32
...............#...#...#....S#..
.######..##..#.......#...#.##..#
...#...#.#...#...#.#.#.#.......#
#....#..##..######...#.#.#.#....
...........#.....#.....#.....#.#
.###.#######.#.#.##.##.#####.#.#
.....#.......#.....#...#.....#..
.#.#.#####.#.#.#.###.#...#...#.#
...#.....#.#...............#.#..
##.###...#.#.###..#.#####..#...#
.........#.#.#...#.#.......#.#..
.###.#.#.#.##..###.#...#####.#.#
.....#...#.....#...#...........#
.##..#...#.######..#####.#.#.###
.....#.#.#.#...#.........#.#...#
#.##.#.#...#.#.#.#######.#.###.#
...#....G#.#.#.#.....#...#.#...#
.###.##..#.#.#.#.###.#.###.#.###
.........#...#...#.....#...#...#
.#####.##.##.#.###..#..#...###.#
.....#...#.........#...#.......#
.###.###....##.##############..#
.#.....#.....#.#...........#....
.#.#.#.#####.#...#########.#.#.#
.#.#.........#.#...#.....#......
.#.#####.#.##.####.###.#...#.#.#
...#.....#.#.....#.....#.#.#....
.###.#.#..##.#.#.###...#.#.###.#
.......#...#.......#...#.#.....#
.#.###.###.#.###.#######.#######
.#.......#.....#...............#
#######.######.######.##########
