32
.......#.......#...#...........#
.#.....#..###......#.#.#.#....##
.....#.#.#...#...#.....#...#....
.##..###..##.####.###.#..#.###.#
...#...#.....#...............#.#
.#.#.#...#.#.......#.#.#..##....
.....#.....#...#.#.#.......#....
####.####.#####..#.#.#.###.###.#
.....#.........#.#.#.......#...#
...#.#.#...##..##..#.#.#####.###
.#.....#........S#.#...#...#...#
.#.#.#.#.#...##.##.###.#.#.#....
...........#.....#.....#.#.#....
#.#..#.#.##.#.##.#.###...#.#.#.#
.....#.#.......#.#...#.........#
.#.#.#..####.#.#.##.#.#.#.##...#
...#.#.....#.#.#.#.............#
...#.###.#...#.#.#.#.#..#.#.####
.#.....#...#.#.#.#.#.........#.#
.##.#..#.###.#.#...#..#####.....
.#.......#...#.#...#.#.#...#.#.#
.#.#.#.#.#####.#####.#...#.....#
.#...............#.......#...#.#
.#.#.##.####.###.#..##.#####.#..
.#.#.#.........#.....#.#.#.....#
.###.#.###.#.##..#.#.#...#.#.#..
G#...#...#.........#.......#....
.#...#...##.....####.#.#####.#.#
.#.#.#.#.....#.......#.#.....#..
.#.#.#.#.#.#########.#.#.##.##.#
...#.....................#.....#
.####.#.#.#####.###..#########.#
