32
...#.....................#.....#
..##.#######.####..###.#...#.###
.#...............#.....#.#.#...#
.#.##.###.##.#####...#.#.#..##.#
.#.........#.........#.#.......#
.###.##.##.####..#.#.#.###.#.#.#
.#.....#.#S#.....#...#.#...#.#.#
...#.#.#.#.#.##.##.###.#.###.#.#
...#.....#.......#.......#.....#
###...##.#.#.#.#.#.#.#...###.#.#
...........#...#.....#.#.......#
.###.#.##.##..####.#.#...###.#.#
.#...#.#...#.......#.........#.#
.#####.#.#####.#.#.#.#####.###.#
...#...#.#.......#.#.#.....#...#
#....###.#.#####.#..##...###.#.#
...#.#...#.#...#................
.#...#.#.#..##.#...#######..##.#
.........#.....#...#.....#...#.#
.#####.###.#.#.#.###.##..#.#...#
.......#.........#...#...#.#....
#..#.##..#########.###..##.###.#
...#.........#.....#.#.........#
..####.####..#.#####.########..#
.#.....#.....#.#.......#.......#
.#..##.#.###.#.###...#...####..#
...#.........#.........#...#...#
.##..###.##..##.###...####.#.###
...#...#.#.......#.........#...#
.#.#.#.###..###..#..#.##.###.#.#
..G..#.........#.........#.....#
.######################.#####..#
