16
................
##......##.#...#
.........#...#..
..##.#...##....#
.....#..........
.#..#.##...#.##.
.............#.#
...##.##..#.....
.#S........#....
...###...#......
.....#...#.....#
.#.....##....#.#
...#.#.......#G.
.#.#####.....#.#
.#..............
###..#.##.#.###.
