32
.........#.............#.......#
.#.####.##...#...#.#...###.#.##.
.#.........#...#.....#...#.#...#
.#.#.#####.#...#.#.#.###..#.##.#
...#.....#...#.#.#.#.#...#...#.#
.#####.#.#.......#.#.#.#.#.#.#..
.#.....#.....#.......#...#.#....
.#..##.#...#..###.#.#..#.#..#...
.....#.....#.....#...#.#...#...#
##..####..##..#..#.###.#.#..##.#
...........#...........#.#...#.#
.#.####.##.#....#.##...##..#..##
G#.............#.....#.....#...#
.....#...####....#.....###.###.#
.....#.#.#.....#...#...........#
.###.#..##.#.#.#.#.#####..###..#
.#...#.......#...#.#...........#
.#..##.###.#..####..##...#.####.
...#.......#.............#.....#
.#######.#...###.#####...#...#..
.#.....#.....#.....#.....#.....#
.#.#.....##.######.#.##.##.###.#
.....#.#.#.#.......#............
.#.#...#.#.#.#...####.#.##.#.##.
.#...#.#.....#.#........S#.#.#..
.###.....##..#..#####...##.#.#.#
.........#.................#.#.#
##.#...#.#..#.##.#.#.....#.....#
.....#.#.#.#.............#...#.#
.####....#...###...#...##..#.#.#
...........#.......#...........#
..#.#..####.#####..#....########
