64
.................#.......................#.......#..............
.#.#.##....#.##.##.#.#.##.###...##.#.#..##.#..##.#.#.#.##....#.#
.......#.........#.....................#.......#.....#...#.....#
.......#.#...#.......#.#...#.##..#.......#..#..#......#..#..###.
.....#.#.......#...#.......#.................#...........#.....#
.###...#.#.##...##.#.#..#....#.#.##..#.#.........#.#...#.#...#..
...#.#.............#...#.........................#...........#..
.#..##.##..#..#.##...#...#...#.####..###........#....#.....#.#.#
.........#...#.......#.#.........#.#.....#.#.#.....#.........#.#
.##..#...#...#...#.....#.#....#..#.#...##....#...####.#..#.#.#.#
.#.............#.....#.#.......#...#.............#..............
.....##..###.##.#..###.###..#...##..#####..#.#.###.###.#.#..#..#
.................#...#.#.......#.......#.......#.............#.#
.##..#.#...##..#####.....##....#..##.###.##......#.....#.#...#.#
.#...#...............#...........#...#.............#.......#.#.#
...#.#...#...#.#...#.#.#..#.##.....#.#.###...###.#.#...#.#..#..#
...#.#.#...#...#.#.............#.#...#...#.#.....#.#............
.#......#.##.##...#.#..#.#...##...##.....#...#.....#...###......
.....#...#.......#.....................#.#...........#...#.....#
...##.#..#.###.#.#...#.#.######.##.#..#..#.....#.##..##..#.#...#
.#.........#.....#.......#...............#.#.........#...#.#...#
.####......#.....#.#....##..##...#.#.##.######.#...#.#.#.#.#.#.#
...................#...#.......#........S..........#...#.#...#.#
..#..##..##.#...#......###...##.#.#.#..###.#.#.#..#......#.#.#..
.............#...#.........#...#.............................#..
...####..#...#....#.#.##.........#.####..##.##.#...##..........#
.........#.....#.#...........#...#...............#.....#...#...#
#....#...#.#..#..#.#.#.#..#....#.#.##........###....#.##.#.#...#
.......................#.........#.....#.............#...#...#..
...#...#.#.##..#.#.#....###.##.........##.####.#.#.#.#.....#....
.#...#.........#.....#...........#.......#...#...#.......#.....#
.##......#.#.###..###..#..#..#...####.........#..#.#.#...#...#..
...#.#.....#...........#...............#.#.............#........
##...#.#.##.#..#.....#.#...#.#..#..#.......###.#...##.........##
...#.#.........................#.......#.#...#.#...#...#...#....
.##....###...##..#...#.#...#.#...##.#..#.###.#...##..........#..
...........#.....#.....#.......#.........#...#.#................
.#....##.##......#.##..#.#...#####.#...#....##.##.##....#...#...
.#.............#.#.....#...#.......................#.....#.....#
.#..##.....#.##...#...##....#.#.#.#...#......#......####.###...#
.........#.........#.....#.............#.#.....#.......#.......#
#..#.###.......#####.#.#.#.##.......#....#.#.#......#.#..##.....
.....#...#.....#.............#.......#.........#.#...........#..
...##..#.......#.#####...#...#..#..#.#....##.#.#...#.#.#.#.#...#
...#...........#.....#.....#.#.....#.#.....................#.#.#
.#.#.#.#.#.###..###..........#...##...#..###.#...#....#......#..
...#...#.......#.................#.#...............#.........#..
.#.###.##..........#.#.#..#..#..#..#..###.##.#......#...##.#...#
.#.....#.........#.#.........#.......................#...#...#..
.#..##........####....##.#.#.#....#.....#.....##.###.#......#...
...............#...#...#.................................#.....#
.#.#.#.#....##....##...##.##..##.....###.#.#.#...#.###......#..#
.#.........#.........#.....#.....#...#...#.....#................
.#.#...#.#.#.#.#..#....##.##......#..#...#.#....#...###..#.#....
...#.....#.#.....#.#.........#.......#.#.......................#
######...#.....#...#.##..#.#..##.#.##......##.#....##.##.###.#.#
...........#.....#.#.........#...#.........#...#.#..............
.###.#.#...#.###.....#.###...#.##....#...#.#.#.#...#.#.#........
.#...............#...#.#...............#.#...#.#.......#...#....
.#.###.....#.#...#####...##..###......##.##.##.#.#.#.#.##..#.#.#
...#.....#.#.........#.............#.....#...#.......#...#...#..
.#.#.....#.#.#...#...#.#.#..##.#......#.##......##..#....###.#.#
G#...#.......#.................#...............................#
#.##..#.##..#...#.....###.#.#.##...##.#.####..###.#.#..#....####
