8
...#...#
.#.#...#
.#.#.#.#
.#.#.###
S#.#...#
##..##.#
......G#
.####..#
