16
...............#
.##.##.###...#..
.......#...#.#..
.##.##...#......
.........#...#..
...###..##.#....
...#...#S#...#.#
.#.........#.#.#
................
###....###..#..#
...............#
.##.##.#.##.#...
...........#...#
.#.##..#.#...#.#
G..........#....
.#.###..#...##..
