32
...#.....#.........#...#...#...#
.#.#.#.#.#..##..##.#.#...#...#.#
.#...#...#.#.....#.......#.#.#.#
.#.#.#...#.#..###########..###.#
.#.#...#.....#...........#...#.#
.#...##.##...#.##.##.#.#.#.....#
G#.#.............#...#.#...#.#.#
.#.#.#.###.#.#.#...#.#.#####.#.#
.#.................#.#.........#
.###.#..#.#.#####..#.###.#.###.#
.......#...............#.......#
.##..####..####..##........#...#
.#.............................#
.###.#.##.##.#####.#.###.#.#.#..
...#.#.......#.....#...#.#S..#.#
##....##.#.###.###.###...#...#..
...#.....#...#.#.....#.#.#.#...#
.....#...#.#.#.#.#.#...#...#####
.......#...#....................
####.#...#..#.##.##.####..####..
...#.....#.#.....#.....#.....#.#
..###....#...#####..##.##.####.#
.........#.#...#...........#...#
.#.#..##.#..##.#.###.#####.#.##.
...#.....................#.....#
..#..##..###...###....#...####.#
.#.........#.......#.........#.#
.##..#......###..#.....#...#....
.....#...#...#.#.....#.....#...#
#..#.##.####.#.###..#..##......#
...........................#....
##.##..###.#.#######.#####.#.###
