16
.....#.......#.#
.#.###.###.#...#
.#.#...#...#...#
.###..##..##.#.#
.......#.....#G#
.####.#####..#.#
.....#...#...#.#
.#####.#.#.#####
.......#...#....
.#.####.##.#.#.#
.#...........#..
.#.#.#.#.###...#
.#.#...#...#.#.#
.#.#.#.#...##..#
.....#.#S#.....#
####.###.#.#####
