64
.....#...#...................#.....#.......#....................
..#....#......#.#..#...#.#.#..##.#.#.#.....#.#....##..####.#.#..
.........#..S........#.....#.....#.........#.......#...........#
.....##..#.##......#.....##.#..#...#..#..#............##.#......
...#...#.......#.........#.............................#.#......
.....#.#.#.##...##...#...#...###.....#.####.#.##.#...##..#.#....
.........#...#...........#.#.#...#.#...........#.........#...#..
.##..#.#.#.####.##....#.#......#.#.#.##...####....#..#...#...##.
.....#.#...................#.#.......#.........#.......#...#...#
..####...#.##...#......###...#...#.#.....##....#...##...#....#..
.......#.....#...#...............#.............#...............#
#.##..##.........##......#..#.......##.....#.#.#.#.#..##.#....##
.........#.#...#.#...#.........#.#...#...#.................#....
..##...#..#..###.....##..#.......#...#.#...#.##..#......###....#
.....#.#.....#...............#...#.#.#.......#.......#..........
.###.........#.#.#..##.....###.#.....###.##.....##..##.#......##
.......#.......#.........#.........#.......#.....#.#...........#
...#........#..#...#.....#.#..##.....#.##..........#.#.###..#...
...#.......#.#...........#.....#.........#......................
.....#.#.#.#.#..##.###.....#.#...#.#..#..#.#...#.#.####...#..#.#
.......#.#.#.....#...............#.#.........#..................
....#.......####.#.........####..##....###...##..#.##.#####.##.#
...#...#...............#...#...................#.............#..
.#.#.#.#.#...#..#....####..#.#...#....##...##...##.#.####.##.#.#
.#.#.....#.........#.......#...#.........#.................#....
.#...##....##..................#....#......#.##.....##.....#.#..
...........#.#...#.............#...#.........#.........#........
....##.#..##.##....#.#...##.##...#.#.................#.#.#.#.#..
...............#.#...#.........#.....#.#.....................#..
.#.#.#.#.##.#....#.###..#..##.#..##.#......###...#.#.###.....#..
...#.............#.......#.....#.#.........#.................#..
...##.##...#####......#.....##.#.#.#......#........#.#########..
...........#.......#.....#...#.#.#.#.................#..........
.#.....##..#.#..#.#.#..#.......#.#.#.#.#...##..#.##..#..###...#.
...#.#.#.....#.......#.#.....#.#.#.........#...#...........#...#
.#.....#..####.#####.....#.#...#.#...#..##.#...#...#.###.#.#.#.#
...#...............#.....#...........#.....#.#...............#..
##.#....##.#..##...#...#.#.#.#.#.............#.#..#......##.#..#
.....#.....#.......#.........#.....#...#...#.#.......#..........
.#..#.#.##.......#..#........#.#.#...###..##....#.......#..#...#
.............#...#.....................#...........#.......#.#.#
#..#.##....##.....##.#.###....#..#...#.#####.#.####..##.##.#.###
...#.#.........#.............#.......#.......#...#...#..........
..##.#..#........#.#.#...#..##.#.#...##...##...#.#.#..#.######.#
.#...........#...#.....#...#...................................#
.#.#..##.##.....#...#..#.##..##..##..#..#.#.#.##..##.###...#...#
...#...........#.#.#...#.#...#.......#.........#...............#
#....#...#.#.#.#...#...#.#.###.#.#........#..#...##........#.#..
.....#.........#.......#...................................#....
.#####.#.##....#.##.#......#...#...#.#.###.....#................
...............#.........#.....#...........................#.#..
.#.#....##...#...#.#.#.###.#.#.#.##..#.#.#..##.#.##..#.##.......
.#.#...#...#.#...#.#.#.#.............#..........................
.#..##...#.#..##.........##.##.####.#...##.#...###........#....#
...........#.....#.#.......#...................#...#...#.......#
##.....#...##.#......###.#....#.#..###.##.#.####...###.#...#..#.
.........#.........#.................................#.........#
.......#.#.#.#.#.#..#.#.##.##..###.#.##....#.###...#.####.#.#..#
.#.........#.#.......#.......#.....#...#...#.......#.#..........
...#.###.#.............#.##........#.....###.#....##.#...#...#..
.............#.#...#.#.#.#.......#.#.#.........#................
.....#.#....##...#.....#....#..#...###.###...#.#.##.#..#....#...
...#...#.........#...........................#......G...........
#######.##.#..###.#.##.#.##..##.#............#.##...#.##.###.#..
