16
...#...........#
.#.#.#####.###..
.........#.#.#.#
.#####.###.....#
.....#.....#.#..
...##..####....#
.......#.......#
.###.###.#.###.#
.....#.........#
####.#.#########
.....#...#......
.#######.###.#.#
.......#.#....G#
..####.#.#.###.#
S......#...#....
#.############.#
