8
........
.#...#.#
....S..#
..##.#.#
.....#.#
.#.#.#..
G..#...#
##.#..##
