8
........
.#####..
.#....G#
.#.#####
........
.#.###..
..S#...#
#.######
