32
.....................#..........
.#.##..#.#.#.#..#.#..#...#...#..
.#...........#.........#....S..#
.#.###.#.#..#.#.....##.....#...#
...#.......#...#...#...........#
.#.##..###.......#.....#...#....
...#.............#.........#...#
...#.##.#...##...#.#.#.#....##.#
.........#.....#...............#
...####.#...#.#..#....#.#.#..#.#
...............#.#..............
.#.#..##..#..###....#.#..#.#..##
.................#.....#.......#
..#..#.#...##.#.#.#....#.#..#...
.....#.#...................#...#
.#...#...#...#...##..#.#.#...#..
...#...........................#
..........#..#...#.....#.###.#.#
.......#.............#.#.......#
.#.#....###.##..##...#...#.#....
.....#.#...........#.....#.....#
###....#.#..##.#.#.##.##.###...#
........G........#...#..........
.#.##.....##.#...##....#...#...#
...........#...#.#.#...#.#......
###...##....#....#.#.##..##.##..
.............#...#...........#.#
...###.#####.#.#........#......#
.....#...............#.........#
#.#..#...###.#.###...#.#..##.##.
................................
.#..#.#...#..#####.##.##...#####
