16
................
.....#.#..#....#
.#.........#...#
.#.####....###.#
.......#...#....
.##..#...##...#.
.....#.#S....#..
.#####..##.##...
................
.###.#.#.#.#.#.#
.....#..........
..##.......#....
.....#.#.....#..
.#..#..###.#....
G#.........#....
#.####.###..#...
