8
G......#
...#.#..
.#.#...#
.......#
.#..S..#
.#...#.#
.#......
..####.#
