64
.......................#...#.........#.....#...#...............#
.###.###.###.#.##.##.#.#.#.#.#.###.#.#..##.....#.###..######.#.#
.#.#.#...#...#.....#.#.#.........#.#...#.....#.#...#.......#...#
.#.#.#.###.#.#.#...#.###.#####.###.#####..##.###.#.#.#####.#####
...#...#...#...#.#...........#.#.......#.#.#.....#.#...#.#.#....
##........######.#...##.##.#.##..##..#...#.#.#.#.#.....#.#.#.#.#
...#.#...#.......#.#.#.....#.....#...#.......#.#.....#...#...#..
.###.#..##.##..#.#..##.###.....#####.#.###.###.#########.#####.#
...#.#.....#...#...#...#...............#...#.....#.........#...#
####.#..####.#####...###.#.##########...##...###...###.##..#.###
.....#.#...............#.............#...#.......#.#.......#....
.#####.#.#.##.#######...##..##.#.###..##.####..#.#..#..#####.#.#
...........#.#.......#.......#...#.....#.#.#...........#...#.#..
####..##.#.#.#.###.#.#.#####.#####.#####.#.#.###.#######.#.###.#
.....#.#.#...#.....#.......#.....#.......#.......#.......#.....#
.#####...#######.#.######..####..#####.#.#######.#.###.#.#.###.#
.#...#.........#.#.....#...#...#...........#...#...#...#.......#
.#.#.#.#####...#.#####....##.#.#.#####..##.#.#.#.##..#..##.#.###
.......#.......#.#.....#.....#.#...#...#.....#.#.#...#.......#.#
.#####.#.###.#.#...####..#..##..####.###.#####.#.#..#.####.#.#.#
.#...............#.#...#.#...#.#...#.......#...#.#.........#...#
##.#.#####...#...#...#.#.###.#...#.###.#.#.#..##.##..###.##..#.#
...#...#...#.#.#.#...#.#.......#.#...#.#.#...#.......#...#.....#
..####.#...#.##..####...######.#.#.#.#.#.##.###.##.###.######.##
...........#.........#.#...#...........#...#.....#...#.........#
.#...#.###.#.####...##.#.#.#..###..##.##.#...###.###.#########.#
.......#...........#...#.#.........#.....#...#.#.........#.#...#
####.#.#.###.#..##.....#..###.####.#...#.##.#....#.#####.#...#.#
..S#.#.#.....#.....#.#.#...#.........#.....#...#.......#...#...#
.#####...#...#####.#..##.#.#.#.#.#####.####....##.####.#.#.###.#
...#...#.#.#.#...#.#...#.......#.....#.......#.............#....
##.#.###.##..#.###.###...#.#....####....######.#..##.##..#.#.#.#
.#...#.#...#.#.....#.....#.#...#...#...........#...........#.#.#
.#####.###...#.#.#.#.###.#..##.#.###..#.######...#.#######.#.#.#
...........#.#...#...#...#.................#.....#...#.........#
.#.##.##.#.#.#...#.###..#.##.#.######..#.#....##..##.#.#.#.#...#
.#...........#.#.#.#...#.....#.........#.....#...#...#.......#..
.#.#.##..###...#...#.###...###.###.#.#.####.#..##..#.#.#####.#..
.#.........#.....#.......#.#.#.#.#...#.....#...#.........#.....#
##.#...###.#.####..#...###...#.#.###.#####.#.###.#.#.#.#.#####.#
...#.#.....#.#...#...#...#.#.#.....#.....#...#...#.......#...#.#
.##.##...###.#..##.#...#.#.#.###.#.#.#####..##.##..###.###.#.#..
.#...#.#.....#...........#.........#.........#...#...#.....#.#..
.#.#.###.####..#.#.##.##.#.###.#####.#.##..#.###.#.#.####..#.#..
...#...#.#.....#.#.......#...#.....#...#...#...#.....#...#.#.#.#
..####.#.#.####....#..##.###..#.#...##.#.#.###.##.####.#.#.#.#.#
.......#.#.............#.#.#.....#.#...#.#.#.#.........#.#.#.#.#
#....#.#.#..##..##.#.#.#.#..####...###.#.#.#.##..#...###.#.#..##
...#...#.#...#.....#...#...#.....#...#...#.#...#.........#.#...#
..###..#.#####..##.#.#.#.###.####.##..##...##..#.##..###.#.#.#.#
.....#.#.........#...#.#.......#...#.....#...#...#...........#.#
.#####..########.###.#.#.#.##..#.#.#####.###.###.#....#.####.#.#
.#.............#.....#.....#...#.#.....#...#...#...............#
...#.########.##.###.##.##.#.#....#.##.###.#.#.#####.#####.###.#
.#.#...........#.#.........#.#.......#...#.#.#...#.....#.....#.#
.#.#.#.##..#.#.#...###.#####.#.##....###.#...##....###.#.###...#
.............#.#...#...#.#.........#.#...#.#...#.#...#...#.....#
.###.#####.###.#.###.#.#.#.###.###.#...#.#.#####..###..#.#.#####
.#...................#...#.#.#...#...#.#.#.#.....#.............#
.#..####.######...######.#.#..#...##.#.###.#.####....#..##.#...#
.#.#.............#...#...#.#...#.....#.....#.........#...#.#...#
...####..##..###.#.#.##.##.#.#.#.#.#.###.#.##.#.#.##.###.#.#.#.#
.............................#.........#....G................#.#
##.######.##.###.######.###.#.######.###.########.##.##.##..#..#
