8
..S.....
........
........
..###...
...#....
.....#.#
G#.....#
.##.#..#
