64
...........#.............#...............#.....#...............#
.#####.#.#...#.#.#.#####.#.#.#.#...#..##.##..#.#..####..##.#....
.#.......#.#.#...#...#.....#.....#.....#.#.....#.......#...#.#.#
.#.##.##.#.#.#.#.###...###.#.#####.#.#.#.#...#.#.#######.#####..
.#.......#...#.....#.....#...#...#.....#.#.#.#.#.#.#...#.......#
.##.##.#.#.#####.#.#####.#.##..#.#.###.#.#.#...#.#.#...#.#.###.#
...#...#.#.#...#.#.....#.......#...#...#...#.....#.#.#.....#.#.#
##.#.#####.###.#.#...#.##..#.#######.###.#.....#.#.#.#.#####.#.#
.#.#.....#...#.....#.......#.#...#...............#.#.........#.#
.#.#####.###...###.#########.#.#.##..#.#####.#####.#.#...#####.#
...#...#.......#...............#...#.#.........#.....#...#......
###..#.##.######.####.#.##.#.####..###.#.##.##.#.###.#.#.#.#####
.....#.......#...........#...#...#.#...#.#...#...#...#...#.....#
.###...#.###...###.###.###....#..#...###.#.#.###.#...#.#.#####.#
.....#.....#...#.........#.#.....#.#.#...#.#...#...#.#.#.....#.#
.###...##.#####..###.###...#######...#..######.#.###..##.#.#.#.#
...#.#.#.......#...................#.#.....#...#...#.....#.#....
.#.#...#..###..#.#####.#.#.###..#.##..#..#.#.#.#.####..#...#####
.....#.#.....#.#.#.........#.................#.#.#.....#.#.....#
....##..####.#.#.#.####..###.####.##########.###...##.#..###.#.#
.#.#.........#.....#.........#.......#.......#...#...#.#...#.#.#
#..###.#..##.##.####.#.###.###.#####...#.#.....#####...##..##..#
.........#.....#.....#...#...#.........#...#.......#.#...#.....#
..#..#...#####.#.#######..##.#####.###.#####..######.#.###.#.###
.....#.#.......#.#.....#.#...#.....#.#...#.....#.....#.....#...#
.#.#.#.#.###.#.#...##....#.##..#.###...#.#.#.#.#.#.######..#.#.#
.....#.#.#...#...#...#.....#...#.#.......#.#.#.#................
.###.#.###...#.#.###.####.#..###.#.###.#.#......###.#.#..##.###.
.....#.....#...#.........#...#...#...#.#...#.....#..............
.#.#.#...#####.###.#..##.#.###.##.##.#.##..#.##..#.###.#.#.###.#
.........#...#...#.....#.#...#.....#.#.#.......#.......#...#.#.#
.##..####..#.###.#.#.###.###.###...#.#.#.#.#.#.#.#.#.#.#.##..#..
...........#.#.....#.#.....#...#.#.#...#.#...#.....#.#.#.....#.#
.####.#####..#######.#.###.###.#.###.#.#...###...###.###.#####.#
...#...#...#...#...#...#...#...#.........#.....#...#.....#S....#
##...#.#.#.###.#.#...#.#.#...#####...#.#.#...#####.##.##########
.......#.#...#.#.#.......#.....#...#...#.#.#.......#.........#.#
.#.#.#.#..##...#.##..#.#.#.#.#.#.##.##.#.#.###.##..###.###.#.#.#
.....#.#.#.#.#.#.......#.....#.#.....#.#.#.....#.#.......#.....#
.#.#.###.#.#...#.#.###..######.#.###.#.#.#####.#.######.....##..
.#.#.......#...#.#.#.#.................#.#.......#.#.....#...#.#
.#.#######.####..#.#..###..#.#####.#####.#.##..#.#...#####.....#
.#.....#.#.......#...#.................#.#.#.......#.....#...#.#
.#.###.#.##.##.#.###.#.#########..#....#.#.#.#####.#.#...###.#.#
...#...#.......#.#.#.#...............#.#...#...#...#.......#....
#..#.#.#.#.####..#.#..##.#####.##..###.#.###.#.###.#.#.###.#....
...#.#.#.#.......#.....#.#.............#...#.......#.#...#...#..
..##.#...#####.#.#.#.#.#.#.#.###.###.###.#.####.##...#.#.#.#.#.#
...#.#...#.............#.....#.....#.#.#.#...#.....#...#.#.#....
.....#.##.#...###.#...#####..#.#.#.#.#.#.#...#.#.#.#..##.#..##..
.#.#.#.......#.......#.......#...#.#.#...#.#...#.#.#.....#.#...#
.#.#.#.#.###.#.#.#..##.#######.....#...###.#.###...#.####..#...#
.#.#.#...#...#.....#...........#.....#.........#.#...#.#...#.#.#
.#....####.#######.#.###.#.#.#.#.######.#..#.#.#.#...#.#..##.###
...#.......#...#...#.#...#...#.....#.........#.........#.#.....#
####.#.###.#.#.#.###.#.#.#.#.#####.###.#.###...#.#.###.#.####..#
..G..#.....#.#.#.#...#.#.#.#.....#.....#.....#.#.....#.#.#.....#
.#.#########.#.#.###.......#####.#.#.#.##.####...###.#.#.#.##..#
.#...#.......#.......#.#.#.......#.#.#.........#.#...#...#...#..
.#.#.#.#######.#.###...#..######.#.#.#.#.#######.#.#.###.#...#..
...#.............#...#.#.........#.#.#.#.......#.....#...#...#.#
.#.#..######..##...##..#####.#.###.#.#...#####.#.#..##.###..##.#
...............#.......#.......#.....#.......#.............#...#
######...####..#.##.####.###.#.##############...##########.##.##
