16
.....#.....#...#
.##....#...##..#
...#.#.#......G#
.#.#...#...#.#.#
...#.#.#.#.....#
...#.#.###.#.#.#
...#.#.....#.#.#
.........##..#..
...#S#.....#...#
.#######.#...#.#
.....#.......#.#
##....####.###.#
.............#.#
...#..##.#.#...#
...........#...#
##.#.###..#.#.##
