8
.#S....#
...#.###
.#.....#
.#.###.#
...#..G#
.#.#.#..
.....#.#
########
