8
.......#
.#.#.#.#
.....#.#
.#.....#
.#...#S.
..##....
G.......
#.##...#
