8
........
.#..##.#
.#..G..#
....#.##
........
....##.#
S......#
#..#.###
