32
.......#.....................#..
.#..##..#.#.#..#.##......###.#..
...#.......#.......#.#...#.....#
.#.......#.#.##....##......#...#
.#.#.........#.........#...#....
...####..#...#.#.###.#.#.#..##..
.....................#...#......
.##....#...#....#.#..........#..
.....#...........#..............
.#.....#.......#...###.....#....
..G......#.....#................
#..#.#.....##....#...#..#.##.#..
.#.....#.#.............#.......#
...#..#..####.#..##.#..#.####..#
...#.#...........#.........#..S#
#.##..####.#.#.#....#.###..#..##
.......#.........#...........#..
.........#...#.............###.#
.........#.#...#.#.....#........
.####..#...#.....#..###..#..##.#
.#.........#.....#.#.........#..
...##.#....#.#.#.#.#..#.#....##.
.#...#.....#...#.#..............
.....#...#.....#..##..####..##..
.#...........#.....#.....#......
...#..#..#...#.....#..#...#..#.#
.#.....#.................#......
.#.###....#..#.#.##..#.#.#.#...#
.....#...#.......#.....#...#....
.#.#.#.....###...#.#.###.....#.#
.........#...................#.#
..##.#.##.######.#.#....##..#.##
