32
.....#.....#.......#.#.........#
.#...#.#.#...#.##....#...#####.#
...#.#.#...#.#.#.......#.#...#.#
.###.#.#.##.##.#.###.###.#.#.###
.#.....#.........#...#...#......
.############.##.......###..##.#
.#...#.....#...#...#...#...#...#
.#.#.#.###.#.#.###.#.#.#.###.###
...#.......#.#...#.....#.#.#...#
..########.#...###..####.#.##..#
.#.#...#...#.......#S#...#.....#
.#.#.#.#.###.#.#####.#..#..####.
...#.....#.....#...#...#...#...#
.....###.####.##.#..###...#..#.#
.....#.#.#.......#...#...#...#.#
##.###.#.#..#######..#.###.....#
...#.....#.#.......#...#...#...#
.....###.#.#.##..#...#####..##.#
...#...#...#.........#.....#...#
.#.#.#.#.#####...###.#.#..##.###
.....#.#.......#...............#
.###....##.#.###.#.###.###.#.#.#
G....#.....#.....#...........#.#
.#...#.#.#####.#.#.#.##.####.#.#
.#...#.....#.......#...#.....#.#
####.#.###.#..#.###.#....#.###.#
.....#...#.#.#.........#.#.#....
.######..#.#.##..##.####.#...#.#
.#.....#.#.#.....#.......#...#.#
.#.#.##....#.#####...#.#.####..#
...#.....#.....................#
#.#.##############.#..#.###.####
