16
...........#....
...#...##....#.#
.....#...#......
.#.##.##.....#..
...#...#.#......
.....#......#...
.#.#.....#.#..S.
.#.....#.#.#.#..
...#.......#....
.....#.##..#....
.#.....#.....#.#
.#..#....##....#
..G#.....#...#.#
.....#..##...#..
...........#....
#####.#.#.#.####
