16
.......#........
.#..#..#.#.#.#..
.#.#.....#S.....
.#....##.#.#...#
.#.....#...#....
.#.#.#.....#.###
.....#.#.#.....#
....#..#...##...
.......#........
.#.....#...#..##
...#.#.#.....#.#
.....#.###......
.#.#............
.....#....##.#.#
G...............
##...###.#...###
