32
.......................#.......#
.###.#.##...#########.......#..#
.#.........#.............#.....#
.#...##..#...###...#...#.#.###..
...#.....#.#...........#.#.....#
.#.##.##.#.....#.##......###.#.#
...#...#.#.....#....G........#.#
...#........##.....#..##.#.##...
.#.......#.....#...#.....#.....#
.#...#.#.#...#.#..##...##...##.#
.#.........#.#.......#..........
...#...#..##.#...#.#.###.##..##.
...#.........#.........#...#....
.#...##.##...#..##.#.#.#.....#..
...#...........#...#.#..........
.#.#.#...............#...##..#.#
.#...#.#.........#.....#........
.#.##..#...#.....#.#.#.##......#
.#.....#........................
.#...#.....###.##.##..#........#
...#...#.............#..........
...#...#..#..###..#.##.....##..#
.....#.............#.......#....
.....#......#....#...##...#.....
.......#.......#.#.#.....#...#..
.#..#..#.###.#.#......#.#....#.#
.#...#.......#.....#.#.....#...#
...#..#....###......##.###..#...
...#S....#.#.....#...#.........#
....##..##.#...#.......#.##.##..
.......#...........#...........#
.#.#....#.##.###..##.###...####.
