64
.............#.........#.#...................#..................
.#...#..#.###..#.##......#.###..#.##..#..#...#........##.#.###..
...#.#.............#...#.......#...#.#.....#.................#.#
.#.#....#...#.#.......#......#.#.....#...###.###.#...##.####.#..
.#...#.....................#.....#.#...#...........#.......#...#
.##..#.#...#.#.#..##....##.....#####.#...#.#..##...#...##..#.#..
.......#...........#.......#.#.....#.......#.........#.....#...#
...####..#..#.#..#.#.......#.#.#.#.#..###..#........##......##..
...#.#.........#.#.#...#...#...#.........#.#...........#.......#
..#.....##..#....#....#..#...#.###....##.###.#.###..##..#.#.##.#
.......#.#...........#...#.......#.....#.#...#.#.........#...#.#
.#..#..#.#.#..#.####...#..##.#...#.#.#......###..#.....#...#.#.#
...........#...#.....#.#.............#.#.....................#.#
..###..#.#.#...#.##....#.##.##........#..#.#.###.#.....#.#.#.##.
.............#..G....#...........#.#...........#...........#....
.#....##......#...##...#....##.#...##.#.#..###.#.....###.......#
...#.#...#.#.........#.......#.#.#...........#...#.......#.....#
.#.....#.......#..##.##.##.#...#.#.##............#.#..##..####..
.............#.#...........................#.#..................
.#.....#...#.....#.#.#...###.#....#.#..#.#.#.#####..###.#..#.#.#
.#.....#.....#.......#.........#.....#...#.#....................
.#...###....###..#.#.....#..##.#.#..##.#.##..#.#...#.....#..#.#.
.........#...................#.....#...#.....#...#...#.#........
.#.#.##...#.......#.##.#####.........#..##..#....#...#..#...#..#
.......#...#.#.#.............#.....#.#.....#...#...#...#........
...#.#..##...#...###..............#..#.#...#.###.##..#.#.#...#..
...........#...............#.#.#.....#.......#.........#...#...#
.#.##..#.......#.#...#.....#.#.....###...#.#...###..........#...
...........................#.#...#.......#.........#...#.......#
..#.....##.#..##.#.....#.#....#..#...#...###..#..####.#......#..
.................................#...............#.............#
..##..##.....###.###.#...##....#.#.##....#.#.##..#...#.#.#...#.#
.....#.................#.......#...........#...#.....#.....#....
.#.#.#.#.#.#..##.#.###...#.#...#....#..#.#...#.....#......#..#.#
.#.....#.......................#...#.................#.....#...#
.......#.#...##.#..#.........##...##....##.###.#.#..##..#....#..
...#.#.#.........#.............#.#...#...............#...#.#.#.#
...#......##.#.....#.###.#.....#...#...#..#.#......#.###........
.#.............#.....#.#...........#...#...........#.#.....#....
.#..##.###.#.#.##...#....##.#..#.##.#....#.#.#.##.##.#.#.#.#...#
.#...............#.......#...#.........#.#.............#.......#
#.....#.#...##.#......####.........#..##.......#....#.#..#..##.#
.........#...#.......#.#.......#.......#...#.#...#...#.......#.#
.#.##...#.....##...#.....#..####.....#.....###....##.#.#.....#.#
...#.......#...#.#...........#.#.........#...#.#...........#....
.#...#.#.#.......#...#.#.................#.#.#.#.#..##.#.###..##
.....#.......#.....#.....#.....#.............#...#.#...........#
####.#.###.#.#........#.#...###.#..#..#..#..##.#..##.###.#.#.#.#
.............#...#...#.....#...............#.....#...#...#.#....
.#.###...#.#.....#..##.....#..##.#....#..#.#...#.#..#..#.##.....
...#...#...#.#.............#...............#.#...#.....#.....#..
.....#...#...#...#.##..#.#.#.#..#.##.###.###....##...#.#...##..#
...#...#.#...............#...................#.....#.#..........
..#..#.....##.#....#.#...###.#####...#.##.#.#.##...........###.#
.#...#...............#...........#.#.#.........#...............#
.#.###.####..#.##..#.##...#..#.......#.#..#..#...#.##..#...####.
.#...#.#...........#...#.......#.....#.....#.#...#.....#.......#
..#....#...#.##.####.#...#..#...........##.#.#.#.#.##.##........
.....#...#.............#.......#.#.......#.#.......#...#.......#
.#.#.###.#.......#.......#.#.###.#.#####.#......#..#...#.#.#....
...#...........#...............#.#.........#.........#.#.....#.#
.#...#.#.#...###..##...##.#..#...#...#.#...##.....#..#.....#...#
............................................S............#.....#
.#..##########...###..#.#.###.#.##.#.#..##......##.###.#.##.####
