8
......G#
####....
........
.##..#.#
.#S#....
.#.#...#
...#...#
#######.
