32
...............#...............#
.#.......#.#...#...##..###.#....
...#.........#...#...#.........#
.#..#........#.#...#.#.#.....#.#
..G..#.#.....#.................#
.#...#.#.#.#.##..#.....#.#..##.#
...#.....#.......#.........#...#
.#...#.....###.##.#...#..#.#.#.#
...#.......#...#...........#.#.#
.#.##..#.#...###.#..#..###.#...#
.#.........................#.#.#
.#.#...#...#.##..#.##..#.###.#..
...........#.....#..............
..#....#..#..#...#...#...##....#
.......#.....#.#...........#....
.#.###..#.#..#.#.#.##..........#
...............#.#.........#.#.#
#.##.#.###.#..#......#.###...#..
.....#...#.....................#
.#...#..#..#.#.#...##.........##
...........#.#...#.......#.....#
....#..#...#.#.#..##..##.#.#...#
.#.....#.......#...#...#.#.....#
.#..#..#.#.#...#.#...#.#.#.#....
.............#...#.......#......
.###..#..#.##...#.#..###.#####..
...#...#.....#.............#..S#
.....#.#...#..##...###...#......
...#.........#...........#...#..
.#.......#.#.....#..#....#.#...#
...............................#
.##.#.##...##.#.....#..#...##.##
