16
...............#
.#.....#.#..##..
......S#.......#
.#.##.........#.
.....#..........
#.##...#.###.#.#
................
..####..#..#.#..
.........#.....#
.....#.##.......
...#.#...#......
............#..#
G..#.#.#.......#
....##...#.#.##.
.......#...#...#
...##.#..##..##.
