16
.#.......#.....#
.#.##......#....
...#.#..........
.#.#.#.#.#...#.#
.......#...#S..#
.##..#...#.#...#
.....#...#.....#
.##..#....#..#.#
.#..............
.#.####...#.##.#
.....#...#.#....
###....##..#...#
...#...#........
.##..#.....#...#
....G....#......
#....#...#######
