8
......G#
.####..#
........
.###.#.#
..S..#.#
...#.#..
.#.....#
.####.##
