16
...#...........#
.#....#.##.###.#
.#.#.#.#S#.....#
##.#.#.#.###.###
.......#...#...#
..#.##..#...##.#
...........#...#
.##.######.#.#.#
.#.....#...#...#
.#.#.#.#..####.#
.....#.#.#.....#
#.##.#.#.##..#.#
...#.........#..
.#.#.#.#######.#
.#..G...........
######.#.###...#
