8
...#....
...#...#
.#S.....
.#####.#
.......#
.####.##
......G#
##.###.#
