64
.....#.......#.............#...#.............#...#.............#
.##..###.##..#...###.....#.#.#.#...#...###...#.#.###.#.#.#.#.###
.#...........#.#.....#...#...#...#.........#...#.....#...#.#...#
.#######.#.....##.#.###..#.#.#.#.#########.#.#####.##..#####.#.#
.........#.............#.......#.....#...#......................
..#..###.###.#.####....###.#.#...##..##..#.#.#...##.#..###.#.#.#
......S..............#...#...#...#.#...#.#.......#.......#.#...#
..######...##..#..##..##.#.##.####.###.#.#...###.#.#.###...#.#.#
.#...#...#...#...#...........#.......#...#.#.......#.#.#...#....
.###...####...##....####...#...###...#.#.#.#.####..#.#.#.#.#....
...#.#.#.............#.....#.#...#.....#...........#.......#.#..
##.#...#.#..##.###.#.#..##.#.#.....#####...#####.###...##..#.#..
...#...#.#...#...#...............#.........#.......#.#.....#....
.#.#.#.#.###..##.#...###.#...#####.#..#..#.#.#####...####..###.#
.....#...#...#.#.....................#.....#.....#...#.........#
.#.#.#.#.#.##..##.##############...##....##..###.#####.#...#.##.
.#.....#...................#...#.#.#...........#.#...........#.#
.#.#.##....#.##..#.#.###.#...#.###...#####..#..#.#.#.....#.#...#
.#.#.....#...........#...#...#.#...#.....#.........#...........#
....#######..#.#..##.###..####.#.#....##...#.#.###.......#.#.#.#
...#.........#.#...#.............#...#.....#...#.....#.....#.#.#
.....#.#######.##..#.#..##.#..####.#.###.###.#..####.##.##.#.#.#
.#...#...........#.........#...........#.#...#.........#...#....
.##.##.#.#.#####.#.#.##..#.###..####...#.#.###.....#.#.....#.#.#
.....#...................#.....#.#.....#.......#.#...#.#.......#
.#.#.##.#..#.#.###.#.###.#.###...#.##.#...##.#...#####.##.###..#
.#.......#.........#.#.#.#.................#.........#..........
.#.#.##...####.#.#...#.#.##.##..##.#...###...#.####..####.##.#.#
.#.....#.............#...#...#.#...#.#.....#...........#.....#..
.####..#.#.#...##...#...##.#.#.#.###..###.##..####.#...#.#..#..#
.....#.....#.......#.....#.#...#.#.................#.#.#.....#..
.#####.....#.####.#..##....#####.###.###.#.#######.#.........#..
.#...............#.............#...#.......#.....#.#...#.#...#.#
.#..##.#...####..#.#.######.###....#..#.......##.#.##.##.....#.#
...#.....#.....#...#.......#...#.#...........#...#...#...#.#...#
....##.###.###.#.#...#...#.#...#.#...#...##..#..####.#.#.#.##..#
.....#.............#.....#...#.....#.........#.....#...#.......#
..##.#.#.#.#.#.##....###.#######.###..##.###...#.##.#....###...#
.#...#...#...#.......#.....#.................#...#..............
.#.###...#...#.#####.#.#.###...#####...#..##.#.#.#.#.#..###.#..#
...#.#.#...#.#.......#.#.............#.#.........#.#............
.###.#....##.#.#..####.##.#..#.###.###.######.####.#.#.....#.#.#
...#.....#.............#.......#.#.....#.........#.....#........
.#.#.##.##.....#.#.#.###.#######.#.#...#.#####.#.......#...#.#..
.#...#.....#.......#...#.#...........#.#.............#.......#..
.#.##..####.##.#.#.###.#.#..###.##.###...##..#.#####.#.##..##..#
.#.#...#.............#.#.#.......#.....#...#.......#...#...#...#
.#.#..##.########.####.#.#....##.#.....##...#.#..#...##..#.#.###
...#.#...................#.#.#.#.....#.........#...#.......#...#
.#.#.##..#.###..##.#.###...#.#.#...#.#..###.##...#..##.#.##..#..
.#.......#.........#.....#...#.#...#.....#....G..#...........#..
.#####.##..#.#####.#######...#.###.###.#.#.#..#...#######.##.#..
.....#.#.............................#...#.#.#.........#.....#..
..##.#.#..###..####..##.###...##..##.#.#.#.#.#..##.###...#.##..#
.............#.....#...........#.....#.#.#...#.....#...#.#...#.#
..####....####.###.#.###.....#.#.#...#.##..#.#.#..#.#.##...#...#
.#.....#.........#.#.#.......#...#.#...................#...#....
.######..##.####.....#.###.#..##.#...#.#.......#.#.###.#.####...
.#.......#.....#.....#.....#.....#...#.......#.....#.#...#.....#
.#.##.#.#..#.#....##...#.###.##.##.#.########..##.##.#.#.#.####.
.#.#.......#.............#...#.#...#...#...........#.#.....#...#
.#.#..##...#.#.#.##..##.##.##..#.#...#.#..###.##.#.#.#...##..#..
...................#.............................#...#.........#
#########..####..###.#..#....###..#.#####.####..##..####..####.#
