64
...............#.....................#.....................#...#
.#.###.........#.##..#..#.....###.#..#.#.#....##.....#....#.....
.....#.............#.........#.............#.....#...........#.#
...#.#####...#..#...........##..#..###.#.#.##...##.#.#..#.#.....
...........#...........#.....#...................#...........#.#
...#.#...#.#...#.#.#..##.#.....##..#.#.#..##.##....#.##.#...#...
.........#.....#...#...............#...#.......#.......#........
.....#.#...#...#....#..##..#...#.#.#######.....#.#.###...##....#
.#...#.........#.#...........#.#.................#.............#
...#.#.#.#####...#.....#.#.###.#.#.#...#...#...#.#.#.....#.##..#
...#...#.........#.......#.......#...#.#.......#.........#.....#
....#.#..###...###....##.....###.....#...#.##....###...#.##....#
...#.......#...........#.........#...#.....#.......#............
...##.###..#.#.....#...#.#...#...#..#..#.....#...####..#.#.##..#
.#.............#.......#.....#.............#.#.......#.......#..
#.####......#..#.....#...#.#..##...#.#..#....#.###.#...#.#......
.......#.....#.#...................#...#.....#.....#..S#...#.#.#
..#....#.#.....###.##.##...#.....#..#..#.....#.#.........#.#.#..
.#.....#.#.......................#.#...............#.........#..
...#..##.#.#.###...#...#.#.#.#.##.##.##....#...#.#.#.#...#.#.#.#
.........#...#...........#.#...#.....#.#.#.....#.#...#.........#
..#..#.#####...#......##.#.#.#.#.....#...#.........#....##.#.##.
.......#.....................#.#...........#.#.....#.......#....
...#.#...#..#...#.##.###..#.##..#....#.#.#..##....#..#..#####...
...#.#.......#.#...............#...........#...#................
.......##..#...#.#..####...#...#....#..#.#.#.#...#..#....#.#.#..
.....#.........#.......#.....................#.#.............#.#
...#.#.#.#.#.####.#..................##..#.#.###.#...#...#####.#
.....#.........#.....#...........#...........#.........#........
.#.....#.#.......##..#.......#...#..#..###...........##........#
.#...#.......#.......#.......#.......#...#...#.#...#.........#..
...#.....###.##..#.#....##.#.#.#...#.###.#......##.##...#....##.
.......#...#.#.................#.....................#..........
.#.#...###.#...#...#..#..#.##..##....#...#.###...#.....###.#.#..
.#...#.....#.............#.......#.......#...#.....#...#.......#
...#.......#.#.#..#......#..#.##...#..##.##..#.#.#...#......##..
...#.#.....#...#.........#.#...#.....#.......#.....#...#.......#
##...#...#.#.....#...#..##.....#.#.#...#....#......#.#.#.......#
...#.....#...#.#.............#...................#...#.......#..
.#....#....#.#...###.#.#...#.###..##########....#..#..#.#....#..
.......#.......#...#...........#...........................#.#..
....#...#...##..##.#.#.##..##..#...#...###.##..#..#.#........#..
.#.....#.........#.#.#...........#.....#...#.........#...#.#...#
...........#...#...#..#....#.#.#.#.......#.....#.....#.#...#.#.#
.......#.#.......#.#.........#...#.....#.#...#..................
.#.#.#..#...#..#.#.#..#.#..#.#.#.#..#......#.####..###.#.....#..
...............#...................#.....#.............#........
.###...##.#..###.#.##..#.####.#..#.#.....###...#.#..#.#..#...#..
...#.........#.........#...............#.....#.................#
...#.....#####.#..##.#...#...#...#.#.......#...#.#....#....####.
.....#.............#.#.....#.........#.........#.........#.....#
.##.##..##.#..##.......##....###.#...#...###.##..#...#...#..#...
.......#.................#.......#...#.............#.#.......#.#
..#.###..#.#....#..#.#.#....#.##...#.#...#...##.##.....####.##..
.#.........#.#...#...............#.#.............#.#............
.#.........###.#..#..#.#.#...#.##......##..##.##...#.....#.#....
.#...........#.#.....#.#...........#.......#.....#.......#.....#
.###....##...#.####.#..#...##.......#....#...###.#..###.#...##..
...#.#.....#...................#.....#.....#.................#..
..##....##.#.###..#..#.#...##.....##.#...#.##....###.#.#.##.#...
...#.....#............G#.#.#.#...............#.........#........
.#.....###....##..#..#.#.....#.#....#.#...#....##....#....#..#.#
.....................................................#.....#....
#..###.#...#.#.####.....#.##.....#.#.####.###..#...#..##..######
