16
..........G.....
##.#......###..#
.......#...#...#
.#..####.#.###..
.#.............#
.#.#...#....#..#
.......#...#....
.#.##..#.#......
.#.........#....
#.....##...###..
...#...#.#.....#
...###......####
...............#
.#.#.........#..
...#..S.........
#.#...#...#...##
