32
...#.............#.............#
.#.#.....#..##...#.###.###.....#
.....#.#.........#.......#......
..##...#.#..##.......##...##....
.....#.#.#.............#........
.####....#..#...######.##..#..#.
.....#...#...#.#...........#S..#
..##...#..##.#.#.#...#.#.#..##..
...........................#...#
#..##.##.#.#...#####.#..#.#..###
.........#.................#....
.#.##.#....#...###.#..#....#...#
.......#.#...#.....#.....#.#....
....##.....#.#..#........#.#....
...#.....#...............#.....#
.....#.##..#...#..#..#.....#.##.
.#...#.........#.........#.....#
.....#.#.#.....#.#.........#.#.#
.......#...#...#.............#.#
.....#...##......#.#.#..##...#.#
...........#....................
....#.#....#.####..#.#....#....#
...........................#....
....#...##..#.....###.###..#...#
................................
..#####.#.....##.#....##..#.....
.#....G........#.#...#..........
.#.........##..#......#.##.#.#..
...#...#...#.........#.....#...#
..##.....#...##.##.#.#.###...#..
.......#.#.........#............
.#...#.##...##.#.#....#.#.......
