16
.............#.#
.####.##.##..#.#
G#.....#.#...#.#
.#####.#.#.##..#
.....#.#.#...#.#
##.#.#.#.###.#..
.............#.#
.##.####.#.#.#.#
.#.#.....#.#...#
.#.#.#####.#.###
.#.......#...#S#
....##.....###.#
.........#...#..
##.#.#.#######.#
.....#.........#
##.#####.#######
