8
........
........
......G#
.#.##...
S#.#...#
##.#....
........
#.#.####
