64
.....#.....#...........#.............#...........#.............#
...#...#.#.......#.#.###..##...##.##...#..#..#.....#.......#....
.#.#...#...#.................#...#.....#...#...........#........
.#..#..#.#.##..#.#.##.##...#...#.#.###.....#..#...#...#..#......
.#.....#.#.....#.#.....#.#...#...#.....#.........#.....#.#......
.#.#.#.#.##..#....#..#..##....##...##.##...##......###...###.#.#
...#.#.......#.......#.....................#.....#.....#.#...#..
#........#.#.#..#..#.......#.#.##....#.#.#.#..#....#.#.#.#..#...
...#.#.#...#.........................#.......#...#.#............
.#...#...#.#..#..#.###...##........#.###..#..#.#...#...#..#.....
.........#.....#.#.#...#.....#.................#.....#.........#
....#...##.#...........#...#.####....#.#.#.......####....#...#.#
.#.#.....#.#...#.....#.........#...#.#.......#..................
.#..###.#..#.#........###.....##...#.#...#..#....#...#.#....##.#
.#.#.......#.#.#...#.............#...#.............#............
.#.#.##..##..#...........###.#.#..###..#.#......#..#............
.......................#...#.......#.....#...#...#.#.....#......
.##..##..#.#..#............#...#.#...##....###...#...#.#.#.#.#..
.#.....#...............#.......................#.....#..........
...##......#.#.######.##..##.##....#....###.#..##.####.#.#.#....
..S..#...#.#...............#...................#.......#...#.#..
.##..###...#.........#.##..#.#.......###...#####...#...#...#.#.#
.......#.....#.....#.#...........#...#...........#.....#.#...#.#
##.##..##..#....#.##..###..#..#....#....#...##...#....#..#.....#
...........#.................#...#.....#...#...#.....#...#...#..
.###...#...#....##.##..#...#.#...#..#..#.......#...#.#.#........
...#.#...#.............#...................................#...#
...........#.....#.........#.#...#.##..........#.#...###.#...#.#
.......................#.#.......#...........................#..
....#..#.#.........#.###.#....#..###.#..###..#...#.......#..##.#
.................................#.............#...........#....
.#.###.#.#..#.##...###......##.###.....####......###.#.##..###.#
.............#.............................#.......#.#.......#..
.#.#.##....#...#..##.......#.###..#..###.#..#..#.....##..#.#.#..
.#.....#...#.#.....#.#...#.#.......#.#...........#.............#
.#.##..#...#...#.....#.#.#..#..#...#.#..#.########.###..###.....
...#.#.#...#...............#...#.......#.........#...#..........
.#...#.###...##.###.###....#.###...##..#..##.#.#.#....#####.#...
...#...............#...#.........#.........#.#.#...#.#.........#
.....###.##...##.#.#.#...###.#.#...#.#.#.....#...#...#...#.#...#
.........#...#.......#.............#.....#.....................#
....#....#.###.#..##...#...#.#..#..##..#.#.#.###..##..#####..#..
...#.....#.....#.#.......................#.#...#...#.........#..
.....#.#.###.#...#..##........#....#.......#.....#.#..#####.#..#
...#.........#.#.......#...........#.........#.................#
..##.#...##..#..##....##.###.....#...###.#.#.#..#......#.#.##...
.............#.......#.....#.#...#.......#...............#...#.#
....##...#####.#...###..#..#...#...###.##....##.#.##.#.#.###.#.#
.....#.........#.......#.#.#.#...#...........................#..
####.#..##.....##.#...##.#..#..##.#.#...##.#..##.#...#...###....
...........#.#...#.......#.....#.....#.........#.......#.#.....#
....#..#...#.#...#..##.#..##..##.#.......#.....#....####.#.##..#
.#.....#.#.#.#...#.#.........#.....#...#.......................#
.###...#.#.....###.#.......#.#.#.#.###...#.#..#...####....##....
.#...#.....#...#...#.#.....#.....#.......#.#.........#.......#..
.#.#.#.#...#.#.##..#..##.........###.#...#..##.........#.#.#...#
.............#...#.#.......#................G........#.....#....
..#..#.####......#...#.#.#...#...#.#.##..#..#..##..#..##.#.#.#..
...#...............................#.........#..................
#..#.......#...#.##..##.#...##.....#.#...#......##.#####.....###
...#.#...#.#.................#.#.#...#.#.#.....#...#...#.....#..
......####.#..###...#.##...#.#.#.#...#.##..#..#...#.#..##..#...#
.............................#.....#............................
#.#.#.#..#.#.#........#####.####.##..#.#....###.##.#..#.#..##.##
