16
G..........#...#
.#...####.##....
...#...........#
.#...#....#.#...
.#.#.#..........
....#..#.###....
...............#
.#...#.#.#..#...
........S#.....#
.#.#.#.#...#...#
...............#
.#.#....#..#..#.
.....#.#...#....
.....#.#.##....#
.#..............
##.###.##.#.#...
