16
.#.........#....
.#.##.##.#.#.#..
...#.........#.#
.###...######..#
G#.....#........
.#.#..#..##.##.#
.#.....#.#.....#
.#.#...#.#..#...
.#.......#...#..
.###...#...#...#
.....#.#.....#.#
#.#..#..#...##.#
.#...#.....#S...
.#....####.#.#.#
...#.......#...#
##.####.#.###..#
