8
...#..G.
.#.###..
.#.#....
.#.#..##
.#.#...#
.#.#.#..
S......#
###.####
