8
.......#
..##.#.#
....S..#
.#..#...
.......#
.#..##..
G.......
##..#.#.
