32
.......#........................
##...#...####.#.......######...#
.......#.#.#.......#.#..........
.....#.#.....#..#...#..#.#.#...#
.............#.....#............
.##.......###....###.#.#....#...
.#.#.................#....S....#
...#.#.....###..##.#.....###.#.#
...#...#...#.........#..........
...##...#.#..##.##...#.......#..
...#.#...............#...#...#..
...#.#.#.#...#.#.#####..#....#..
...........................#.#.#
#.#..#.#.##..#.#..#...##...#...#
.......#.....#.....#.......#....
.#.##..#.###...........#.....#..
.....#.......#.....#.#.....#...#
.#...###.#...#.#.#.........#.##.
...#.......#...#.............#..
.#.#.#.....#...###.###.......#.#
.......................#.#...#..
..##.##.##.#.##..#.#.#.#.......#
.......................#.#...#..
...#.#..#####...####.....#......
.#.......#...............#...#.#
.....##....#...##...##.....###.#
......G........#................
.#..######.###.#...#.#..#.......
...#.....#...#...#.......#.....#
..#...#....#...#####.##.##..##.#
.......#.......................#
.##..#.#.##..#.##.##.#.#.#.#.#..
