16
.........#......
.#..#...#..#.#.#
.......#.....#.#
....#..#.#...#.#
.#.....#.....#.#
...#........##..
......S#.......#
.#.##...........
...........#....
.####..#.#.#.#..
...........#....
...#.....###...#
.........#......
.#..............
.....#.....#..G#
..####..#..####.
