64
.........................................#.......#..............
..#..#.#.#.####...#..#..##.#..#..###.#.....#.##...##..#..#...#..
.....#...............#.#...........#.#.#.............#.........#
...###.#.#......#..#......##.#.........#.#.#....#..#...##.##...#
.#.......#.#.......#.#.#.............#...#G......#.#.#.......#.#
#..##..#...##..................##....##.##.......#.#...#.#...#.#
.......#.#.#...........#...........#.....................#...#.#
...#...#......#..###.#.#####.##.#....#.###.###.#.#..##.###..#..#
.....#.#.......#.#...................#.......#.........#...#...#
..###..#...###......#.......####......##...#.#...#.###.#.##.#..#
.#...#.......#.....................#.....#...#.......#.......#.#
..#....#..#..###.###.#####.##..#.#...#.#........###..#.#...#.#.#
.....................#...........#.............#.....#.........#
.........#.#.###.#.#.....#.#.#####.#.#.#####...#..#..#...#...#.#
...#.................#...#.#.........#...#.........#.......#....
..#...##.#..##...#...#.#...##..#..##...#...........#.#..##...#..
...#.................#...#.......................#...#..........
#..###.#.#.##..###.#...###...#..###..##...#.#....#.....####.##.#
.........#.............#...#.#.......#.#...........#...#.....#..
.....#.#..##...#.....###..#.#..............##.##.#.#.#...#.#...#
...#.......#.#.#.........#.....#.....................#..........
.....#.....#.#.#.#............##.....##.#..#...#...#...#....#..#
.....#...#.....#...#.#...#.#...#...#.....#.............#.#......
.#.#.####...#..........#.#..#...#...#......#.#.#....#....###.#.#
...#.......#.....#.....#.....#.......#.................#........
.#..#.#...#....#...........#.###.##....#..#.#......#.##..#......
...........#.....#.....#.....#.....#.............#...#...#.....#
.#.#...#...........###.#.##.##.#...#..#.#..###.##...##...####...
.....#...#...............................#.....#...............#
.#.#...##....####.##.#..##....##...###.#...#...#....#..#.##..#.#
...#...#.........#.....................#.....#.#................
##.###...###...##..###...#.#.#.#..#..#..#.#......#.#.#..#...##..
.....#...........................#...#.........#.....#.........#
.###...##.#.#.......#####.#..##......#.###.#.............#.#....
.#.............#.#.....#.........#.......#.#.#.....#.#...#......
.#.#..#....##....##.#..#.###.###.#..#..#.#...#.#.....#.#...#.#..
.....#.........#.....#.................#.#.#.........#.#........
.#...#....#....#.#.....#..#..#.##....###.#.#.##...##.....#.....#
.#...#.#.......#...#.#...................#.#.#...#...#.......#.#
.........##..##.####.#..##.#.##.#.####.#.#.#.#...##..###.####..#
...#...#.................#.#.#.......#.................#.....#.#
###..#......#.##.#..##.#.......#####..#.##...#.###.#.#.#.##..#.#
.......#...#...#...............#...#.....#...........#.....#...#
.#...#...........#...#...#..#.#..#..#.##...#..##.....#..##.##..#
.#...#.#S..#.#.........#...#...........#.........#.....#.......#
#.#....#........##..#..#..#....#..####.#...#.#.....#..#..#......
.........#...........#.....#.....#.#...#...........#.....#.#.#..
.......#.#....#....#...##..#.#.#.#.#.#.....#.....#.#.###.#.#.#..
...........#.....#.......#...#.....#.....#.........#.........#..
....##..##.....####.##.#.....#...#...##....##.....##.#.#...#....
.#.................................#.........#.........#.#.....#
.##..#...###...#..##..#.#...#........##.##.#.#...#..####.#...#.#
.........#.....#.#.......#...........#.....#.......#.#...#.#...#
...##..##..#.#...#...#....##.##....#.#.#.#..#....#.#.#.##.......
...........#.................#.....#...................#........
.#.#..#........#....#..##..#.#.#.....###...#.#....#.##.#...#.#.#
...#.#.......#.....#...........#.........#...#.....#.........#.#
.#...#..#....#.#...#...#..####.##.##..##...#.#..#..#.#.#.#......
.#...........#.......#.#.............#.........................#
.#..#..#.....###.#..#..#.##..##..#..#..#....#....###...#...#...#
.......#...........#...#...#...................#.......#.#.#...#
......##.#.#..#.#....#...#.##.....#....#.##.#####.....##.#.#....
.....#...#.............................#.............#.......#.#
.########..###.###..#.#.#.##....#..##..#.#..#.######.##.#..#..#.
