16
...#.#..S#.....#
.#.#.#.#.###.#..
.....#.....#.#.#
.#....##.#.#.#.#
.#.......#...#.#
.#..##.#..#....#
...........#...#
.###.#.#.#.#.###
...#.........#.#
#....#.#.#..##.#
.#.#...........#
.#...##.##.#.#..
...#..........G#
.###.#####.###.#
.....#.........#
##.##.####.#..##
