32
...#...........................#
.#...###.#.######.##########..##
.#.........#...............#...#
...#.#...###.##.....##..##.###.#
.#...#.#.#.....#.#...#...#...#.#
...#.#.###..##.#.###.#.#.###.#.#
...#.....#..S#.#.....#.......#.#
##.#.###.##.#..##.#.##.###.###.#
...#.#...#.........#.......#....
.###.#.#...##.#.#..#..########.#
.#.....#...#.......#.#.........#
.#..##.###.##.#####....#..###..#
...................#.#.....#....
.#.#.#.#...###.##..#.###.#...###
.#.#.....#.....#...#...#...#.#.#
.#..#.#....#.###.#.##...##.#.#.#
.#...#.......#.......#.#...#...#
.#.#.###.###...###.##..#.#####..
...#...#.#.........#...#.....#.#
#.####...#..####.###.#####.#.#.#
.....#.......#...#...#...#.#.#.#
.#.#####.###.#####.###.#.###.##.
.#.......#.........#.......#...#
.....##.##..###.######.###.#.#.#
.#...................#...#...#.#
.#########.#.####.#..#.#...#.#.#
.........#.#.#...#.....#.#.#...#
.#.#######.#.#...#.#####.#.###.#
.#...#.....#.#...#....G#.#......
.#.#.#.#####...#####.#.#...#.###
...#.........#.................#
..#######.############.#.#.###.#
