16
................
..#....#..##....
.....#.........#
....##.#.#.#...#
............G#..
.#...........#.#
...#.......#.#..
.#.##..###.#.#.#
...........#...#
...#.##..####..#
...#.......#....
.#...#.#.#....##
S#.......#.#...#
.#.......#...#.#
...#...........#
###.##.#.#.###.#
