8
..G.....
.#.....#
.#......
..#....#
.......#
..##.#.#
....S..#
.##.#..#
