16
.........#......
.#.......#..##.#
...........#..G#
.....#........#.
...#...#...#....
##.#.#.#...##...
.......#........
...#........#...
.#.....#........
.#.#..#..#...###
.#...#.....#....
.#.##.......##.#
...#.......#...#
.###...#.....#.#
......S#........
#.##....##.#####
