64
...............#.....#...............#.........................#
...#.##..##....#.......#....#.#####..#.#.#...#.#####.#..###..#.#
.....#.......#.....#.#...............#.............#.#.....#...#
.......##...#..#.#..#.#....#.###.#...#...#.#...#.#.#.#.#...#..#.
.#.....#.........#.....................#.........#.#.......#....
.....##.#.#....#.........#.###..##.#####...#..##.#.#...........#
...........#...#.............#...............#.......#.........#
.#.#.####...#..#####....#..#.#...#.........#...#.#...#..####...#
.....#.................#...#.#.#.............#.....#...#........
..#.........##.#.#..#........#.......#.#.....###.#.#.......####.
.........#.#...#.........#.............#.......................#
.#.....#..#......#.#.#.#...##.##.#.....###.#...#...##..#.###.#..
.....#.......#.......#...........#.....#.....#.#.............#..
.###.#.###.#.##.......#..##..##..#.#.#.....#...####.##..#..##..#
.#.......#...#.....#.....#.......#.#.........#...#..............
...#.#....#..###...##..###.#....#..#..###..#.....#..#..#....##.#
.......#...#.....#.....#..S....#...........#...#...........#....
.#....##.....#...#.##..#..#....#...#...#.#.##..#..##.#..#.##.#..
...#.........#...#.....#...........#.................#.....#....
.#.#...#.#.....###..##.#.#......#....#.###..####.#.#..##...#.#..
.#...#.....#.#.....#.........#.......#.....#...#................
###..###...........#.#.#.#.#.....###.#.#.#.#.....###.###...#.#..
.........#.#...#.#...#.#.....#...#.....#.#.#.#.#.......#.......#
.####..#.#####...###.#.##.#..#.#.#.###.......#...###...#...#.##.
.......#.....#.#.....#.#...............#...#...........#........
.#.#.#.#.....#.##....#.#...#.###...#.#..####..##..#.....##.#....
.......#.......#...............................#.....#.#...#.#.#
.#.#.#..######.#...#..##..#....###.......#...##..........#.#.#..
...............#.#.................#.......#.......#...#.#...#.#
.##....#.#.......#.###....##.#.........###....#####..###...#.#.#
...............#.....................#.........#...#...........#
...##....#.....#.#...###...###.#.#.#.....#..##.#.#.##...#.#..#.#
.........#.#...........#.................#...#.......#..........
##...#.#.##....#.#...#.##....###.##...##..#...#..###.###.#...#..
.............#.#...............#.#.....#...#...#...#............
.#.#....#.#.#.....##.###.......#...#.#...#.....##..#....##..#...
.............#...................#.....................#........
...#.#.###.#.##......###.....#.#.#....##.....#..#..#.#....##.#..
.........#.#.......#.......#.......#.................#.#.......#
...#.#...#..#.##.#.#......#.##..###..#.#.##..#.......#.....#....
.....#.......#.#.#.....#...........#.....#.........#.....#.....#
.......###...#.#.#.#.#.#...#.#..#..#.#####......##.#.#.#........
.............#...#...............#.................#...#.#.#....
.....###.#...#.#.#.#..##.#.#..##...#.#...###.###.#.......#.#.#..
...#...#...........#.................#...#.......#.#...#.....#..
...###.#...###.#.##..#.#....#..#.###..#....#..####.#............
.#.............#.............#.............#....................
...###.#.###...#.####..#...#..##.#.##..#.#...#.#...#...##..##...
.#.........#...................#.#.........#...#...#...#.....#.#
.##...#.#...##.....#.#.##.##...#.#...#.#...####..#...#.#.##..###
.........#.....................#.....#...#.....#.#.....#........
...#.#...#.#..#...#..##......###.#..##.#.###.#.......#.#.#.#...#
.......#.#.#.#.........#.#.......#.......#.......#.........#....
...###.#.##..#.##....#.#...#.........#..#..#...#.#.........#...#
.....#...#...#...#.#.....#.....................#.....#...#...#.#
####.....#.###.#.....##.................#....#.....#.#.#.#.#.#.#
.................#.#...........#.....#.....#...........#.......#
.........#.#.#.#...#..###....##..#..#..###.........###.........#
.#.........#...............#...#...............#...........#....
.#.......#...#..#..#.#....#.#..#.##.#.#.#....###..##...#.###.#.#
...#G#...#...........#.#.#.............#...#...........#...#....
..#.......###.##...#........###.....##...###.#.#.#..#.#....##...
...............#.............................#..................
###.##.#.#.#.###..#.##..#..####......#.########.#.#.#####......#
