8
........
.#.###.#
G.......
..#.##.#
.......#
##.#.#..
...#S...
##.#.##.
