16
...............#
.#.###.#.#####.#
.......#.#......
.##..#.#.#..##..
...........#....
.#.#.#.#.#...##.
.#....S#.......#
##.#..##.#..#...
...#.....#......
.###..####..##.#
...........#...#
...#...#...#...#
.....#.....#.#..
...#..####.#.#..
..............G#
...#..##.#.#....
