32
.........................#.....#
.#..##.#.#.#....##...#.#.#..##..
...#.......#...#...#...#.#......
..##...#.#..#.##.#.#.#.#.#...##.
...........#...........#...#....
.#.##..###....##.##.......#.....
.#.........#.#.#.#..............
..##......##.....#.....#.#......
.......#.........#..............
...#..#...#.##...#.#.......#.#.#
.........#.................#....
.#..#.#.#..........#.#.....#.###
S#.....#...#...#...........#.#.#
.....#.#.#..##.####.....###..#..
.....#.....#....................
.#.......#.#..#..#.##....#...#.#
...............#.......#.......#
...######..#.#...#.#..###..#.#.#
.............#.#...#......G....#
.......###...#.#.####.#....#.#..
...........#...........#........
.#.###.###..#.#..#.#.###.#....##
.............#.....#.....#.#.#.#
.#.#..#####..#.###.#...#.....#..
.#.#.#.............#.......#....
...#...##..##......#.......#...#
.........#...#.#.......#...#...#
......#...#..#.#.##....#..#..#..
...#.......#.........#.....#.#.#
.....#.....#...#.##.#........#.#
.....#..........................
##.####.#..##.##.###.##...#..#..
