64
.......#.....................#...............#..................
...#.###.....#####.###.#.#.#..........##..##.....###.....#...#.#
.#.....#.........#.......#.#.#.....#...#.......#.#...#.#...#...#
...###...##..#...#.#.###...#.......#...#.#.##..#.........###.#.#
.........#...#.#.....................#...#...#..............G#..
.#....###..#.#....#..#..##...#..#..#..##......##.......#.#.##...
...#.............#.....#.....#.....#...#...#...........#.....#..
.#...#.##.##...#...#..##....#..###.#.#.#....##.#.....#...#.#...#
.....#.#.......#...............................#...#.#..........
.#.#...#......#....#.###..#####.....##.#...#.#.#.........#..####
.....#.#.#...#.....#.....#.........#.....#.....#...#...#.......#
.#.#...#.#...#...##......#.#.#...##..##.##.#.##....###.#.#.#....
.......#.....#...............#.........#...#...........#.....#.#
.#.#......##.##..#..#...##.#.#......#........#.#.#...#...#.##..#
...........#...........#.......#...............#.....#..........
.#..#.#..#...#...#.#.##...##....#.#..##..#.###...##...#..##..#..
.#.......#.......#...#.............#.....#.......#.....#........
...###.#.#.#......##.#.#.###.###.........#.#.#...#.....###...#.#
.........#.......#...................#.............#.......#....
.......#.........#..###......#.......#.#.#.#.#.#...#.###........
.....#...........#...#.............#.........#.........#.......#
.##...#......#...#.#.#.#.....#.......#...#...#....##.#.....#..#.
.#.......#...............#.....#.....#...........#.....#.....#.#
.##..#.#.#...#.##.#..#.....#..##.....#.#.###....##.......#.#....
.#...#...#.#.....#.....#...#.....#.......#.........#.#..........
.#....#..#.#..#.#..####..#####.###.....#.#.#............###.##..
...#.....#.#.........#.........#...........#.......#...#...#...#
....#.......###....#.#.....#.#...#....#..##..##..#.#.##........#
...#.#.#.......#.....#.........#...................#...#........
.....#.#.#.#....####.#.....#.#.#.#.........#..##.....#.#.....#.#
.#...#...#.....#.......#...........#.#...#.#.........#.......#..
.#.#.#.#...###.#.##..#.#..#..##..#.#.#.###....#..#...#...#.....#
.....#.#...#.........#...#.#...........................#.#.....#
.#.###.#...#........#.......###....####.#..#..##.#...#.###......
.......#.......#.................#...............#...#..........
#.#..#.#..#....###.#.###.#...##....#...#.###....#..#.#.#....##.#
...#.................#.....#.....................#...#.......#..
#....#.##.##....#..#.#.####....###.#.#.##....#.#.#......#.#..#.#
.....#.....#.......#.......#.....#...........#.#.........#...#.#
.#.#.###.....#...#...#..#..###.#.#..##.#.#...#.#..##.##..#.#.##.
.#.....#...#...#.#.#...........#.#.#.......#...............#....
.#...#.#.....#...#.#.....#####...#.#.#####.#.#.....##..#...#....
.......#.....#.......#.............#.#...................#...#.#
.#..##.....#....##...#.#...###.#.#.#...#....##.#.#.#.##.#.#.#...
...#.....#...#.....#.....#.#.......#.#.............#.#.........#
..#......#.###.##.#..##.#..#.#.#.......#.###...##..#.#.###.#.#.#
...............#...#.......#.#.........#...........#.#.#...#....
.##....###.#.###.#.#...#.###...####.##...#...#.#.#.#.#.#.......#
.................#...#...#...#.......#.............#...........#
.#.##.#.....#........#...#..#..#.#.#...#...#.#...###.#.#.....#.#
.........#...................#.#.........#.........#...#.......#
.....#.#.#.#.......#...#........#...#....#....###..#..##....##.#
.....#.#.#.......#...........#.......#.#...#.....#.#.#...#.....#
.##.#..#.#.......##.....#.###.#..#.#.....#.....#.......##..#..#.
...#...#.............#...#.......#.#.........#.#.....#..........
.....#.#.#.....##.....#..#..#.#....#....#......#.##..##.....#..#
.#.#.......................#.....#...#.........#.........#......
.#.###.#..##.#.#..#..#####.#...#.....##.#..#..###..#.....#.#...#
...............#.........#.......#...#.......#.......#.....#...#
...#...#...#...#..####.#...##..#...#.#...#.#...###.###..#.##.#.#
...........#.........#.#.#...................#.......#.#.#.....#
.#.##.#..#...............#.#..#..#..##.....#.#.#..#....#.....###
...........#.........#.#.....................#....S....#........
.###...#..#.#..##..##.##.......#....####.###.#########.##.###..#
