8
G..#...#
...#...#
.....#S#
...#.#.#
.#.#....
.#.#...#
.#......
#...####
