64
.......................#.................#.................#...#
.#.#.###......#.#####......#.#.#..##.#...#.#.#..###.####........
.....#...#.#.#.......................#.#...#.............#...#..
.##................###.#...#.#.#.#.....#.###.###.#.....####.....
.....#.........#.....#...#...#.......#.#.....#.........#.......#
...#.#...##.#..#.#.#.......#....####...###....#..#...#.#.##..###
.............#.#.....#.#.................#.#.#.......#.........#
..#..##.#.##.#...###.#..######..#..#.#...#.#.#.#..##.####.#.##.#
...#............................G..#...................#.......#
...#.###.#..###.#........#.#######...##.##.#.##.##.#.......#.#..
.........#.................#.....#...#...........#...#...#.....#
...#...#.#...#.....#####...#.##....#...#####.....##..####..#.#.#
.........................#.......#...#.........#.#..............
.#.#..##.#.###.###.#.......#..##...#...#.##..#...#..#......#...#
.........#...............#.#.....#.............#.........#...#..
..#...##...#.#.....#.#####......#....#.....###.#.##....#..#.....
.........#.#.......#...................#.#.........#.........#..
..#.#.#..#....####.....###.#..##.#....##.#....#....##.#..#..#..#
.........#.#.#...#.......#.......#.......#...............#......
......####.#...#...#.##...#.#..#.#.#....##....#.....#..#.#.#....
.#.............#...#...#.......#...........#...................#
.#.....###.#.....#####..####...#.#.......##..#..##.#..........#.
...#.#.....#.................#...#.................#.......#...#
.##..##..........##..####..#...###.##..##......#.#.#...###...#..
.#.........#.#.....................#.....#...#.#...........#...#
...#.#......#....#..#..#.##.......##.##...#....#.#......#..#...#
...............#...#.............#...#.......#.............#...#
.#......#..###.#..###.#.##..##.#...#.#..##..#...#......#...#...#
.................#.........#...........................#........
.....#.#####.....#......#..##.#..####...###..##.##...###.###.#..
.............#...................#.......................#.#...#
.#.####..#.#....#..........##..#.....#..##..#.......#....#.#....
...#...........................#...#.................#.#........
.#.#.#.....#.#.#.#...##........#..##.#...#..#....##..#...##.....
...#.........#.#.#.#.......#.#...........#...#...#...#.........#
##....#..#.#.#.......#...#.....###.....#......##..####.....#.#.#
...#.............#.....#.#...............#.#...............#...#
.#.#.#....#...#....#...#..#.##.....#..#..#..##...#.#####.....#.#
...#.............#...............#.#.#.......#.#...........#....
...#...#.#.###.#.#.#..##.#.......##......#.#.#...#.##..###.#.#.#
.#...#.....#.......#.........#.......#.#...................#.#.#
.##..#...###...#.#...#...#.#.....###.#.#.#...#...#....#.#..#...#
.......#.........#.#.#.....#.#.....#.....#.#.........#.......#.#
..#.##.#.....##..#.#.###...#.##..#.#.#...#.####....#.#.#####.#..
...#.....#.#.............#...#...#.#.#.#.....#.............#...#
.#.#..##.#..#..##..........#.#..##.....#...#.#.###.####.#..#.#.#
.#...#...........#.....#...#.#.#.............#...#.#.........#..
.##....#...###....##.##..###.....##.#.#..#.#.........#.#.#.#..##
.#...#.#...#...#...#.......#.........#.........................#
.....#....##.#.#.#...#.#.#...#...#......#..#.#...###.#......##.#
.....#.....#.........#.............#.......#.............#......
.##......#.#...#..##.#...#...###.#.#.##..#.#.#.#.##.....##...#.#
...#...#...#.............................#...#...#..............
.........#.#..####.####....###.#.#.#..#........#.#...........#..
.............#.............#.......#.#...........#..............
.....#.##....#.##.##.#.#.#...##....##...#.##.###.#.......#.#...#
.............#...............#...#...................#......S..#
.#.......#.#.#.###...#..#.#...##.#...##.##..#..#.###.#.##.#.....
...#...#.....#.........#...#...................#.............#.#
.#.....##..##.##...#..#...#....##.#.#..#...#.......#.#......#...
.....#...................#...#.........#.....#.#.......#.......#
...#.#...#.##..#...#.#.#.#.##..###.##....#.#......#.#....#.#....
.....................................#.......................#.#
.##...#..#.##...##.#..##..#....#.#.####.##.#.....#..#.#.##.##.#.
