8
......G#
.#.###..
.#.....#
.#####.#
.#S.....
.#.#####
........
#..#####
