64
...#...............#...#.................#...#.......#.....#...#
.###.#...##..#.#.#.#.#.##....##..##..#####.#...#.#.#...###.#.#.#
.....#...............#.....#.#.#...........#...#...#...#.....#.#
.#####.#####.#...##.####.#.#.#.#######..##########.#####.#####.#
.#.....#...#.#...#...#.....#.#.#.............#...........#...#.#
.###.#...#.#.###.#...#.#####.#.#.#.###.####.##..####....##.#.###
.....#...#.........#.#.#...#.#...#.#.#.#.......#.....#.....#...#
.##..#.#.####...####.#.#.#.#.#####.#.#.#.##...##.#.###.######..#
.....#.........#...#...#.....#.......#...#.......#..............
.#.#####.###.#.#.###...#.#.#.#.###.#...#...###.#.#.#########.#..
...........#...#...#.....#.#.#.#.....#.....#.....#.......#..G#.#
.#######.#.##..###.#.#.#####.#.#.###.#.####.####.#.#####.##.##.#
.....#.......#.....#.......#.#.#.#...#...#.....#.......#.#.....#
###....##.##.###.#..#####..#.#.#.#.#.###.#.##...#......#.#..##..
.....#.....#...........#.#.#...#.#.#.#.#.#.#...........#.#.#....
.##.##..##.######.##.#.#.#.#######.#.#.#.#.###.#...#.#.#.#.#.#.#
.......#...#.............#.......#.#...#.#...#.......#..........
########...###...#######.#.#####.#.#####..##.####.######.#.#.###
.........#...#.........#.......#.#.....#...#.#.....#.....#.#...#
.#.##..#.#.#.#....##.#.#.#####.#.#.#.#.###.#.#.###.#.#.###.###.#
.#.#...#...#...........#.....#.#.#.......#.#.....#.#.#...#...#.#
.#.#.#.###.#.#.#..#####.##.#.#.#.#.#.###.#.#..####...#.#.#.#.#.#
.#.#.......#.#...........#...#.#...#...#.#.#.....#.#...#...#.#.#
.#.#########.#.#######.#...#.#.##..##........#.#....##.###..##.#
.#...#.......#.....#...........#...#.....#.#.#.....#.....#.....#
.###..####.#####.#.#....#.##.#.#.##.####.#.###..####.###.#.#..#.
.#.#.#...#.#.......#...........#.......#.#.....#...#...#...#...#
.#.#.#.......###.#...###.#.###.#.#.###.#.##.####.#.###.#######.#
...#...#.........#.....#.....#.....#...#.........#.#...#.....#..
##.#.#.#.####.##.#.#...###########.#.#.#.#.#.##..#.#...#..##.#..
...#...#.............#.#...#.......#.....#.#...#.......#...#...#
..##.#.#.##...#######..###.#..##########.#####.#.#####.#.###.#.#
.#.#.#...........#.........#.#.........#.......#...#.#...#...#.#
.#.#.....##.###..####.######.#.###.######....##.##.#...#...#...#
.#.#.....#.....#....S#...........#.........#.....#.#.....#.#.#.#
.#...########..#..####.#...##############.#..###...#.#####.#....
...#.#.#.....#.....#.....#.#.......#...........#.#.......#...#.#
##.#...#.#.#.#.###.##.#..###.##.#..#.######...#..#######.###.#.#
.....#...#.....#.........#.......#...#...#...#...#...#.......#..
.##.##.###.###.#.#####.#.#.###.#.#.###.#.#...#.#.#...#..#.####.#
.#...#...#.#...........#...#.......#.....#.#.........#.......#.#
.#.###.#.#.#.#...#.###.#.#.###.#.#..##.#.#...###..#.##.#.#...#.#
.#.......#.#.#.#.#.....#.......#.....#...#.#...........#.#.#.#..
.#...#.###.#.#.#.#.#.#.####..#.##.##.#.#.#.#..####...###.#.#.#..
.#...#.....#...#.....#.....#...#...#...#.#.#.#.........#.#...#.#
..#.##.#######.#.#...#.###.#.#.#.#.##.#..#.###..#.######.#.###.#
.......#...#...#...#.......#.....#.....#.#.......#...#.........#
.#.###.#...#.#.#.###########..########.#####.####....#..###.##.#
...........#...#.#.....#...#...#.......#...........#...#.....#.#
..##.#.#.#.###.#.##..#.###.#.#.#####.#.#.######.#.#######..#.#.#
.#...#...#...#.#.....#.............#...#...#.....#...........#.#
.#.#.#..####.#.####..#.#.##..##.#....#.###.#.#.#.#.#..###.####.#
.#.#.....#.#...#.............#.#...#.........#.....#.#...#.....#
.#.#.###...#.#.#.#.#.#######.#.#.###.##..###.#######.#...#.#####
...#...............#...........#.#.......#...........#.#.#.#...#
#.##.#.########..#.#.#####.#.###.#.#.#..#..####..#.###.#.#...###
.....#...#...#.#...........#.#...#.#.#...#.....#.#.....#.......#
.#######.#.#.#.#.####....#.###.###.#.##..####....###.#.####..#.#
.......#.#.#.#.......#...#...#.#...#...........#...........#.#..
.#.#.#.#.#.#..#....#.##.#..#.#.#...###.....##.##.#..####.#.##..#
...#.#.#...#.....#.#.....#...#.#.#.........#...#................
####.#...#.#.###....####.#.###.#.##..##.##.###.#######...#.#.#..
...............#.......#.......#.......................#.....#.#
####.######..#.###.###..##########.############.##...###########
