16
...........#...#
..#.##.#.#...#..
.....#...#.....#
.#.....##....#..
.#...........#..
.#.#...##.##.#..
.#.....#...#...#
.#..##...#..##.#
S...............
.#.#...####..#.#
.....#........G.
......###......#
.#...#.....#.#.#
....##.....#....
................
####.#.##.#.#..#
