64
.#...................#.....#...................#................
.#.#..###.#..#.##..#.##....#..#......#.##.####..##.#.#.##..#.#..
...#.#.....#.#.............#.#...........#...................#..
#..#....##....#..#.##..#.#..#....#.##..#.#.#..#..###.#.#.#.....#
...............#.#.#...........#.............#...#..............
....#......##......#...###.....###..#.##.....#.###...........#..
.............#.#.....#...#.........#.......#.......#.....#.#....
.#..##..#..#.#...#..#......##.####..##..##..#.##.#..##...#...###
...........#.....#.....#...#.....#.....#...#...................#
#..#......##..####.#.......#..#..#.......###...##..#..#.##.....#
.....#.#.#.#.........#.#.............#...#.........#.....#.....#
..##..#......####...##........####..#..#...#.###.#.#..#....#....
...#.....#.#.......#...........................#...#.#.........#
....#..#.#.#.....#....##..##..........#.....##..####.#.#.##.##..
.#...........#...............#.....#.....#...#.................#
................##.#.......#...#...#...#...#..##...#.#.#........
.......#...............#.................#...#.....#...#...#....
#..##......#.....##..#.#.........##....#.............#.........#
...#.............#.....#.#.....................#...#.....#......
.#.#...###.#.###.#.#.##....#...#...#..##.#.#...#.....#..##.#...#
...#.....#.....#.........#.#...#...#.....#.#...#.#...#...#...#.#
....#..#.#...#..###....#.#.###.##..........#...........#.#.#...#
.....#...#...#...........#.#.................#.............#...#
.....#.#.#.#...#......####.#.##..#...#..####.#...#.###.##....#..
...............................#.....#.....#...........#G.......
#####....###.#.##.#...####..##..#..##........##..........####...
.............#...........#...........#.......#.......#.......#..
.#.#.#.........#.#.#.#.#..##..##.#.....#.#..........#####..#.#.#
.........#.#.............#...#.#...........#.#.....#.....#.#....
....##.....##....##..#...#.###.#.###....#....#.##....#.#...#....
.........#.....#.......#...#...#.#.....#...............#...#.#..
..........#.....##.......#.#.#...#.##...###..#....#......#.#.###
.#.........#.#.....#.........#...............#.#.........#.....#
.#.#..###..#.#.#...#....##...#.#.....###.##....#...#...##..#...#
...#...#...#...#.#...#.......#.......#...#.#...........#.....#..
##.#.#.....#..##.##.##.##......#.#.#....##.#.###....##..#..##...
.......#.................#.#.#.#.#...........#.......#.........#
.#.##..###...#.........#.###.....#...###...#...#..#...#.......#.
...#.................#.....#.......#.....#.#...#.#.......#.#...#
.....########.##.....#.##....#.##..#...#...#.#.#....##..#.##...#
.#.#.............#.......#.....#.........#.#.....#.....#.......#
.#.##.#.#..#...##....#....###......#.#...#.#......##...#....#...
...#.........#.....#.........#.#...#...#.#...#.#...............#
...#..##....#..#...###.........#.#.#...#.###....##...#...##.##..
.................#.......................#...#..................
.#.###...#.#.#.#...#.###...#.##..#.#.....#.##..#.........##..#..
...........#...............#...#.....#.............#...#.....#.#
....##.###.#...#...#.#...#.#.#.#..#......###.#.#.######....##...
...#.....................#...#.....#.#.........#.#.......#.....#
...#.#...###.#.#.#..#..#.#.#.#..#..#.#.........#.#.##..##.###..#
.#.#.......#.#...#.....#.....#.....#.#.................#.......#
#..#.....#.......#.#.#..#####......#.#...........##.####.#.....#
.....#.............#.......#.............#.....................#
.#..##...#..#..##.#..#...##....#.##...#.##...###....###.######..
.....#...............#.............#.....#.......#..............
..#....#.#.#.#...#.#...#....#.###..###.#.##..#.#.#.#..#.#####..#
...#.......#...........#.......#.......#...#.......#...........#
#......#.....#..#..#....##..#..#..#.##.###...#.#.###.....###..##
.#...#S....#.#.....#.#.........#...#...#.......#...........#....
.#...##.#..#.#.....#.##...##.#..##.#.#.#.#.#.#...#.#..##.#.#.#..
.......#.......#.....................#.#.....#.#.........#.#.#..
...#...##.####.#.......#......#..#...#...#.#...#..##..##.#.#.#.#
...............#.....#.....#.....#.............#.....#..........
#...##..#..###..#.#...#..##......#..##....#.##.#.#.#..#....#.#..
