8
G......#
.#####.#
.#...#.#
.#.##..#
...#S..#
##.##.##
........
###.####
