32
...#.#.....#.....#.#...........#
...#.#.##..#.....#.......###.#.#
.#...#...#...#.....#.....#......
.#.##.#..###....##.#...#.#.#.#..
.#...........#.#.........#.....#
..#..#.###..##.#.....##.##..##.#
......S........#.#.....#.#...#.#
.....###.####....#.#......#..#..
.....................#.#.......#
.##..#.#.........#.....#...#....
.#.....#.....#.......#.........#
...#####...#.##.##...#.#...#..##
.........#.#.....#.....#...#...#
...#.#........##.#..##.#..####.#
.#...#.......#...#...#.....#....
.#........####....#..#.......#.#
.#.........#...#...#............
...#......##..#.....#..#..##...#
...#.#...#...#...#.....#........
...#...#.#...#..#.##...#.#..#..#
.#.....#...........#.........#..
...#..##.#.#..##...#......#..#.#
.#.#.........#.....#...#...#....
.....#.....#...#...##........#.#
...........................#....
##.#..##.....##.......#.##.#.#.#
.#.........#.#...#...#.....#...#
.##.##.......#.#.#.#...#.###.##.
.......#...#.#.......#.#........
...............#.#.###...#...#.#
.................#........G.....
..#.##.#.##....#.#.####.####.#.#
