8
...#..G.
...#.#..
.#......
...#....
S..#...#
.....#..
.....#.#
.#.###..
