32
.........#.......#S..#.........#
.#.#...#.###.###.###.##..###.#.#
.#.#...#...#.......#...#.....#.#
.#...#####.###.######..#.#.#.#.#
.#...#...#...#.#.....#..........
.#.#.#.#.###.#.#...#.#.#.#.#.###
.#.#...#...#...#.......#.#.#....
.#...###.#.#.###.###.#.#...#####
...#.....#.#.#...#.#.#.#.#......
....##.#.###.#.#.#.#.#.#.##..#..
.............#...#.#...#.....#.#
####.#.####.####.#.##.######.#.#
.#...#.#.......#...........#.#.#
.#..##...#####..######.###...#.#
.....#.#.....#...........#.#...#
.##.##.#####..####.#..##.#.#.#.#
...#.......#.....#...#.#...#....
####.###.######..#####.#####.###
.....#...#.........#...........#
.#.###.###.##.####.#.#####..##.#
...#...#...#.#.......#.......#.#
##..####.#......####.#.#####.#..
...#.....#.#.....#.....#.....#.#
.#.#.####....#####.#####.#..##..
.#.#.........#.........#.....#..
.#.#...#..####.###.#.#.##.##.#.#
.#...........#.#.....#.....#.#.#
.#.#.#.#####.#.###.#.#..#..#.#.#
.#.#...#.....#...#.#.#.#...#....
.#.#.###.#....#..#.#.#.#######.#
.................#..........G..#
#.#####.#####.#######.##.####.#.
