32
...#...................#........
...###.###......#...#.....####..
.#.......#.....#.....#.........#
.#.#.#.....##....#.#.#.#.#..#...
...#.........#.............#.#.#
.....##...#......#.####....#.#..
...#..S................#.#...#..
...####..#.###.#.##.##.....##...
...#.............#.....#...#...#
.#....####.#.....#.##..#.#.#....
.....#...#...#...#...........#..
..##...#.#.#.##..#..##.....###.#
.....#.#.........#...#...#......
#.##.#.#..#...####.#.#.#......##
...................#...#...#...#
.#.#..#..###.#.#.#.......#...###
...#.........#.#...#.#..........
.#.#...###..#...##..#....#.###..
...........#.......#.........#..
...##....##..........#.#.#.###.#
.....................#..........
..#..###.##..#..##..#..#.....#.#
.........#....................G#
.#.##....#...#####.#.#####.#####
...#.#.....#.#.................#
..#..#.#.#...#..#.##.##..###...#
...........#.........#.......#.#
.......###.####.......##..##....
...........#.....#.....#...#....
.##.##.#.#.#.#.....#...#.#.....#
.......#.....#.................#
...####.#.##.#.###.#.###.#.##.#.
