16
.....#.........#
....##.#...#.#..
G#...........#..
.#.#.###.#...#..
.#.....#.#.....#
.....#...#..##..
...........#..S.
.......#..##.###
.#...#.#........
...#....##.#....
.............#..
.####.......##.#
.#..............
....#####.##.#.#
................
.##...#..###.#.#
