64
...................................#.............#...........#..
....##...#...##..#.#...#...##..#.#.#.##...####.#.#.#...#.###...#
.#...............#.....#.......#.........#...............#.....#
...##...#.#..###...#.##....#....###......#.##..........#.......#
.....#...#...............#......................................
...#...#...#....#...##.....##.#..#..#....#........##.#...#.#.#..
.........#.#.#.........................#.#.........#.#..........
.###.......#....#..#.....#######...#........#.#....#...###.###.#
...#...#...#...#.....#...........#.#...#.....#.....#.#.........#
.#.#..####...#....#..###...#.###.....##.#..#....##....#..###..##
...#.............#.....#...#.#.....#.......#.........#...#......
...#.#....##.##..#.#.....#.#....#####..........#...#.#.....###.#
.....#.#.....#.......#.#...#.............#.....................#
.#.#...#.##...###.##.....##.##....#..#.##..........#.###.#.....#
...#......S....................#.......#.........#.............#
...#.##......#..#.#....#....####...#.#...###.#.#..#.#.#...#.#...
.#.#.................#...#...........................#.....#...#
...#.....#....##...#......##.#...##......#....#....#.#..#....#..
.#.....#.......#.#.#.....#...#.#.#.................#.........#.#
.......#...#..##...#.#.......###.#.#...##.#..#.#.....##..#..#...
.................#.#.................#.......#.................#
.#.##.#####......#.#.....#..##.##....#...#...#.#...#.......#...#
.................#...#.........#.............#...#.....#.#......
.....#..#..#.#.#.....#.##....###...#....#.##.###.#.#..#......#.#
...#.....#...#...#...........#.................#...........#...#
##...#.##.#..##.......##..#...#.#..#.#.#.....#..###..#.#...#...#
.................#...........#.............#.#.........#...#....
.###...#####.#...#...#.#..#.##.#...#.###...#.##....#...#.#.#.#..
.............#.#.....#.........#.........#.......#...#.#.......#
....##.#..#.#..#.....#.#...#.#.#...#.#.#...####.##.......#.##..#
.............#...#.#.........#.....#.............#.#............
##...#.#..#......#.#######.#....#....#...#.......#....#....#.##.
.......#...#.....#...............#...#...#.#.............#.#....
.####..#.###.##..#....##.#.######.##.#..##..####..#.#..#.#.#....
.#...............#.........................#...............#...#
.#...####...#..#####...#..#....#...#.#.#...#...#....##..##.....#
.......................#...................#...........#.....#.#
.#...#.###...##..#.###...#.#...#.....####.#....###.#.....#..#...
...................#.....#...............#...#.#.......#.......#
.......#.....##......#.#.#.#.#..#....#..##.#.#.#.#.....##..#....
...........#.#...#.#...#.....#...#...#.#...........#.#...#.....#
....####.##....#....#.##..##.#.....#...#.#.....#..##.....#.....#
...#.......#.#...#.....#.................#...#...........#.....#
..#..#..#........#####...###..#..#.###.#.#.#.#.#.#.#...#.#..##.#
...........#.......#.#.....#.#.........#.........#.............#
...##..#...#...##....#.#.#...#.#..#..#.........#.#.....#.#..##.#
...............#...#...#.......#.......#......G......#..........
..#####..##.#..#.#.....#..#..#...#.....##.#....#...#.......#.##.
...#.#.........#.....#...#...........#.....#.........#.........#
#......#...#.#.#.#..#....#.#.#.#.#.#...#......##..#..#..#.##.#..
...............#...............#.........#.....#.#.........#.#.#
..###.#.....##.#..##.#.#...##...#.#....#.#.##........#.##..#.#.#
.........#.#.................#.......#.#.............#.......#..
....##...#......##..#.#.####.....##..........#.#...#....##......
.........#.#.....#.............#.........#.........#.#.......#..
.###..##.#.....#...#...##..##.####.#.#.#.#.#.#.#...#.#.#.###....
.#.....#.........#.#...#.......#.....#...#.......#.......#......
.....#.#...#.#..##...#.......#.#..#.##...#...#.....#.........#..
.#.#.....#.....#...#.........#...............#.........#.......#
...#.#...#......#...#.....##...#.##....#.#...#......##.#.##.#..#
.......#...#.......#...#.....#.........#...............#........
...###.#...#...##....##...##.#....#..#.#....##.....#..#.#..###..
.....#.........................#.........#.....#...............#
..#...###.......#.....#.#.###.....#####.#..#.##..#...###.#.#....
