8
...#...#
...#....
G....#.#
.##.....
...#...#
#..#.#.#
...#S...
...#....
