32
...........................#....
.........#.#..##...#.#.#.#.#...#
.............#S........#.#...#..
.......#.#.#..#...##..##.#......
.#...#.....#.#.................#
....###..#......###.#..#.##.....
.#...........#..................
..##...#....####.#..#........##.
.....#.#.#.....#.#.......#.....#
..##.#.#...#.#.....#####....##..
.#...#.....#...............#....
.#.####..#.#.....#.#.#..#..#...#
.#.........#.......#...#.....#.#
...#.####..#.#.#...##....##..#.#
.#.......#.#.....#.....#...#...#
.###.#.....###.#........##.#.#..
.....#...............#...#...#.#
.#.#.#.#....##.#.#...........#..
.....#.........#.......#........
...#.#.#...#....#####..#...##..#
.....#.#.......................#
##.#.....##.#...###..#.##..#.#..
.....#...#...........#.....#....
.#...............##.##.##...###.
.......#...#.....#.............#
###..........#.#...#....##.##...
....G#.......#...#.#.#...#.....#
..#.#..#.....#.##....#...#.#.#.#
.....#...............#.....#...#
.....#.##.##......#..#.#.....#.#
.................#.............#
..#.###.#.##.#...#.#..###..#.#..
