32
................................
...#.##..#...#.###...###..#..###
.#.#...#.........#.#............
...#.#.#.#.#...#..#.###.##.##...
.......#.#...#...............#..
...##...#..#...##.#.##..#.##...#
....S#.....#...........#........
.###.#.#.....###.........#.##...
.#...#.........#.....#...#...#..
...#.#.#.#.##....#.###...#..#..#
...#...#.#.....#.#.......#......
....##...#...#.#.#.###.#.......#
.#.#............................
.#.#.##..#.#.#.####..#.#.#..#.#.
.#.#.........#.#.......#.......#
...##........#.....###.###..#...
.#.....#.........#...#.........#
.......###...##...#..###.......#
...#.......#............G#......
.#......######.#.#.#...##..####.
...................#.......#....
.#....##.#..#......#.###.##....#
...................#...#........
..#......#.........#.#..#.......
.#.....#.................#...#..
...#####.....#.......###...#...#
...............#.....#.....#.#.#
.##....#.###.........####..#.#..
.........#.......#.#...#.....#.#
.#...#...#..#..###........#....#
.........#.............#.......#
#.#..##.......#.##.##..#..##.#.#
