32
.#.....#.....#.........#.......#
...#.#....##............#....###
.#...#.........#....S......#...#
.....##...#.....#..#...#.#.#....
.......#.....#.......#...#...#.#
###.....#..###.###.#...#..##.#..
.......#.................#.....#
.#.#.#...#.#...#.#.#...#.#.#....
.#...#.......#.#.....#...#.....#
.#.#....#..#.#...#...#..##.#.#..
.#.#.#.........................#
...........#.#..#..#.......#.#..
.....#.#...#.......#.#..........
.......#.#.#.###..#....#.#.#..##
.......#...#...#.....#...#......
.#.##.##...#.#.#.........#.#....
.#...#.........#...#...#........
.#..#..##..#....###.##.#.....#..
.............#.......#.#........
..#....#.#.#.###.##....##.###...
...#.......#.....#...#.........#
.#......##.##..##....#.#.#...#..
.#......G..........#.#.....#.#.#
...#.##...##.....###.#..#.......
.#...#...............#.......#.#
...#..........##.#.#...#.#.....#
.............#.................#
..###.....#....#...#..##...#####
.....#.......#...............#.#
...#........##..##...#...###...#
................................
#..#.#.###...##.#.##.###...#.#.#
