16
...........#..G#
##..######.#.#.#
.........#.....#
.##.####.####..#
...#.........#.#
##.#.###.#####.#
S..#...#........
####.#.#.#.#####
.....#.#........
..#..#.###.#...#
.............#.#
.##.##.#######.#
.#.....#.......#
.#.#.##...###...
.#.............#
#############.##
