64
...................#.......................#.............#......
...#.#..##.....##..#.##...#......#.#.#..#..#..#.#..##.##....##..
.....#...........#.......#.....#...#...#....G....#...#..........
.#...#.#...#.....####..#.#.#..##.....#.#.#.##..#..#..#.##..###.#
.#.........#...#.#.........#.....#...#.........#.....#...#......
......###....#...#.###.#.#.#..#.#.##.##.##..#.#.###...#....#.#..
...#.#.....#...#.........#.................................#.#..
.......#.#...###...#...#...######.###....#..##.#.#.......#.#.#..
.........#.......#...#...........................#...#.#.......#
.##..###.........##.........##.#.....##.###..#.#.#.###.......#.#
...#.#.....#.............#.........#.......#...#.#...........#..
.#.#...####......##....#.##..##....#.###.#.#.#.#.........#...#.#
.......#.....#...#...#.#.............#.............#...#...#...#
.###.##...###..#.#.....#.#.....#.##..#....####....##.###...#.###
.#...........#.#...#.#...#.#.#...#...#.#.#.................#....
.#..##.#.##......#.#....##.#.#.#####..........#.##..##.###.#.#..
...............#...#.................#.#...........#...#...#.#..
...#.#.#.......#.....#...#...#.#..##.#...#..##.#.#.#.####....#..
.....................#.....#...#...#.......#.#.....#...........#
.#...##...##.##..#.#.#.#...#...#.#.##.#....#.......#.#.#..#..#.#
.#...............#.#...#.#...#...#.#.......#.#.#.#...#.....#....
.##.#..#...#.#.....#...##......#...#.##..#.....#...#.......##..#
...................#.......#.......#.........#.#.#.....#.#...#..
.###.##.##....##.#..#.#..#.#.###..#..#....##.#...#..####.#.#.#.#
.....#.......#.............#.....................#.........#...#
.#.#........##.#......###...##....##..#..#..#.##..##.......#....
...#...#...#.......#...#.......#...#...................#.....#.#
......#......#.#.#...#...#...#...#.####....#.....#.#.##.###..#..
.#.....#...#.................#...#...........#.................#
.....#.....##....#.#.........##.#..#..###.#..###.#..##...#.##...
.....#.#.#...............#.#.......#.........#.....#.........#.#
...#...#.#...##..##...##.#.#...###.#.#.####....#...#.#...#...#.#
.......#.....#...#...............#...#.#...#.........#.......#..
.........##..#.###....##.#..##.#.#.#...#...#.###...#......#....#
...#...#...#.......#.............#.....#.#.#.......#.........#..
#..#.#...#....#..#.#..#.##.#.#..##...#...#...#..##.#.##..#.....#
...................................#.#.........#.....#.#.#.#...#
.#.#...#.......#...#....##...#...###.#.##.#..###.##....#.#.#.#.#
.#...#.#.#...................#.......#.....#...........#.#......
...#.#.#.#.#...#.....#.#...#.###.#.######......#...###.......#.#
...#.....#...............#.#.#.................#...........#.#.#
.#..##.#...#...##.#..###.#...#.#...#......#..#.#...............#
...........#.............#.........#.....#...........#...#.#...#
.###....##...#.#.###......#....#...#..##...#...#.#......##.#....
.#...................#.......#...#...........#.#...#.........#..
...#.#..#####...#..#.######.#.#.....#....#.#...#.##....#.....#.#
.............#...................#.........#.....#...#.........#
#.#.#..#.......#.###.#......##.#.#.....#...#.#...#.....##.......
.......#...#...#...............#.........#...........#.#.......#
.#.#.###...#.#.#.#.#...#.##..#...#.#..##.#.#.....##.#..#.#..##..
...............#...#.........#...............#.#.......#...#.#.#
....#......####.##.#.###.#.#.....#....#..#.#.......#...###.#.#..
.#.......#...................#.....#.#...#.........#.......#.#..
.#...###....##.#...#.....#.#.###...#.#.#.....###..##.#...#.#.#.#
...........#...#.#...#...#...........................#.........#
...#.##............#..#....###..##...#....##..#....#...#....#..#
.#.........#.......#.....#.......#...............#...#.....#....
.##....##.#.#....###..#...#..#.#...##...#..###....#.#..#.#.#....
.#...#.........................#...........#.....#.....#.#.....#
......#..#.#...#...#..####...##.#..#...#.#.....#.#.#............
.......#...#.#.......#S..................#......................
.#...#.#.#.#.#.#.....##..#..##...#.###...#....##...###..#.#.....
...................#.....#...............#.......#.............#
.###.#.####.###.#.#..#.##..##..####..#.#.#..#..#...#.#.#.##...#.
