16
................
.#..#####.#.##.#
...............#
.#.#...#...#.###
G#.....#...#....
....####.#.#.#.#
...#.....#.#....
..##.###.#.....#
.....#..........
.......#####...#
.............#..
....##.#.#.#.#..
.....#..S..#.#.#
.#.#...#.#.#.#.#
...............#
.......##.#.#..#
