64
...............#.........#...#.............................#...#
.#..#..#.###.###.#.#.###.#.#.#.#.###...###.#.#..##.#..##.#...#.#
.#.....#.....#...#.....#...#.#...#...#...#.#.#...#...........#.#
.#.#.#.#####...#.##.##.#####.#.#.#.#..#.##.#.#.....####..##.##.#
.#.#...#...#.#.#...#...#...#.#.#.#.........#.#...#.....#.#...#.#
...#..##.#.#.#.###.#...#.#...###.#.#####..#.##.#..##.#.#.#.#.#.#
.#.#...............#...#...#.#...#.......#.....#...#.#.#.#.#....
.#.#...#.####..##..###.#.#.#.#.####...####.##.##...###.#...#####
...#.#...#.......#...#.#.......#.......#...#..G#.#...#.#.#.#...#
.###.#.#.#.#...#####.#.#..#.####.#...###.###.#.#.#...#...###.#.#
...#...#...#.........#.....#.......#...#.#...........#.#.....#..
####...#.###.###.##.#..###.#.#####.#.#.#.#..######.###.####..#.#
...#...#.#.#.....#...#.#.....#...#...#.....#.....#...#.#.....#.#
...###.#.#.#######.#.#.#.#..#..#.######.#..#.###.#.#.#...###.#..
.#.#...#.#...#...#.#.#.......#.#...#.........#.#.#.#.#.#.#.....#
.#...#.#.#.#.#.#...#.##..##..#.#.###..########.#.....#.#.####..#
.#.#...#.#...#.#.#.#...#.........#.........#...#.#.....#...#.#.#
.#.#.....###.#.....###.#.#.#.#####.###.#...#.#.#..##.#.###.#.#.#
.#...#.#.....#.#.........#.#.......#.....#...#.#.......#...#....
.#...#####.#.#.########..#.#.#...#.#...###.#.#.###.#...#.#######
.....#.....#.#...........#.#.#...#.#...#.....#.#...#.#...#.....#
.###.#.###.#.##.####.#.###.#.###.#.##..#######...#####.###.##...
...#.#.........#.....#.#...#...#.#...#.....#...#.#.....#...#...#
##.######.####.#.#.###.####.#..#..##.#.##..#.###.#...#.#.##..###
...#.....#.....#...#...........#...#...#...#.#...#.#.#.#...#....
..#..#.#.#.#######.#..########.#.#.#.#.#.#####..##.#.#.#.#.#.#..
.....#.....#.#.........#...#.......#...#.......#...#.#...#.....#
.#####.#.###.#.#####.###.#.###.##..#.#.####..###.###.#.....#.#.#
.#...#.......#.....#.#...#.......#.#.#.#...#.#.............#....
..##.###.##....###...#.#.#######.#.###.#.#...#..#.###..###.#.###
...#.....#.........#...#.........#.....#.#.#...#.....#...#.#...#
#..###.#...##.##.###.###.#####.##.######.#...#.#.##..###.#...#.#
...#...#.#.#.....#...#.......#.#...#.....#.#...#...#.#...#...#.#
.#.#.#.###.#..####.#.#.###.#.#.#.#.#.#.###.###.###.#.#.###.#.#.#
...#.....#.#.......#.....#...#...#...#...#...#.#...#...#...#.#..
.###.###.#...###.#.#.###.#.#.###..####.#..##.#.#.#.#####..#..#.#
.#.....#.....#.#...#.....#...........#.......#.#.......#.#.#...#
.#..##.#.#####.#######.#..#...##.###.#.###########.##..#.#.#.#..
.#...#.#.....#...............#.......#.................#.#.....#
...#.#.#.##....###.#..##...###.##..#.#.###.#.#.#########.#####.#
.#.#.#.......#...#.....#.........#.#.....#...#.........#.....#..
.#.#.....###.#####.#...#.#########..####.###.#.##.####.###.#.#.#
...#...#...#.........#...#.........#.....#...#.#.........#...#.#
##.#.##..#.#..###.##.###.#..##.#######.###.#.#.###.#.###.#.#..##
.#.#.....#.............#.#...#.#.....#.....#.#...#..............
.#.#.#.###.#.###.#.###.#.#...#.#.###.#..##.#...#.#.#..####.###.#
.#...#.#.....#...#...#.......#.#.#.#...#.......#...#.....#.#....
.###.#.#.##.##.####..#####.###...#.###.##.##.#.#..##.##..#.#.#.#
...#.#.#...................#.....#...#.#.....................#.#
.#...#.#.###.##.##..##.#..##..###.##.#.#.#####...###.##...##...#
...#.#.#S#...#...#.....#.................#.#.......#.#...#.....#
.#.#.#...#.##..#...###.#...###.###.#.#####.#.###...###.###...###
.....#.........#.#.....#.#...#.......#.#.....#.........#.#.#...#
.#####.#####.##..#.#####.#.#.#.###.#.#.#.#####.##.####.#.#.#.#.#
.#...#.#...#...#...#.....#.#.#.#.......#.....#.......#.........#
.#.#.#.#.#.##..#####.#.###..#....####..#####.###.##..#.#.#.#.#..
...#...#.#.#...........#...#...#.#.....#...........#.#...#.#.#.#
.#####.#...#.##...###.##.#.#.###.#.###...#####.###.#.###...#..##
.#...#.......#.....#.......#...#.#...#.#.#...#.#.#.#...#...#...#
.#.#.#..######.###.#...#.#.##........#...#.#.#.#.#.#.#.#.#.###..
.............#...#...#.......#.#...#.#...#.#...#.#.#.#.#...#...#
..######..##.########..#..#.##.#..#..#.###.#.#.#.....#.#.....#.#
.........#.............#...............................#.....#.#
##############.#..####...##.##.############.###.#.############.#
