64
.....#.......#.....#.......#...............#...................#
.##..#.##.#..#..##..##.##..#.#...##.##.#..#..###...##..###.#.#.#
.#...#.#...#.#.........#...#.#.......#.#.#...#...#.....#...#...#
.#..##.#..##.#.#......##.##...##.#.#.....#.###.#.##.##.#.#.##..#
.......#...#...#.....#...#.........#...#.............#.#.......#
.#.#..#..#.####...##....#.####.#.#...#.#.####..###.....###.#...#
.#...#.....#.....#.....#.....#...#.............#.....#...#......
.###.#.###.#.##..#.#...#.###.#.#.#....#####.##...###.#...#.###.#
.................#.#.#.#...#...#.........#.......#...#.#.#...#..
..#####.##...#.#...#.#.#.#.#.##...#.....##.#.#.#.#.##..#..#..#..
...............#...#...#...#.......#...#...#.#.....#.......#....
...#.#.#.###..#..#.####..#....######..##.#.#.####.##.##.##.#...#
.#.....#...#...#.....#.....#.#.......#...#.......#...........#.#
.#.###.###...#..####...###..##..##.#.#.#.#.#.###...####.###..#.#
.....#...#.......................#...#.............#.......#.#..
.###..#..###...#.#.#.......#.#.#.#.#.#.#.#.##..#.#.#.#.#.#.#.#.#
.#...........#...#.#.....#.......#.............#...#.#...#...#..
.#.#.#.##.##.#...#..#.####.#..#....#..###..#.#.###.#.#.#.####..#
...#.......#.#...#.#.....#.........#.......#...#.....#...#...#..
##.#.######..#..##.#.###.#.###.###.#.#...###...#.#####.#.#.#.#.#
.#.#.#.......#.#.....#...#.#.....#...#.#.....#.#.#S....#.#.#.#.#
.#...#.#######.#.###.#.#.#.#.##....#.#######...#...#.##..#...#..
...#.#.....#...#.....#...#.......#.#...............#.......#....
.#.#.#####...#.###.##.##...###.#.#.#.#..####.#.#....####.#######
.#.#.......#.....#...#...#.....#.#.#.#.............#...#.#.....#
.#.#...####..#.#...#...###...###.#.#...#.#####.#.....#.#.#...#.#
.#.........#.#.#.....#.....#.....#...#.#.#.....#.....#.....#.#.#
.#.###.#..##...#.#####.#.#.#.###.#.###.#.#..#.##.###..####...#.#
...#.....#...#.........#.#...#...#.....#.#.....#.....#.........#
#....###.#.###.#.#.#####.###.#.###.###.##.##....######.#.#.....#
.#.#...#.#.....#...#...........#...#.......#.#...............#..
.#.#.#...#.###.#...###..##..###..#.#.#.#..##.#.#..##.#.#.##.##..
...#.#...#...#.#.#.......#.....#...#...........................#
.#.#.#.#..#.##....###.#..#.##...##..##.#####.#.##.##..##.#.#####
...#.......#...#.......#.....#...#.....#...#...#...#.....#.#....
..##.####....#.#####...#####...#.##..###.##...#....#.#.#.#.###..
...#...#...#.#.#.....#.......#.#.....#...#...#...#.............#
#.####....##.###.#.#.#.#.#####.###.#.#.#.#.###.###.#####.#.##..#
.............#...#...#...#.....#.#.#.....#.....#.....#.......#.#
.######.####.#..#..###.#.###..##.#...###.#.#.##..#.......#.##...
...#.............#.........#.....#.#...#.................#.....#
.#.#.##.#....#.#.####...##.#.###.#..##.#.##..##.#.##...#...#.#.#
.#...#...#.......#.....#.#.#.#.....#.....#...#.....#.#.#........
##.......#.##.#..#.#####.#..##.##.#.####.#..#..##......#.###.#.#
...#...#...#.....#.............#.....#.....#...#.#.....#.#.....#
...###.#.##..#.###.###..####.#.#.......###.#.#....######..#..##.
.#.........#G#.......#.#...#.....#.......#...#.............#...#
.##..##.##...#.#####.#.#.#.#...#.#...##..#.....#..####..#..#....
...#...#...#.....#...#...#.......#.....#.......#.#.#.......#...#
.#..##.#.###.##....#.#.#.#.#.#..##.#....###....#.#...###....####
.#.....#.......#...#.#.....#...............#.#...#.......#.....#
..##.###.#.#.....#.#...#.#.#.###.#....##......#.##.####..#.#.#.#
...#.#.......#.#.#.......#.....#.......#.#.............#.....#.#
.#...#####...#.#.#.#.##..###...#.###.#.#..#.##...#.#.#..#...#..#
.........#.#...#.#.#.#.........#.....#.#.................#.....#
.###...#.##..#.#.#.#...##.####.###...#.####..#...#######.#.#...#
.#.#...#...........#.#...#...#.......#...#.#.....#.....#.....#..
...#.##....##..###.#...#.#.#.#####.#.#.#...#...#.#.###...#.#.#..
.........#.....#.....#.......#.......#.#.#.#.....#.#.........#.#
.###.#.#.#.#..##.#......##.#.#.#######.#.#.#.#.#.....#.#.#.###.#
.....#.#.#.#.....#.....#.....#...#.#...#.#.#.#.#...#...#........
.###.#...#..#..#.#...##..#...#.......#.#.#.#.##..#####.##.######
...#...#.........................#...#.....#....................
#..######.#.#...###.#######.#####.#...#..###..##.#######.#####.#
