8
......G#
..#..#.#
.....#..
.##....#
..S..#..
...##..#
........
#...#...
