64
.............#...........................................#.....#
...#.#.#####.#.#.##.#.#...####.#######...#.###.###.#.#.#...###.#
...#...#.......#.........#...#...#...#...#..............G..#...#
.#..####.#.##.##...#####...#.###.#...###.#.#..##...###.#.#.#.##.
...#...#...#.....#.#.......#...#...#...#.#.#...#................
.###...#.##...####.#..######.#.#..##.#.#.#####.#.###......#....#
.#...#.......#.#...............#.#...#.....#...#...#............
.#.#.#.#.#####.#.#.##...##.##..#.#.###...#.#.###.....#.###.#....
.......#.#...........#...........#.....#.....#.....#.......#....
.....#....##.#..##....##.###.###.#.#.#.#..#..#..##.#####.#.#.##.
.#...#.....#.#.....#.......#...#.....#.......#.#.........#...#..
.#.##.####.#.#.##.###..###.##..#.#.#.##.##.#.#..##..##.#.#.#....
.#.....#.....#...#...#.#...#.............#...#.........#...#....
.###.#.#####.##.....##.#..####.#..#....##..#.#.##..#######.###.#
.....#.............#...#...........#.#.....#.#.....#...........#
.###.#.#.#.####.##.#..##.#...#####.#.###...#.#.##.##..##...##.#.
.#...#.....#...#...#.....#.#.....#...#...#...........#..........
...#######.#...#....####.###.##..#...#.###.#####.#.###.###.#.#.#
...#.......#.#...#.....#.......#.............#.......#.......#.#
.#.#.#.##..#.##...##.#.##....#.#.###.#.#...###...#.#.###.##....#
.....#.....#.#.......#.......#.........#...#.......#............
.#.##....#.#.#.#.#.####..#.#..#.##.#.##...#..#..###.#####.###..#
.#..S#.......#.............................#.#...............#.#
..##...##..#######.##.####.##......##....#.#.....##.##..#.####.#
.#.......#.....................#.#.......#.#...#.....#.....#...#
.#.#####...#####.#..##.####..#...#########.###.#####.#####.#.###
.......#...#.......#.........#...#...........#.....#...#...#.#..
..##.#.#.###.##..#.#.##..##..#...#.###.##...##....#.##.#.#.#.#.#
.......#.#...#...#...#.....#.#.#.......#...#.......#...#.....#.#
.#...##....#.#.......#.##....#.#.#.....#.###...##..#.#######...#
.#.#...#...#...#...#...............#...#.#.........#...#.......#
.#####.#.#..##.##..###.#..######.#######.#.#.####...##.#.#.###.#
.#.......#.......#.........#.............#.#...#.........#...#..
.#.#.##...#.##.#..##..####.#...###.#.#...#.###..###....#...#..##
.......#.#...#...#...#.....#.#.#...#...#.#...#...........#.#...#
.#####.#.#.#.#.###.#.#...###.#.#.#...#.#...#.#.#.##.##.###.#.#.#
.....#.#.#.#...#...#...#...#.#.....#...#.#.#.................#..
..##.#....##.#####...#.#.#.#.#..##.#.#.#.#.#.#.###.......#.###.#
.#.....#...#.......#...#.#.........#...#.#.#.#.....#.#...#.....#
..####.##..#########.#.#.#.##.#.#.##.#.#..##.##########.##.###..
.#.........#.........#.#.#.#.....#.........................#...#
...##.#####..#......##.#.#....##...###.###...####.#####...#..##.
.#.........#.#...#...#.........#.........#...#...........#.....#
.###.#.#.#.#...###...#..#####..#####.#...##.##.#.#.#.###...#.#.#
.................#...#.#...#...#.....#.#...#.........#.#.....#.#
.####......#.#.#.#...#...#.#..##...###.####..######..#.#.....#.#
.#.....#...........#.....#.#...........#.....#.......#.....#.#..
.#.....#.###.#.#.#####..##.#.#...#####.#.#.#.#.##########.##...#
...#...#.....#.#.........#.....#.....#...#...#.......#.....#...#
.#....#.##.#.#.##..#.###.#.#..#..#.#.#.##.####...###.#.###.#.#.#
.#.....#...#...#...#...#.......#.#.#...........#.....#..........
.#.#.#.#.###...#.#...#.#...###.#.#.###.#####.#.###.#.#.#.####.#.
...#...#...#...#.....#...#...#.#...#...........#...#...#........
####.#.##..#.##..##....#.#.#.#.#.#.#..#.####.#.#.#.##..#.###.#.#
.....#.#.#.#.....#.#.#.#.#...#.#...#...........#.#.......#...#.#
....##.#.#.#.#.#.......#.#..##...#.###.#.#.#.##..#...#####.#...#
...#.....#...........#.#.#.#...#.#.#...#.#.........#...#.....#.#
.#.#.#.#.###.#.###.###.#.#.#.#.#.#.#.#.#####...#.#.#.#...#...#.#
.#.#.......#.#.........#.#.#.........#.#.........#.....#...#....
.#.#.##..#.#....##....##.#.#.####.###..#.#####.#.#.#..###..#.#..
.#...#...#...#.#...........#.............#.#...............#...#
.....#.#.#.##..#...####....#.###.#.#.#..##.#..##.###.###.#.##..#
.#...#.......................#.....#.......#...........#.......#
..###..########.#.##############.#######.########.###.###.##.###
