16
.........#.....#
...#..##.#...#..
...........#.#.#
.#.....#.#....##
.#.....#.#......
#..#.##..###....
...........#....
.......##..#....
....S..........#
.##.####..##.#..
.#.............#
.....#.......#.#
.#.#............
.#.#.#..##...#..
..............G#
#.#.####....###.
