64
.#...........#.............................#.....#.#.....#.....#
...####...#.##.#.#.#.######..###.#.#.#.#.##........#.#.#.#.#.#.#
.................#.#.#.............#...#.....#.#S....#.#...#....
.#..#....#######...#.#...#.#.##.##.#.....#.....#####.#.#####.#.#
.#.........#.......#.#.........#.......#...#.......#.#.......#.#
...#####.#...#.#.##....#...####....#...#....#..#.......###...#..
.#.#.........#.#...#.....#.....#.#...#.#.#.#...#...#.........#..
.#.##..####.##.##..##..#...#.#.#.#####.#.#.....#.......#######..
.............#...#...#.#.....#.#.....#.#.........#...#.........#
.##..#.#.#.#.#....##.#..###......#.#.#..#########...####.....#..
...#.....#.#...#...#...#.................#.............#...#.#..
.#.#...#.#.#.##..#.#.###.####..#.....###...#.#.######..#.#.#..##
.#.#.#...........#.#.....#...#.....#...#...#.........#.....#....
.##..#.#.#.#.#.####....#.#.#.###.#...#.#####.##..#....#.##.#.#.#
.#...#...............#.....#.........#.........#...#.....#...#.#
....##.#.#######.#..#..##..#..######.#.##.##.#.#.##..#.#.#.###.#
.........#.............#...#.......#.#.......#.#.#.............#
..#..#.#...#.#...#.###.#...##.####.#.##.#.##...#.#.#.#...###.#..
.#...#.#.#.#.#.#.#.......#...#.................#...#.#...#.#...#
.###.#.#.#...#.#.....######..#.#.#...#.#####.##.#.#....#.#...###
.#.....#...#.....#.............#.....#...#...#.....#.#.....#...#
.#.##..#..##..###..##.#..#...#.#.#..####.#...#.###.#.###.#..#...
...#.#.......#.....#.............#...#.....#...#...#.....#.....#
.#.#.#.....#.#.#..##.##.#.#.#...#....#.####..#.#.#.#.###.##.##.#
...#.#.#.#.#.#.#...#.......#...#...#.#.....#...#.......#...#...#
###..#.#..##..###..#.#.###...###......##.#.#.#..#..#####.#.#.#..
.#.......#...#.....#.#...#.#.......#...#.#...#...#...#.....#.#.#
...#####.#.##..####..###.#...##.#..#.....#.#.#...###.#..###..#..
.#...#.............#.....#.#...#...#.....#.#...#.....#.#.....#.#
.##..#..##.##.##..#...#.##..#..#......####.#.#.#..###..#.#..##.#
...#.#.................#.....#...#.......#.#.#...#.....#........
.#.#.####.#.###....#.#....##.###.#..##..##.#.###.#.#.#....####.#
.#.#.......#.......#.#.#...#.....#...#.#...#.................#.#
##.#.....###.#...#.#.#.##.....##.##..#.#.#.###.##..#.#.#..##.#..
.......#...#.#.............#.......#...#.#...........#.......#.#
..#..###...#...#...###.#.#.#.....#.#...#.#....####...#.#.#.#.#.#
.....#.....#.#.#...#.....#...#.#.....#.....#.............#.....#
....##.###...##.##.#.#.###.#...#..##.#.##..##.##.#.##...#..#.#..
.#.....#...#.........#...#.#.......#.#.......................#..
.#.###.#.#.....#..##.#.#.###.####..#####.##..###.##.##.#..##....
.....#...#...#.........#.......#...............#.........#...#.#
.###.#.#.#.#.#.#.#.###...#.##.##.....#..#.####..###..#####.##..#
.....#.#.#.....#.#...#.#.#.#.#...#.#.#.......#.#.....#...#...#.#
.#.##..#.#.#...####..#.#.#.#.#.#.###.#####.#...#.#...#.#...##...
.......#.#...#.#.......#.#...#.....#.....#.#.#.......#.#.......#
#....##..###...#.#..##...##....#...#.###..#..#.##.######...#..##
.#.......#.....#.#.....#.....#...#.......#...#.............#...#
.###.###.#.###...#####...####..#.###.#.###.#.#.#.#####.###.#....
.........#.#.#.#.........#...#.....#...#...#...#.#.#.....#.#.#.#
.###.###.#.#...#.#####.#...#.##..#.#.#.#..##...#.#.#.##..#.##..#
...#.....#...............#.#.......#...#.#...#.#.#...#...#......
#..#.#..##.#...#...#.#...#.#.......####.....##...#.###.###.#.#.#
.#.#.#.........#.#.#.............#.#.........#...#.....#.....#.#
.#.#.#..####.#.##..#.#.#.##.######.#.##....###...#..##.#.###.#..
.......#...........#.....#...........#...#.#...#.#.........#....
.#####..##.#.####.####.#.#...#..######..####.###.###.#...#.#.###
.......#...#.#.#.....#...#.#.........#.....#.#...#...#.#.#.....#
.#.###...#.#.#.#..##.#.#...###....##.#.###.....###.#####.#.###.#
.#...#.....#...#...........#.....#...#...#...#.#...#.....#...#.#
.###........##.#.#.#.##..##..#.#.#.#.###.#.###.#.#.#..##.##.#..#
.#.#...#.#...#.#.............#...#.#.....#.......#...#.........#
.#.#.###.##......#.#.##.#.##...#.....#...#..##.#.#..###....#...#
...........#..............G....................................#
..######.###.#######..##..#..#######.######.######.####..######.
