16
G...............
#..#.....##....#
...#.....#...#..
.##.##.....##...
.....#.........#
.....###.#......
...#.........#..
.###.####.##...#
...#....S......#
.#.###....###..#
.........#...#.#
#.#..#..#..#.#..
.....#.#.......#
..#.#....##..#..
...............#
.#.#.#..##.#....
