32
.....#......................G...
...##...#....###.........#.##..#
...................#.......#....
.#.#.##..##..#.....###...#...#.#
...#...#.................#...#.#
.##.#...#.....#..##....#.###.#..
.......#.#.#.#.........#........
.#.......#.#.#.#...#.#...#..#...
.....#.....#...#.....#...#......
.#.#..##.#...#.#.#..###....#.#..
.#...#...#.......#.........#...#
.#...#.##.##.#.....#..#..#.....#
...#.#.........#.....#.......#.#
.#.#.....#.....##.#..#.....#.#..
...#...#........................
.##.##...#...#...##..###...##..#
...#...#.#...............#.#....
.#...#.#.#...##.#...#...........
.........#...................#..
...#.#......#..#.#.#.###.#...#.#
.............#.#.......#.#...#.#
...#.......#.#.#...###.###.#.#..
.....#...........#.........#.#..
....#..#......##.#.....#####....
.............#.........#.......#
#...#....#..#..#.###.#.#...#...#
.........#.................#.#..
.#....##.#.#...##...#..#.#...#..
.#..................S....#......
...##...#....#...#.####.#......#
.............#...#.............#
...#...####..#...#..##..#####..#
