8
S#.....#
...#.#.#
...#.#..
#..#.#..
.....#G#
.####...
.......#
.#####..
