16
.#.......#.....#
.#.###.#...#.#..
...#...#.#...#.#
.##..#.#.#.###.#
.....#.....#.#..
..#..##.#..#.#.#
.#......S....#.#
.#...#.#####.#..
...#.........#.#
.#...#..#####..#
.#...#.........#
......#####.##..
.#.........#...#
.########..#.#.#
G............#.#
#.##############
