64
.........#.............#...........#.......#...................#
.#.....#.#.#.#....###..####..#.#.#...#.#...#...#..##.#.#...###.#
...#.................#.......#.....#.#.....#.#...#..............
.#.###.......##..#.#.####..#.....##..#...#....##.#.#...#.#.....#
...#...#...#.......#.....#.#.#...#...#.#.#.#...#.....#...#.#....
.#.....##..#...#.#.#.#####.#...#.###.#.#.#.#......##.#...#...#..
...#.#...........#...........#.#...........................#.#..
.....#...#.#..#..#.#..####.#...##....##.#....#.###.#...#..#..#..
...#.....#.......#.#.......#...#...................#...........#
.#.....#..#.#....#.....##....#..#..#....##.........#..#..#####.#
..S#...#.....................#...........#.#...........#.......#
.###....#.#..#.#...###.........###.#.#......#.#....###.#..##.##.
...............#.......#...#.....................#...#.#........
..###...##.#.#.#.#...#..#.....#..##...######...#.#.#.#....###..#
.#.........#...#.....#...#.#...........#.........#.#.....#......
....#.#..#...#.#..####...#.#...#.#.........##...##.##.#....#.#..
...#.............#.................#.....#.....#.#.......#.....#
.....#.#.#..##.#...####..#.....#...#..###.....##.###...#.#..##..
...#.........#.....#.......#.........................#.#...#....
..#..#...#.#..##..#..#####.###.#.....#...#.....##.##.#.....#.#..
.........#.#.................#.............#.#.........#.....#..
..##...##..##.##.#.###.#...#.###.#.#...###.#..##...#.#..........
.#.........#.......#.......#.......#...........#.....#.......#..
.#...##...#....#.##.....####.#....##...#.......#.###..####..##.#
.#.#.#.......#...#.........#.#.............#.....#.......#......
#..#....###..####..#...............#.#.#....#####.........##.#.#
...#.#.#...........#.......#...#.....#...........#.#...#G#...#..
.###.....#.....#.##....#.#..##.##...#...#........#.#.##..#...#.#
.....#.#...#.......#.#.#.#.#.....#...#.....#...#.....#.....#....
.#.#.....#.#.#...#.....#...#.....#.#.###.......#.##.....########
.#.....#...........#.#.............#.....#...................#..
.#...######..#...#.....#...###......#.#.............#.#.#.#..#.#
.#.......#...#.....#.#..........................................
.#.#.###...##.#.#..#..##..........##.#........#.##.#.#.###.#...#
.#...#...............#.....#.........#.....#.....#..............
..#....##..#...#..#..#........##....#..#.#.#.......##.#.#..#.#..
.....#.......#.#.........#...#.......#...#.....................#
.#.##..#...##..#.#..###....#..#...##.#.#.#.#.######....#...###.#
.......#.....#.................#...#...#.#.............#........
.....#.#####....#.#..#.#.......##.##...#.......##.##.#..#..#.#..
.#.....#.....#.............#.#.....................#............
.#.#.#.#.#.#.#..#..#.#..##.##..##....#.#.#.......#...#........##
...#.#.............................#...#.......#.....#...#.#....
.#...#.#..#..###.#..####....##.#...##...##....##.#.#...#..##...#
.#.....#.........#.....#.....#...#.#.......#.......#...#.....#.#
...#...#...#.#.##........###.#...#.....###.#...#..........#.##.#
.............#.................#.#.....#...#.......#.........#.#
...#.#...#.....#.#..#.##...#.....#.....#.#...####..##..##.......
.........#...............#.....#.#.#...#.......#.......#...#....
.#.###.#....#.##.##....#.....#.#.#.#...........#.#.##.....#.##.#
...#.....#.........#...#...#...#.#...#.........#.#...........#..
.#.#..#..#...##.##.####.###..##....#.#.#...#.....#.#.#....#..#.#
...#.......#...#...........#.............#.......#...#.#.#.....#
.#.#....##...#.#...#...#.#.....#...##....#......#.#......#.##..#
.............#.#.#.#...#.................#.#.......#.#...#.....#
...##..#.####....#...###......#.#....#...#.#.###...#........##..
.....#.............#...................#.#.....#...#............
.#.#...#.###....##.#..#.#...##.#...#..#..###..#...###.#....#...#
...................#.#...#.......#...........................#..
.....##......##.#....#...#...#..##..##...#......#.......####....
.........#...........#.......#.#...#.........#.#...#...........#
...##.##....##...#.#.#.##..#...#...#.#..##.........#...###...#.#
.........#.....#.....#...........#.............#.#.............#
#.###.####..#.##...#####.#.#..#.######..#.###.####.#.##.#.###.##
