64
.........................#....G........#.....................#.#
.####..#.....#.#.#.#...#.#...#.......#...#.#.##.##...##.#..#.#..
.......#...#...#.......#.....................#.....#.#..........
.#.###...##.#..#..###..#.#.#.##..#..#....#.....#.#.##....##.....
.....#...#.........................#.....#.#...#...#...#........
.##..#..#....#..#..#.#.####.##..#..#..#.##...##..#.#...#...#.#..
...........#.........................#...#.#.......#...........#
.#.....#.......####..##....#..#......#.#.#.#.###...#..#..#...#..
.#...#...#...................#...........#.#.........#...#......
...#.#.###.##.##..#.#......###..#..#...###...#.#.#..##.###.#....
...#.............#.......#.................#...................#
.#.#..#.....###..#.#...#.#..##...#.###.#.#..####.#....##.#.#.#..
.....#...........#...........#...........#.....#.......#.#.....#
.....#.#....##...#...###.......##....#...#.#...#...#.#.#.#..#.##
...#.......#.#.........#...#.....#.#.#...#...#.#.#...#.........#
.....##..##....#.......#.###.....#.....#.#...#.#..##.##......#.#
.........#.......#...#.....#.....#.#.......#.#...#.........#.#..
...#.#.##..####..##..#...#.##.##.#....##......#.....#........#..
.#.....#.......#...................#.........#.....#.#..........
.#.#....#..#.#.#...#.....#####.#..##.#...###.#.###.#.#..#...#...
.#.#.#.#.........#.......#...#...#.#...#.#...#.......#.......#..
...#.....#..#....#.#.......#..#..#.#.#.....#.......#....###....#
.#.#...#.................#.........#.............#..............
.#.....#.#.#.#.#.#...###.#.#.#.........#..##.####..####.....#.#.
.....#.....#...............#...#...#............................
.#..##...#.#.##....###.......#...#.#.###...##..#.#.###.###...#..
.#.............#.....#...#.......#.........#.....#.....#.....#..
.#.##..#.#.#.#...#.#.##.............##...#...##..........#.##...
...#...#.....#.#.#.....#.#...#.........#.#.....#.#...#.........#
.#...#.....#.#.#.#.####..#..##...##...#..#..##...#...#.#.###...#
...#.........#.#...........#.............#.#.........#.#.....#.#
.#....##.....#.#...###.#..##.##..#.##......#.###....#..#...#...#
...#.....#...#...#...................#.....#.....#...#.#........
...#.###.#...#.##...##.#.....#....#..###.#..#..#...#.#.#####..#.
...#.....#...#.......#.....#...................#...#...........#
...#..##...#...##.##.###.#.#.#...#..#.......#......#.#..#...#..#
.................#.........#...................#.#...#...#.#....
.##.####.....##....##.#.#.##.#####.#.#...#..#.....#..#.#.......#
...................#.#.....#...........#.......................#
.#.##..#..#..#.#.....#....#.#...#..#.#.#...###.###.##..#.#......
.......................#.....#.....#.#...........#...........#.#
.#.#...##..#...##....#.###.#.##......#......##.....#.#...#.....#
.................#.............#...#.#.#...#.......#.........#..
.......#...#.....##..#...#.....#.#...#...##...#..##..#...#.###.#
.#...........#.......#.#.....#.......#.......#.........#.....#.#
.#..#...##.....##......##.#.##.......#.#..##....#...#..#.....#..
.............#.....#.#...............#...............#.....#...#
.##....##.##.....##....###....##.#........###..#..##..#.##.##...
...#.............#...#.........#.#.#..............S............#
...#.........#.#...#.#.##.###..#...#.........#.#..###....#..##.#
.....#...#.......#.#...........#.....#...#...#.#.........#......
....##..#...##.#...##....#..##.#.#...#..##.#...#.###.##..#..#..#
...............#...............#...#.....#.....#.........#.....#
.#..#...##..######......#....#...#...#.....#.#.##...####...#...#
...#.......#...............#...#...#...................#.......#
.#.#..#..#.#.#.#.###.....#.#...#.#.#...##....#.##..#.##.....##.#
...................#.#.#...................#.........#.......#.#
.....###.#.####........#..###.##.##..#.#...#.#....####.###......
...#.............................#.......#...#.....#...#.......#
.....#.....###...#......#...##.....#....#..#.#.##..#...#.##..#..
...#.#.....#.......#.......#...#...#.......#...#...#.........#.#
.........#....##.......##........#..####.........#...#...#.....#
.......#.#...................#...................#...#...#......
....#.#.#.###.#########..###.##.#.##...#.#.#.#..#.#...##.#.#.###
