16
.........#......
.##.##.#.#.##..#
.........#...#.#
#..#.....#.#.#..
.....#.#...#.#G#
..##.#...###...#
.......#........
.#.#.#..###.##.#
...........#....
.#.#...#...#.#..
...#.......#....
...#.......#.#.#
.....#.........#
.....#..####....
..S........#....
#.##...########.
