32
.................#...........#.#
.#####.#.#.#.##..#.###.#.###.#.#
.........#...#...#.#.....#.#...#
..##.###.#.###.###...##.##.#.#..
.............#.....#.#.........#
.#..##.#...#...#..##.#.#.#.#.###
.......#.....#.#.#...#.#...#...#
.#..##.##..#.#.#.#.#...#.##..#.#
...........#.....#...#...#...#.#
.#.#.##..#....##.#...###.#.###.#
.#...........#.#.......#.#.#....
.#.#.#.###.###.###.#.#.#.#.###.#
...#...........#...#.....#..S#.#
##.#...###.###.#..##...#.#.##..#
...#.................#.....#...#
.####..#.#.##..##.#.#...##.#.###
.....#.......#.................#
####.##.##.#.##..#.##..#.####..#
.....#...............#...#......
..###.#....#.#.####....###.##.##
..G....#.#.....#.....#.....#...#
.##.##.#....#.#..#.###.#.#.#...#
.....#.....#.#...#.........#.#.#
..#####..#.#.#.#.#.###..#..#...#
.............#.#.....#...#...#.#
..##...###.#...#.#...##...##.#.#
.#.....#.....#.....#.....#...#..
.#.##..#.####.########...#.#.#.#
.....#.#.#.........#...#...#....
.....#..#..###.#...#.###.#.#..#.
.....#...................#......
##.#..###########.#.#.#.#.#####.
