64
...............................#...............................#
....#...##....#.##...#.#.#.#...###......##.##.....##.##..#.#.#.#
.#.......#.......#...#...#...#...#.#.#.....#...............#....
......##.#.#.......#.#.#.###...#.....###.#.#..##....#......#....
.#.#.......#...............#.........................#...#......
.#.....##..#....###..#.###...#.#.#.#.#..###.#....#...#....#.#...
...#.....#...#.........................#.............#.........#
.#.####....#....#..#..#.##.......#..#......#.#...##..##..#.#.#.#
.......#.................#...#.............#.#.#.............#..
...#...#...#.#...###...#.#.#.....#.#.#.##.##.....#.##.###..#....
.#.............................#.....#.#.................#......
.#...#.####...#.#......#.#.#..#...##.#.#.#.##.##.#..#.....#.....
...#...............#...........#.#.....#.......#.#...........#.#
.#.........##...........####..##.#.#.........###.#.##..#####....
...#.#.....#...............#.#...#....G#.........#.#............
......##...#.#.#.#.###...#.#.....#.#.#...#.#.#####....###..#...#
.#.....#.....#.#.......#...............#.#...........#.....#...#
.###.##..#..##.#.......#.##...##.#.##..........#..##.#.####.#..#
...#.............#.#...#.....#.........#...#...........#.......#
.......##....#.....#..#.#..#.#.#.#...#.#....#........###.#..####
...#...#.......#...#...........#.........................#.....#
..##....#..#..##...#.#..#..#.#...#.###.....#...##..#.#.###......
.......#...........#...........#...........#....................
.........#..#..#.#.#.#.#.##..#...#.#.#.###.#..##.##...##.#...#.#
.........#...#.#.....#...........#...#...#...............#.#.#.#
.###...##.#........##.......##.#.#.#.....#..##.......#...#......
.#...#.....#.#.#.......#...#.....#.#.................#.#.#.....#
.#...#.#...#...#...#.....#.#.#####...#....##.##.#......#.#.....#
.....#.#.#...#.#...#.#.......................#.....#...#.#......
.....##..#...#.#.....#.###.#...#.........#.#.#.......#...#...#..
.................#.#.#...#.........#...#.#.......#.#.......#....
.#..##.#...#..#..#.#..##....####.#.#.#.#.....#...........#..####
...#...............#.....#.......#...............#.#...........#
..##.####....#...#.####..#.####.##.#.#.#..#..##....#.#.#.#.###..
.#.........#.........#.................#...............#.#......
.#.#...#..#....##....#.#.....#.#.###.#...##.....#....#...#####.#
...#...#.#...#.....#...........#.....#...#.........#...#.....#..
.####....#...#..##.#.##..#..#.#....#..#..#...#.#..#..##...##....
.........#.#.#...................#.#.........#.#.....#...#......
#..#...#.#.#...#.#.........##....#.......##..###.#.#...#.#.....#
.........#.........#.................#...........#.#...........#
..#.##.#..##.#.#.#.......##.##.......#..#........#.......#...#.#
.#.............................#.#.#.....#.......#.........#....
.#..#.###...#..#.#####...#.#...#.#.......#.#.###.#...#.##..#.#..
.#.............#.....#.#.......#.........#.....#...........#.#.#
.#.##...##.##..###.....#.#.#...#....###..####..###.........#...#
.......#.............#...............#.........#.......#...#.#..
.#.#..##.#..##.#.#.#..##..##.#.###.......#.......#..#..#...#...#
...#...............#.........#...#.......#.......#.......#.....#
#..#.###...#.#...###..##...........#.###....#..###.#.....#...#.#
...#.......#.....#...#...............#.......#...........#......
.##..#..#.#.....#..#.##..#...#.###..##...#.#..##.#.#.#.#.....##.
.......#.....................#.........#.............#.........#
.#.#..###....##..#..##...##.#..#..###...##..#.##..#....#.#.###.#
...........#.....#.#...#.#.........................#...#........
..##.##...#..#...#...##..#.#.#.#..#.##...##.#........#.####....#
.........#.........#.......#.......#...#.#...#...#.....#.......#
..##.#........##.....#######.#.#.......#......##...#..#...####.#
....S..............#.......#...#.#.............................#
.#...#.#####.#......#...#..#.....#.#...#........#..#.#####..####
.....#.............#.......#.....#.........#.#.#...#.......#...#
....##...#.....#.#.#.##....#...##..#.#.#.###...#.#.#.#..##..##..
.......#.............#...............#.......#.................#
#..#......##.#.##..#..##....###..###...####.###.#####.#.#..#####
