8
......G.
.##.#..#
.....#.#
.####..#
.#S..#.#
.###.#.#
...#...#
#.######
