8
....G..#
.#####.#
.....#.#
.#.#...#
.....#.#
..####.#
S......#
#.###.##
