16
.....#.........#
...###.##.##.##.
.........#...#S#
.#######.#.#.#.#
.#...#.....#.#.#
.#.#.#...#####.#
.#.#.........#..
.#.##..#####.#.#
.#.#.#.....#...#
.#....#.##.##.##
...#...........#
#.##.####.###..#
.#......G#......
.#.##..#.#.###.#
.......#...#...#
##.###.######.##
