8
.......#
#.#..#.#
..S.....
.##..#.#
........
..###..#
......G.
....####
