64
...........................#...............#.........#.........#
.###.###.#.#.#####.#.#.###.#..##.##.#....#.#....####.#.#.#####.#
.........#...#...#...#...#.....#.....#.#.#...#.#...#...#.......#
.#.###.###.#.#...#.##..#.#####.###.#...#.#####...#.#.#######...#
...#...#.....#.#.#.................#...#.....#...#...#..........
...###...###.#.#......########.#.#.#.#.#####.#########.#...#####
.#...#.#.......#.....#.........#.....#.....#.....#.....#...#....
.###.#.#.#.#.###.###.#.###.###.#.#######.#..##.###.##.##..##.#.#
...#...#.#...#...#...#...#.......#.......#.#...#...#...#.#...#.#
####.#...#.#.#.##..###...#.#####.#..#.#.#..#.###.###.#.#.#.##...
.....#.#...#.#...........#.......#.#.#.....#...#.........#.#...#
.#.#######....#.##.###.#####.###.....#.#.#.###..####.##.##.#...#
.#...............#.........#...#.#...#.........#.#...#...#.#.#.#
.#.##########.##.#.##.#..##.##..##.#.###.#.###.#.#.#.#.#.#.#.###
.#.#...#.....#...#.#...#.#.....#...#...#.#...#...#.....#...#...#
.#.#.#.#.#.##..#.#.#.#.#....##.#.#.###.#.#.#..##.####.#####.##.#
.....#...#....G..#...#.#.#.....#.#.....#...#.................#.#
.#.#######..##########.#...#.#.#.################.######..####.#
...#.....#.#...#...#...#...#...#...#.....#.....#...#.....#.....#
.#.#..##.#.#.#.#.#.#..###..##..###.#.#.#.#..##.#.#.###.##..#...#
.....#.......#.....#.#.......#.....#...#...#...#.......#.......#
...#.##..###..##.#....##.#.#.###.##..#...#.#.#...####....#.#.#..
...#...#.......#.......#.#.......#.....#.#...#...#.......#.#...#
..####...#..##.###.#.#...####....###.#.#.#.#.#.#.######..###.#.#
.#.....#.#.#.#.......#.#...#.........#.#...#.#.#.#...........#.#
.#.##.##.#...#.#...###.##..#.########..#.###.#.#.#.#######.###.#
.#.......................#.#.#.....#.....#...#.#...........#....
.#.###.######.#..##..##..#.###.###.##.#.##.###.#####.#####.#.#.#
.....#...#.......#.#.....#.#...#.#.....#...#.#...#.#.......#.#.#
##.#.###.#.####.##.#.###.#...###.#####.#.#.#.#...#.###.#.#.#.#.#
...#...#.#.................#.#.........#...#.........#.#.#.#...#
.###...#.#.#.#.#...#.###.###.#####.#.###.#.###.####..#.#.#.#.##.
.#.....#.....#.#.#.........#.........#...#...#.......#.....#...#
.#.###.#####.#.#.##.##.###.#####.#..#.####...##.##.#.#####..##.#
...#.#.......#.#...#.......#.....#.......#.#.#...#.#.......#...#
####..####.#.#...###.#..##.#...#.##.##.#.##..#.###.#.#.###.#..#.
...........#.................#.#.........#...#...#...#.#...#...#
.###..####...#.######...######.##..#.#.#.#.#.###.###.#.#.#..#..#
.#.....#...#...#.....................#.#.#.......#...#...#...#.#
....##.#.#####...#.###..###########.##.#..#.##.#.#.###########.#
.....#.......#...#.#...#...#...#.........#.....#.#.............#
####.#.#.#.#.#.###.#.....#...#.#.##.####.#.#####.############..#
.#...#.....#...#.........#.#.#.......#.#.#.#...............#...#
.#.###..######.#.###.###.#.#.#.#####.#.#.#.#..##.###.#.#...#.###
.#.#...#.......#.....#...#...#.#.....#...#.#.#...........#.#.#.#
.#.#.#.#.####.#.#.####.#####.#.#.##.####.#..##.#####.#####.#.#..
...#.#.#.#.........#.......#...#.#.....#...#...#.....#.....#...#
.##...##.#.###..####.#.#.#.###...#.#...##.##.#..####.#.###.###.#
...#.....#...#.......#.#...#...#.#.#...........#.....#.#...#.#.#
##.#######.#.#.#####.#.###.#.###.#.#.#...##..#.#.#..##.#.#.#.#.#
.#...........#.#...#.#...#...#.#...........#.....#.....#.#...#.#
.###########.###.#.#.###...###.###....##.#.#..#.#.####.#.#.###.#
.................#.......#.....#...#.#...#.#.....#.....#.#.#...#
##.##.##...#####.#.#.#########.#.#.###.#.#.#.#...#####.#.#...###
...#...#.........#.......#.....#.#.........#.........#.#.#.#.#.#
...#.#.###.#.#.....#####...#####.####...#######.##.#...#.#.#.#.#
.#.............#.........#.......#.....#.....#...#.#.#.#.....#..
...####...####.#####.....###.##.##.###...###.#.#.#.#.#..##.#.#.#
...#.............#...........#.....#.#...#...#.#.#.............#
.#######...#.#.#.#.###.##.##...###.#.#####..##.#.#..##.##..#.#.#
.....#.....#.#.#...#.........#.....#.....#....S#.#...#...#...#.#
####.#.#.#.#.#.#####..#.###..###.#.#####.###.###.###.#.#.###.#.#
.......#.....#.............................#.....#.......#.....#
####..####.#######.#####....##.####.#######.##..########.#.##.#.
