32
.......#...........#........G...
.#.#..##.##..#.#..#....#..##....
.#.......#...#...........#...#.#
...#.#.....###.................#
.#...........#.................#
##.##..#.##...#..#...###.##....#
...#...#...#...............#...#
.#....##.#.#.........#.#.......#
...#.#.....#.....#.....#........
.#...#...###...#..##.....#...#..
.#.#...........#.#..............
..#.##..####.#.#.#.....#.#...#..
.......#.....#...#.#...#.#...#.#
.#...#.#.#...#....#....#.#.###.#
.#S..........#.#.....#...#......
...#.#..##.##..#.#.#.......#...#
...#.#...................#.#....
.#.#...#...#..#..#.....#...#...#
...#.#.#.#...........#...#......
.###.#.#.#....##..#.....##...#.#
.....#...#...............#......
.#.###...#...#.#...#.#.#.#.#.###
...#.........#...#.......#...#..
.#.#.#.###.........#.......#.#.#
................................
..##.#..#......#..#..#.#....##..
...........#...#.............#..
.#.####..#.#.#...#.#####..##...#
...#.........#.......#...#.#.#..
...#.#.....##...###.#..........#
.........#.................#....
...#....##..#..##.###.#...#.####
