32
...#.#.........#...............#
...#...##..#####.#.#..####......
...........#.....#.#.#.....#...#
..#....#.###.###...#.#.####..#.#
.......#....G#...#.#.#.#...#....
.#..#...###.#..#.#...#.#.#.#.#.#
.#...#.........#.#.#...#.#.....#
.#.#...##.#######..#...#.#....##
.#...#...........#.#.#.........#
##.#.#.#.###.##..#.#....##..#...
...............#.#.......#...#..
.####.##...#...#.#...##...#.....
.#.#.........#.....#...#........
.#.#.##.########.###.#...#.###..
.....#.......................#.#
.#.....##.##.#.#.##..#.......#.#
...#.#.#...#.....#...#.....#.#.#
.#.###.##..####....#...#.#.#.#..
.#...#.....#.....#.#.......#.#.#
.##..####..#.###.#.#....####.#.#
...#.......#.#.#.#.#.#.#.....#.#
.#.###.###.#.......#...#.#...###
.....#...#.#.#...#.#...#.#.#....
..#..#.#.#.....###..####....#...
.#.....#.....#...#.......#...#.#
.#..######...#.#.#.#.##..#.#.#.#
.............#...#.........#S..#
.##..#.#.#.##.#####.#......##.##
...#...#...............#...#...#
##.###..##...#.#.##.####...#.#..
.........#...#.........#.......#
.#.##..###.####.###########.##..
