8
...#G..#
.###.#..
.....#.#
#..###.#
........
.#.#.#.#
S#...#.#
#######.
