32
................................
.##..#.##.#..#.........####..#..
.#.....#.......#.............#..
...##..#..#.#...##...###.##..#..
.......#.....................#..
..##.....#...#...#.#..#.##..#...
G..............#...#...........#
.#...#.##.#....###.#...#.##....#
...#...........#.........#...#..
.#.#..###.##...#........##.#...#
.#...#...............#.........#
.##......##.####.###.##......#..
.......#...#.............#......
##.#####......#..#.###.#.#.#....
...........#...........#........
.#...#...##....#..#..#.#..#..#.#
...#.#.#.#.....#...............#
.....#.#...#.#..######.##..#...#
.#.#.........#.#.....#.........#
.#.#.##..........###...###...###
.#.#...........#...........#...#
.#..#..#####.#.###...#.#.#......
.#.....#.......#...#.....#...#..
.###............#..#.##.##.#....
...#.#.......#.............#.#..
..##...##.......##...#.##..#....
...........#.....#..............
##.#.#.#.#.#.##.....##...#..#...
.............#..S....#.........#
.#.#.#.#.#.#....##.#.#....##...#
...................#............
##.#...#.####.####.#..##....##..
