32
...........#....................
...#..#.#..#..##..##...##..##..#
...#.....#...............#.#.#..
##.#.....#..##..#..#...#.#.#....
.#.#.#.........#.....#.........#
.#.#....#.##.#...###.#.......###
.#...........#.......#...#.....#
.#..#.##...##......#.#...#.#.#.#
.........#.....#...#.......#....
.###..##..#..#.....#......###...
.#.#.....#...#.#...#...#.#...#..
.......#...#.#..##.#..#..#.....#
.#.....#...#...#S........#.....#
.....#.##.#....#..##.#.......##.
.....#.#...............#...#...#
.#.###.##.........#.#.#..#.#....
.......................#...#.#.#
.....#.#.#.....##.####...#.#.#..
.....#.......#.............#....
.#.###.....#..#....##..##..###..
................................
##.#..#..###.#...#...#.#..##.#..
.........#...........#.......#.#
...#.#..##.#.####...####...#.#.#
.#...#.....#.....#.#...#.#......
.#.####...##.#.#...###.#.#...#..
.#.....#.........#.............#
..#...##....#.#....#.#.#...#.#.#
G#.....................#.#.....#
...#...###...#.....#..#..#......
................................
....#..#.##..#..#..#..##.#.##.#.
