32
.....#.......................#.#
.#...#.###.#.###..####.###.#.#.#
...#.....#...#......G#.....#.#.#
.#.#.#.#.#.##..#####.#...###.#..
...#.#...#...#.#...#...#...#...#
####.#.#.###...###.#..#..#.###..
...#.......#.#...#.#...#.#...#.#
.#.###..##.#.###.#.#.#.###.#.#..
.#...#...#.......#...#.......#.#
..##.###...#.#.###...#####.#...#
.......#...#...#...#............
.#.##.......##..##....######.##.
...#.#.#...........#...........#
...#.#..#..#.###.#..####.#.#.#.#
...#.....#.........#.#.....#.#.#
.#######.####..#.##..#.#.#.#...#
.#.....#.......#.......#.......#
.#.#.#.####.#..######..#.#.###.#
.....#...#.....#................
######.#.#.#####.###.#####.###.#
.........#...........#...#.#...#
.#####.###.##.#.##...#.#.###...#
.....#.........#.....#.#.....#.#
.##....###...#.#.#####.###..#..#
.....#.........#...#...#.....#..
.#.#.#.#####.#.###.#.#..##.#.#.#
.......#...#.#...#.#.#...#.#.#.#
.#.###.#.#.#.###.#.#####...#.#..
.#.....#.#.......#.#.....#.#.#.#
.###.#.#.###.####..#..####.#.#.#
...#...#......S#...........#...#
..###.#.###.#.######..####.#####
