64
.......#.................#.........................#...........#
.###..##...#.#.###.##..##..#.#.#..#..###.##.....#.##..#...#.##..
.........#.........#.#.......#.............#...............#...#
.##......#...#.#.#.....###...##.#..#.#...#...#....##.###.#.....#
.....#.#.........................#.....#.#.......#..............
.#.#...#....#...#..##..#...#..#.....#.#..#.#..##.........##....#
.....#...#.......#...#.........#.#.......................#.....#
.######..#...##....#..##.#...#.......###.#..#..#...#.##....#.#..
.................#...#.....#...#...#.....#...#.#...........#...#
##..#.##.##.##.#.#.###...#.#.###...#.##......#...#..##.#...####.
.......................#...#...#.#.....#.........#...#...#......
..##...#...##...#..#.#.##......#.#.#.....#...#.####......#.#...#
.#...#.......#.#...........#...#...#.....#.#....................
.#.#.#...#...#.#.#.###.#...#.##..#...#..#..#.#.#.#.#....######.#
.............#...............#.....#...#...#.#...#.............#
...#............##.#.......#.##....#.#....##.#.....###.#.#.#####
.#.#...#.#.#...............#.........#.......#..................
.....#...#.##.....#....#..####.#...#.##..#####....#..#.#...###..
...#.#...#.......#.#...#.......#...#.......#.......#.........#.#
.#....#..#......##....#....#.......#..#..#.#.####..#..##...#...#
...#.......#.....#.#.#...........#...................#..G..#.#..
##.#.##.####.#.#.#.#.#..##.#.###...#..###.#.#..#.###.#.#.......#
.........#.........#.....#.#.................#.............#.#.#
.####........#.#.....####..#.......#...#..#..#..##.###.#.#...#.#
.....#.........#...#...#...#...#.......#.....#.....#.....#.#...#
.###...#...#.#.#.#...#.#.####.##.#...#.#.#...###.###.#.#.##..#..
.....#.#.#.#.#.......#.#.#...............#.......#..............
......#..........##......#.....###.#.#.###.##..#..........#.##.#
...#...#.......#.....#...#.#.#.................#.....#..........
.#...#.#......#....#..#.##..##.......#.##..#.#....#..#.#........
.....#.#...#.......#...............#.................#.....#....
.##..#.#...#...........###.#...#.....###.#...#.#...####....#....
.#.......#.......#.........#.....#.....#.....................#.#
.#..#.##...#.##.#..###.#.###.###..#.#...#.#.##..##...#.#.#.....#
...#.....#.......#.........#.........................#.#...#....
.##....###...#.#.######.##.#....####.#.#.#.#.###...#.##..#..#.#.
...................#.......................#.............#......
....##.#.####.##.#.#.##..#.#.#.##...##..#..#...#.#..##...#.#....
.....#...#...................#...#.#...#.......#...............#
.###...#....#...#..#...#.#.#.....#.......##..##..#.#.#.###...###
.#...#.#.#.............................#.#.........#.#..........
.#.###....##...#.........#...#.#.#.......#.####....#..##.#..##.#
...#.......#.#...........#.......................#...#...#.....#
.###.###.#.#.#.##..#.#...#.#.#..#....#.#...#.#...#.....#.#.#...#
.........#.#...........#.........#.....#.#.....#.#.......#...#.#
.#.###..##.#..##....##.##.##.###....##.#.#.......#.#....#...##..
...................#...............#.......#.........#.......#..
...##.##.....###....#..#.#.#.###.##..###.............##.#.#....#
..............S..#.........#.................#.#.....#.....#....
.###...#.#..#..#.##..#..#.#..#.##..#...###.....###..##..#......#
.#.......#.#...........#...#.....#...#.............#.#...#......
.#.......#...#..#......#.#.#.....#.#.#.#.......#...#..##.####..#
.....#.....#.....#.#.......#.............#.#.......#.....#...#..
.#...##.#....#.#.#.....#.#.#.#.#.#....##.#....#.##.#.#.....#...#
...............#.#...........#.....#...........#.......#........
...#...#....##.#...#####..#.##...#..#..#..####.##..#.#...##..#.#
.........................#...............#...#.......#...#.#....
............##...##.#..#.#.#...###..##.....#..##.#.#..##...#....
.....#.........#.............#.........#...#.#.#.........#.....#
..##.#.#.#..#..#.....#.###...#.#.#.#.#.......#..#.#.#.#.#..#.#..
.....#.....#.#.....................#...#...................#....
.#....##..............#..#....##.#.#..##.#.#..#..####.#.....#..#
...................#.......#.............#.............#........
.####...###..#.#.....#..#####....###.#.##.###.#.##..#...#..#...#
