8
..S....#
...#.#.#
.#...#.#
.#.###.#
...#..G.
.###...#
........
#.######
