64
.........................#...............#.....#................
.....#.#.#.##..##.#.##...#.#.#.##...#.##.#..##...#...#.#.#.#...#
G........#.......................#.#.......................#...#
.###...#.##....#...###.#.#....#.##.....#..##..#..#.#...#..#....#
.......#...#.....................#...#.#.#...#...#...#...#.#...#
.....#..#..#...#.#.#.......#...#.#...##.....#....#.#.#.#.#.#.#..
.................#.#...........#.........................#.#....
.......#...##........#.....####...##.#.....#.###.##.........#..#
.........#.........#.................#.#...#...#.#.#.....#.....#
..###.##...#.###.###...#..####.#.###....##.###.#.....#....##...#
.........#.#.......#...........#.............#...#...#.#.......#
##.#.......#...#...#.#..##.##....#...##..........#.###.##..#....
...#...#...#.......#.#.....#.......#.#...#...#.........#...#....
..#.......#...#....#.....#.#...##....#.......#..##.....#.....#..
.#...#...#.........#.....#.....#...#...#...#...#.....#.#.#......
.#....#......##.....#..#.#.#...#.####.#..##........###.#.....#..
...#.................#...#...#...............#...#.#.........#..
...###.##.####...#.###......##...#.##.#..##..#..##...#...#.....#
.....#...........#...#...#...#.......#.............#............
.##...###.....#...#..#.....#.##.##.....#...#....##.#.#...###....
...........#...........#.....#.............#.#.#.....#..........
.#..####...#..#.....#..#...#...#..#........#.......#...#.###.#..
.........#...#.....#...#.........#.....#.#.#.....#...#.#.....#..
#..#.#.##..#.#..###..###.#...#.....#.#.....###.#.#...#...#...#.#
...............#.......#.....#...#.#.....#.#.....#...#.#...#...#
.#..#....###..#..####..#.###.#...#...#.##..#...#....##..##..##.#
...#...#...................#...#...........#.#...#...#.......#.#
##.#.#.....#..#.####...#...#...###...##.#.##.#...#.#.#..#..##...
...#.....#.....#.........#.#.....#...#.......#...#...#.........#
.#...#...##....#.##..#...###...#....##.#.#.....#.#.#..#..#.#.#.#
.#...................................#.............#.....#.#....
...#.#......#...##.....#.#...#.#.#.#.#..#..#...##.##.###...##..#
...................#.....#...................#...............#.#
.#......##..#..#.###.#.....####..#.#.#.....#.#.#.###....####.#.#
...........#...#...............#.#.........................#...#
.....###..#......#........#..##..##.##.#.#...##........#.......#
...........#...#...#...#.....#...#.......#.........#...#.#......
.#....#.#.##........##.###......##.#.###...#.#..##.#####....#...
.#...#...............#.........#.........#.........#...#.......#
#....#...#.......#.......##..###.#####.#...#.......#.....#####..
.......#.#.#.....#...#.....................#.....#...........#..
.#.#...#...#..##.#.#.#..##.#.##.##...#...#.#.#....#.##.#.....#..
.....#.....#.....#.......#...........#.#.#.#.#.#.....#.#.......#
.....#.#.###...##.#.##.#.#..#.###.#..#.#.#.#.#....#......##...##
...............#...#...........#...#.....#...#...#..............
##.#.#.....#.........#####.#.###.....#..##...###.#.#.#.....##...
.#...#...#...#.#...........#.......#.........................#..
.###.###...#.....###.#.###.......#.......#...#.###.#.#...#.#....
.....#.....#...#.................#.......#...#.....#.....#.#.#S#
.###.......#...##.....#..#....######...##..#...#...##..#.#...###
.#...#.#...............#.........#.........#.#.#.#.......#.#....
.#.##..#...#.......#...##...##.#...#####.###.#...###.....#..##..
.........#.#.............................#.....#...#.#..........
.#...........##...##....##...#...#.#.#....####...#.......####...
...#.#.#...#.#.....................#.........#...#.........#....
...#.###...#...##.###.###......##..#.##..#...#.#.#..##.###.#...#
...........#.......#.......#.#.....#.#.....#.#.....#.....#......
..##.#....######.#.#.....#....##..##.#..##...#...#..##.#.#.#.#.#
...#.................#.............#.........#...........#.#....
##...####..#...#.#.#.#.#...#.....#.#..####..#.##..#....#.###.#.#
.#.#.........#.....#.#.#.................#...........#..........
...#...#.#.#..###..#.......##...##.....#..##.#.##.......##.#.#.#
.......#.................................#.........#.....#......
.#.......###...#.#.##.##.#..#.##.##.#...#..#..#.#..#.########...
