32
G....#..........................
.#.#.#.######.#..########.#.#..#
.#.#.#.#...#.......#...........#
.........#.#.#.##..#.###.#####..
.#...#.#...#.#.....#.#.........#
...##..##..#.######..#####.#.#.#
.#...#.....#.#.................#
.####.####.#.#..##.#.#.##..#.#.#
...#.......#...#...#.......#.#..
.....##.########.###.#######.#.#
.#...#.....#.....#.#.#.....#.#.#
.#####..##.#..####.#.#.###.#...#
.......#...#...#...#.....#...#..
##.#####.####..#.#.#.#...####...
.......#.....#.#.#.....#.#...#.#
.#..##.###.###.#.#######.#.#....
.#.#...#...#.......#.....#.#.#.#
.#.#.###.###.###..##.##.##..##.#
...#.....#.#.#...#S............#
.#.###.#.#...#.#######.#.#...###
.#.#...#...#.#.#...#.......#.#.#
...#.#.#.#.#.#.#....##...###.#..
.#...#...#.#...........#.#...#.#
.###.#####.#.##..##.##.#...###.#
.#...#.....#...#.#.......#.#....
.#.#.#.##.#....##..#.#####.###..
.#.#.#.#.....#.#...#...........#
...#...##..#.#.#.######.####.##.
.#.#.#.....#.......#...#...#...#
.#.....#.#.#.#.###.#.#.#.#.###.#
...#.....#...#.......#...#.....#
#######.##.######.#.#####.######
