64
...#.....#.............#.....#.........#.....................#..
..##.#.###.####.####.#...##....##..#.#.......##.#..#....#..#....
...........#.........#.......#.........#...........#.......#...#
..#..#...#.##....#.##..####..#...#.......##.........#..#.#.#....
.#..S#.........#.....#...........#...#.#...#.........#.#........
.#.#.......#..##.#....##.#.#######.##....#.......#.#.#...#...#.#
.#.#.#.#...........#.....#.........#.......#...#.#.#.#.#...#....
...#.#.....#.#...##..#.#....##....#..#.....###.#.#.#.#...#..#...
.........#.....#.....................#...........#.......#.....#
####..#..##....#.#.#.......###...##....#.#......#...#####..###.#
.....#...#.....#...#...#.....#.#.................#.............#
.#.#.#..#......###.#..##.#...#.##...##.#.#.#...#.###..##.#.#.#.#
.....................#.....#...............#...#.....#..........
#..#.....#...##...#......#.#.##..#....##.#..##.#..##.#..#..##.##
.#.#.....#.............#...#...#...........................#...#
.#.#.##.....#...#....#.#...#.#..##.....##..#..#..#....####.##..#
...#.....................#...#.#...#.#...#.#.....#.......#.....#
...#.#...#...#...#...#.#.#.........#...#.#.#.##..####.....###..#
.#...#...#...#.#.#.....#.......#.......#.....#.........#.#.#...#
....#.......#..#.#.#.....#.#...#.#.##.#.####...##.####.....#.#..
.#.............#.#.......#...#...#...#.................#.#......
...#...###.##.#..#.##.##.....#.#.###...#.#.#.##.#..#..##.#.##...
...#...................#...#.#.......................#G..#.....#
.......#...#.#.#...#...#..##.....#.#.###.....#.###..#..##..#....
...#.#.......#.#.....#.......#...#.....................#...#....
...#....##.##..#.#...##.#..####..#.....#..#....##.#...##.#.#.#.#
.....#.......#...............#.........................#........
.....#.#.#.#.......##....###.#..#.##.###...##.##...#.##.......#.
.......#...........#...#...#.....#.....#.....#...#.............#
...#.#.#.####..#.###..#.##...#.....#.#.##.#....#.#.....#...#....
.#.....#.....#...........#.....#...............#.....#.#........
.#..##..##.#...#.#.###.#.#.#.......#.##..#.#.#..##.#.#..##...#..
...#.......#.#...#.......#...#.#.........#.#.#...#.......#......
...#.#.#...#.....#......#.##..#....#..#.....#....#.#.##...##....
.#.......#...#.......................#...#...................#..
..##..##.#.#.##....#.###....##.#..##.#.#.#.#.#...#...###.#..#..#
.................#...........#.........#.................#.....#
...#.#.....#..##.###.###.....#.#...#.#.#...##.##.#.#.#..####...#
.#.......#...........#...#...................#.......#.......#.#
.#...#.#.#...#.....##....#.#.#....#..#..#.##.#.###.#..##...##..#
.#.............................#.#.............#...#.#.........#
.........#...#.#.#.#..#.....#.#..#........##.#.....#..##..#....#
.#.#.....#...#.#.......#.#...........................#...#......
.#.####....##..#..#.##.###.#.......#..#......#.......#.#.#...#.#
.#.......#.#...#...#.......#.......#...........#.#.....#...#...#
.#...#.#.#....#.#..#..##.#..#...##.##....#..#..#.##..###....#...
.........#.................#.........................#..........
#.#.#...#..###.....#..##.#...#.#####..#.##.....###...#.....##..#
.....#.#.........#.......#.#.#...................#..............
..##.#...#.#...###...#.....#.#...##.#..#...##......#.......#.##.
.......#.........#.#...#.........#.......#...#.......#.......#.#
.#......#..#.......#.....#.###..##...#.#...#.#...##.....#.##.#.#
...#...............................#.#...#.#...................#
..#..#...#..##.#.#.#.#.##....#.####.....#..#..#..........#.###.#
.....#...............................#...#.#.....#.........#...#
.#.#.#.##.#..#.##.#.#......#....##....##.#.........###..#.#..###
.#...........#.....#...........#...#.....#.....#...#.....#.#...#
...#.###..#.#.#.#..#..#..#...###..##....#..#...#.###..#..#.#.#.#
.......#.............#.......#.......#.......#.....#...#...#....
##.#....#.#...#....#.#...##.##..###..##.#..#.###..#..#..#......#
.....#...#.......#.....#...........#............................
.#.#.....#.#.......#.......###.#.#.#.#...#.#..#..#.........#..#.
...........#...#...#.....................#.........#.#..........
..##......#....####.#....#.########..#..#.#.##.###.##.#..###...#
