32
.......#.........#..............
...#.###.#.#...#...#.###...#...#
...#...........#.......#.......#
.#.#.#..##...#....#.#..#..##.#..
.#.............................#
..#.#......#.#.....#...#.....#..
.#.....#...#...#...........#....
.#.#...#...#.......#.#..#.##...#
...#.........#.#.....#...#...#.#
..##.###..#..###....##...#..##..
.....#...#.........#............
..#.#....#.####.#.....###...#..#
.....#...#...........#......S#.#
.######..##....#..#..#..#.#..#..
.......#...#.#...............#.#
.##....###...#.##..#.###...###..
G........#...#...............#.#
####..##..#....#....###.#..#...#
.....#.....#.#.....#.......#...#
....##..##...##.####.###...#..#.
...............#.....#...#.....#
.#...#...#..#..#.##....####..#..
.#.....#...#.#...#.............#
.###....##.#.#...#..#....#.###..
.....#..........................
...#..#..#.....#......##..#..#..
.#.......#.#.....#.#...........#
..##.#.#.#...#.#.#....##.#......
.........#.......#.#.........#.#
#..#.......##.#.##.##..##.##.#..
.......#...............#.......#
#.#...#.##.#.#.#.#.#.#..####..##
