64
.............#.......................#...#.#.....#.............#
.###.####.#..#.#####..####.#.###..####.#.#.#.#.#.#.#.#######.#.#
.....#.........#.....#...#...#.#.#...#...#.....#.#.#...#........
####.#..###.#..#.##..#...##.##...#.#...#.#..#..#....##.#######..
.....#.............#...........#.#.#...#.#...#...#.#.#.........#
.###.#...#####..##.#####..####.#.#.###.#.#.##....#...#######.#.#
...#.#...#...#.....#.#...#...#...#.....#...#...#.......#.......#
##.#.#.#...#.#.#.#.#...#.#.#....##.#.#.#.#.#.#.#.#.##.....####.#
...#.#.#.........#.#...#.....#...........#...#.#.......#...#...#
.##....#.#.###.###.#.###.###.#.#.#######.#.###...####..#.#.#.#.#
.....#.#.#...#.....#...#.#...#...#...#.......#.#...#.....#...#.#
.#.#.#.#...#.#####.###.#....###..#.#..########.##.##.#.###.###..
.#...#...#...#.........#.#.....#...#.................#.........#
...##.##.#.#.##.#.##...#..###..#.###..#.####.###...#.#.#####.#.#
.#.#...#.#.............#...#...........#...#...#.#.#...........#
##.#.#.#.#.#######.#..####.####..#####.#...##..#.#.#.#...#####..
...#.#.#.#.......#.#...#...#.....#.......#...#.#.#...#.#...#...#
...#.#.#.#.#######.###.#.###.###.#.#...#.#.#.#.#.###.#.###...###
.#.#.#.#.#.........#.#.#...#.#.#.......#.#...#.#...#.#.#...#...#
.###.#.#.##..#.....#.#.###.#.#.#.#####.#...##..##..#.....#####.#
.....#...#...#.#...#...#.#.#.....#...#.#.......#...#.#...#...#.#
.#.###.###..#..###.#..##.#.#...#.#...#.#.###.#######.#.##....#..
...#.......#.............#.#.......#.#.#...#.#.......#.....#...#
..##.#.###.###.###.#####.#.#.####.####.#.#.#.#.###.###.#######.#
.#...#.#.......#.......#.#...#.........#.#.#...........#.......#
.#####...#.###.#.###.#.#...###.########..#.#######.###.#.#.#.###
.......#.#.#...#.....#.#.........#.....#...........#...#.#.....#
.###.#...#.#.###.##..#.#.#.#..##.#.#.###.######..#.#.#.#######..
...#.....#.#.#...#.....#...#..S..#.......#.#...#.#...#.....#.#.#
.#.#######.###.###.##..#.#...#####.##.#..#.#.....##...####.#.#.#
.#.........#.....#...#...#.#.#...#.........#.#.#.....#...#.....#
.#.##..##..#.###..##.#.###...#.#.#.#######.#.#...###.#...#...#.#
...#...#.....#...#...#.#...#.....#.....#.....#...........#.#.#..
##.#####.#######.#..##.#.#.#.###.#.#.#.#.#.#.#..####.##..#.#.#.#
...#...#.........#...#.....#.....#.#.#.#.#.....#...#...#........
.#.#...####......###.#.###...#.#...#.#.###.#.#.#.....#.###.###.#
.#...#.#.......#.....#...#.#.#.#.....#.....#.#...#...#.#...#...#
.#.###.#.##.#..#.#.#####.#...#.#####.#.#.###.#######.#.#.#.###.#
.............#...#.#.....#...#.#...#.#.........#.......#.....#.#
.#....#.##...#.#.#.#..###..#.#.#.#.#.#.#.#...#.#.###.##.##.#.#..
...#.......#.#.#.#...#.........#.#.#.#...#.#...#.............#.#
.#####.#####.#.##..#########.###..##...#.#.#.####.#.#########..#
.#.....#.....#.............#.....#...#.#.....#.#.........#.....#
..##.#.#.#...#######...#.#.#######.###.#.#####.#..##.###.#.####.
.....#...#...........#...#.........#...#...#.....#.#...#.#.....#
.##...#.##.#.#####.......#####.#####.##.##.....###.#.#.#.#.#.#.#
.#.........#...#.....#.....#...#.....#.......#.........#.#...#.#
.#.#.#.#####...#.#.#####.#.#.....#.#####.###.##..#####.###.#....
.#.#.....#.................#.....#...#...#.#...#...#...#...#.#.#
.#.#.###.#.#...#.#...##.####.#.#####...#.#.###...#.#.#.#.#.#.#.#
.#...#.....#...#...#.......#.........#.#.....#...#.#.#...#.#...#
.#####.#.##..#####.#...#.#.#.###.##..#.########.##.#.###.#.#####
...#...#...#.............#.#.#...#.................#...#.......#
.##..###.#.#.##.##...#####.#.#...#.##.#######..###..#....#.###..
...#.....#...#.....#.....#.....#...#...........#...#...#.......#
##.####.#..#.#.##..###...#####.###.#.#...##......#.#.#.#.###.#..
...#.......#.#.....#.....#...#.......#.#.......#.#...#.#.#.....#
.###.###.#.#...##..#.######..###.##.##.#...##.##.###.#.#.#####.#
.#...#...#.....#.#.#.#...#.......#...#...#.................#...#
.#.#...###.#...#.#.#...#...###.###...#.#.####..#.####.####.....#
...#...#...#.#.#.........#.#...#...#...#...#...#.........#.#.#..
.###.###.###.#.#.####..#...#.#.###.####..#.....###.#####.#.#.#..
...#.........#.........#...#.............#...#.........#.....#G#
#.###...####.####.#.###########.##.#########..#####.########.#.#
