64
.............#.....#.....#.....#...........#.........#.........#
.##....#.##..#.#.#...##..#.#...##.####.###.#.###.#.....#.#.#####
...#...#.#.......#...#...#.#.#...#.....#...#...#.#.....#...#...#
.#.###...#####.#.#.###.#.#.#.###.#.#####.#.#.#.#.#..##.#.###.#.#
.#.....#.....#...#.....#...#...#...#...#.....#...#.#...#...#...#
.#..###..#.#.#.#####..##...#.#.###.#.#.#.###..####.#.#.#...#.#.#
.........#.#.#.#.........#...#...#...#.#.....#.........#.#...#.#
.###..####.#..##.#########.#..##.#.....#.#.#.#####..##.#...#.#.#
...#.............#.......#.#...#.#...#...........#...#...#...#..
.#.###.#.##.##.#.#.#.###.##..#.#.#.#############.###.###...##..#
.#.......#...#...#.#...#.#...#.#.#.................#.....#.#...#
..#...#.##.#..##.###.#.#.#.###...#..####.#####.###.#..#####..#.#
...#...#...#...#.....#.#...#...#.#...#.......#.#...#...........#
...#####.#####.#.....#.###.#.###.#.#.#.###........#####.#..###.#
.#.......#.......#.#.#.#...#...#...#...#.#.#...#...#.....#.#...#
.######.##.###.#.#..##.#.#.#.###.#######.#..######.#..#..#...#..
...............#...#.....#...#...........#.......#...#...#...#.#
.#.#.###.#.#####.###..###.####.#...#.#..##...#.#######.###..#..#
...#.....#...........#.......#.#.....#.#...#.#...#.............#
..##.#######...##..###.####..#.#.#.#.##....#.###.#.#.#.######..#
.#...#.......#.#.....#.....#.......#...#.....#.#.#...#.......#..
.#.#.#.#######.#.#.#.#.###..####.#.###.#...#.#.#.#.#.#.#.#...#.#
...#.........#.#.#.#...#...#...#...#.#...#.....#...#.#.......#..
.#.###.####..#.#...#.###.#.#.###.#.#.##.##.###.#####.#####.###.#
.....#.....#...........#.#.......#...#.......#...#........S#...#
.##...####.####.####.#.#...#....#..#.#..#...####.#.#####..##.###
...#.#...#.#...#.......#.#.......#.#.#.#.#.......#...........#.#
.#.#.#.#.#.#.#.#.#.##..#.#..###........#.#.#.#...###.##..#.#.#.#
.#.....#.#.#.#...#...#.#.#.........#.......#.............#.#...#
#..##.##.#.#..##.#.#.#.#.#..####....##.###.#.#.##..###.###.##..#
...#...#...#.....#.....#.......#.....#.....#.....#.....#.......#
.#.#.#.#.#######.#.##....#..##.#.#.#.#####.######..#.#.####.....
.#.#.#.#.#.......#...#.#.....#.#...#.......#.........#.......#..
..#..#.#.#.#########.#.#####.#.#..#.####.###.###.#.#..##.#.###.#
.....#...#.#...#...#.#.....#...#.#.......#.....#.#...#.......#.#
#..#.#.##..#.#..##.#.###...###.#.#..##..##.###.#.#####..##.#.#..
...#.#...#...#.....#.......#...........#.....#.....#...#.....#.#
.###.###.###.#.##.##.#.#.###.##..#####..####...##..#..###.###..#
.........#...#.......#.#.....#...#...#.......#...............#.#
.#.##.##.#.###..#####..#######.#.###.####.##.#.#########.###...#
...#.#...#.#...#...#.........#.#...#.........#.....#...#.#.#...#
.##....###.#.####..#.#####.#.#.#.#.###.#.##..#####.#.#...#.#####
.#...#.....#.....#.#...#.#...#.........#.........#...#.#........
.###...#.######..#.###...###...#.###..##..########..##..########
.#...#...#.....#.......#...#...#.#...#...#.#.......#...#...#....
.#.#######.##....#####.#.#.#####.###.#.###.#.###...#..##.#.#....
.#.........#.#.#.....#.......#.....#.#.#...#...#.#.#.....#......
.#..##.#.#.#...#.#.#..######.##..#.#.#.##..###.#...###.###.##...
.......#...#...#.....#.....#.#.....#.......#...#.#.......#...#.#
.##.####.#.#.#.#.#####.#..##.#.#.#.########..###...#.#.###.#.#..
.........#.....#.....#.#...#.#.#.#.#.........#.#.....#...#.#....
####..###..###.#.#.#..##...#.#...#.#..########.#.#.##..#.#.##..#
...............#...#.....#.........#...#.......#...........#...#
..#####..#####.#####.#.#..#####.##.###.#.##.#####.###.#.##.#.#.#
...#...#....G#.....#.#.#.....#...#...#.#.........#.........#...#
##...#.#...#..##.###.#..####.#...#.#.#.##.#..#.#....####.#.###..
...#.#.#...#.#...#...#...#.....#.#...#.#...#...#...#...#.#......
.###.#.#.#.###.##..#####.#..####.##..#.#.#..#..#...###.#.###...#
.#...#.#.#.#...#.......#.....#.......#.#.#.....#.......#.#.....#
.#.#.#...#.#.##..#####.###.#.#.###.###.#.#####.##.####.#.#.#####
.....#...#.#...#.....#.....#.#.........#.#.....#...#...#.#.....#
.#...##.#.####.#.###.#.#.###.######.####.#.#.##....#####.###.#.#
...#...................#.................#.......#.......#.....#
###.####.##.#.#.#####.##.#####..############.#.############..###
