64
...#.........#..................................................
.#....#......#.......##.##..####.....#.#..##.#.#....###.###..#..
...#...#...#.#.#...#...........#...........#...........#...#...#
.#..##...#.#.#.#.#....#....###...#.#.#..##.#...#.####..#...#..#.
.....#.#.#.......#.......#.........#.....#.......#...........#S#
.#...#...#...###.#..###..#..##.#...#.###..#..#.##....##...#.##..
.........#...#...........#.................#...........#........
##.##.#..#.......#.#....#..#.###.#.#..#....#.#...........#....#.
...#...#.#...#.........................#.........#...#.#.#......
.#.......#.#..##.#....##....###.###.##.#.......#.........#.###..
.#...#.....#...............#...........#.......#.#...#.......#..
.#.....#.....#####.##..##..###.....###.##..#.##.#....##.##.#.#.#
.....#...........................#.................#...........#
.####.##.#.##.#.##.#......###..###.#.#.#..#..##..#.#.....####...
...........#...#.....#.......#.#...................#...#.......#
.#...##...#..#...##..##.###..#.#.##....#..#......#...#.....#...#
...#.....#.#.....#...........#...#...#.......#.............#....
..##.....#......##.##.#.#..#.#..##...#.####..#.##.#..###........
.........#...#.......#.......#.......#...............#.......#..
.#.#.#.###.#.#...##.......#..#.#...##.#.......#.####.#.#.#.#.#.#
...........#...#.....#.............................#.#..........
...###.#.#...#.....#.....#.###...#.#####..#..###.#...#...##.##..
.#.................#...............#...............#...#.....#..
.#.#.##..#.#....#..###.........#.#.#.#......##.##.#.#..#.#.....#
.........................#.....#.#.....#...#...#.............#.#
.#...##.##.##..#...#...###..##.#.....#..##.#.###.#...#...#.#.#..
.....#.........#.....#.....#.#...#...#.........#.....#.........#
.###.#.#.#..##.#.###...#..##.........#.#..........#.#.....#.#..#
...#.........#...........#...............#.........#...........#
...#.#.#.#......#.#.....##....#..###.....#...##............###.#
.....................#.#...#.#.....#.............#...#.#........
.#.#........##.##.#.##.#.#.#.#...........#....##.###.#.#..###...
.......#.#.#...#...........#.#.#.............#.#...#............
.....#.#.##..#.#...#..#..#..##.#.###....###.##...#...#.#...#...#
.#.........#...#...#.........#.#.......#.....#...#...#.........#
...#.#.###.###.#...#.#...##..#....#....#.#...##...#.#.#.####...#
.............#.....#.....#.#...#.....#...................#......
.#..#..#.........#..#........#..#........#.....###.#####.#.##...
...........................#.#.........#.#.................#...#
.#.#.#...##..#..#..#.#.....#.#.#.#.#...#.#.#.####.##.#.#.......#
.....#.........#...........#.....#...#.....#.................#.#
.#.#...##..#.#.#.#..#....#...#.##..#.#..#..#.#......#........#..
.#.#...............#.#.#.....#.......#.......#...#..............
.#.###...###.#.#.#...#.#....#...###..#.####..#.#.#......#....#..
.#.....#.....#...#.#.........#.......#.....#...#.......#.#.....#
##.#...........###.#.#.#...#..#..#.##..###.....#...#.....#.##...
...............#.........#...#...........#.#.#.........#........
...#.###..#..###.#.#####.#.#.....#.....##..##.....#......###.#..
.............#.....#...#.......#.............................#..
..#..#.#..####..##.#.....#.#.....#.#.#...###.###......#..#.##..#
.................#.........#.........#..........................
....#..##......#...#...#.............#.#.#.#...#..#..#.......#..
........G..#.....#.......#.#.....................#...........#.#
.#....####.#.#.#.#.#....##.....#..#....#.#....#.##.##.###......#
.....#.....#.#.#.#.....#...#.........#.#.....#.#.............#..
.###.#...#.#...#.#.#.#.#.#.#...#..##.#..#......#.##......#..##.#
...#.....#...#...#.#...#.....#.#...............#...........#...#
...##.#...#....#.#.#..##.#...#.#.....###.###.....####..#........
.#.#...............#.#...#.............................#.....#..
.#.#.....#...#.###.......#.#......##..##.....#.#....##.#..###...
.#.......#.#...#.......#.....................................#.#
.#.#####...####.......###.............##.###..##.#.###.#.###.#.#
...........#...................#.............#.......#.........#
##..##.#....####.###..#....##..##.#.##.#.##..#.#####.#.#...#.#..
