8
......G#
.###....
.......#
..##.#.#
.#S....#
.###...#
.....#.#
#######.
