16
...............#
#.##.....##..#..
.....#........G#
........##.#.#.#
.#..............
...#.#.#..#.#.##
.#..............
.....#.#.....#.#
...#S#.......#..
##.....#..####.#
.............#.#
.#...#.#.....#..
.#.....#...#...#
.....#.#.#...#.#
...............#
....###.#.###...
