32
.................#.............#
#..#.#...#.##...##...#.#.......#
...#.....#.................#.#.#
.#.#...#......#..#..##..##.#.#.#
.......#.........#...........#..
......#.#..#...#....##.#.###....
G..............#................
...#.#...#.#####...#..#...#..#..
.....#...#.........#...#........
###..#.#...#.###.....#.##....#.#
...#...#.#.#.....#.........#....
.....#.#.#......#..#..##.#.###.#
.#.......#...#.#.........#...#..
..#..#....##.#...#.#.#...#..##.#
...#.........#.#.....#.........#
#..##......#..#...#..###.###.###
...................#.........#..
..#...####..#.#.#..##..###.#.#.#
.#...#...#.......#.......#S.....
.#.#.....###.##........#..##....
...#...#...#...........#.#...#.#
.##...##.#...##...##...#...#.#..
.........#.............#.#......
#..#.........#.#...#...#...#.#..
.#...#...........#.............#
.#.#..##.##.......#..#..##...#..
.......#.......#.....#..........
.#.#.#.......#.......#.###......
.........#.#....................
...#.#.#.#.......##.#..#.####...
...#.......#.#..................
.#.#...##.#.#####...##.###..####
