16
..........S#...#
.##....#.##...#.
.#.......#......
.....###....#...
...........#...#
##...#.........#
...#............
..#..###..#.#...
.....#.........#
.#.....#....#...
.#.....#.......#
...#....#.......
...#.#G.........
.####...####.#..
.......#.......#
..##...#.#####..
