16
...........#....
....##..##...#..
.....#.#........
...#...#.#..##.#
.........#.....#
...#.#..#.......
...........#.#G#
.#...#...#......
.............#.#
...#.....#.#.#.#
.#.........#...#
.###.#...#..#.##
...#S....#......
#...####..###..#
.......#.......#
#...#.##..##...#
