16
..........S#...#
##.#.#.......#.#
...#.....#......
.#......###..#..
.............#..
.#.#...###.#...#
.#...#.#...#...#
.....#...#.##..#
..G..#.#.#.....#
.......#..##...#
.....#.......#.#
.#....#####....#
.#.....#.....#.#
.##......#.##..#
................
##.#...##.#.##..
