8
......G.
.#..##..
.#......
.#.#.#.#
..S....#
.#.##.##
.......#
.###..##
