32
.....#....................S#...#
...###.#....#........#.##..#.#..
...#...#...#.........#.......#..
.#.......#.#...#.#.#.#.##.###...
.#...............#.............#
.....#..##.#..........#....###.#
.............#...#.............#
.#.#.#.##..#..##.#......##.#.#..
.......#.....#...#..............
.#.#.#.#.#.#...####.#...##...##.
.........#...#.........#...#....
.#.##..###.#.##....#...#.#.##..#
...................#.#..........
...#...##....##.###..#...#..#.#.
.#.#.....#.....................#
.....#...........##.######.#....
...#.#.#...#.....#.............#
...#.#.##..#..#....#####.#..##.#
.#...#.#...............#........
.##.##.#.....#...#...#.#.#.#...#
.......#...............#.#.#.#.#
.#....#.......#####.##.....#....
.#...#...#.#.................#..
..#.#.##.#.#.#.#.##....#.####...
.....#...#...#....G#.#.......#..
.........#..#..###.#...#.#......
.....#.....#...#.....#.....#.#..
.#.....#..#..#...#.###...#.#.#.#
...........................#...#
.##.#..#..##...##......#..###...
.........#......................
..#..#.#.#..##....#....#.####.##
