8
........
.###.###
......G#
.....#.#
.......#
.###.#..
..S....#
#.##.###
