64
.......................................#...............#........
##.....#..#..#...#...#.#.#....##.....#.#...#...###.#...#.#.###.#
..G#.....#...#.............#...#.........#.............#.......#
..##...#.###.#.#....#.####...#...###.#....#..#....#.#....#.#....
.#.........#.#...........................#...#.................#
...#...##..#.###.#.#...#..##.#...#.#.###.....#...####.##...#.#.#
.................#.....#...................................#....
.#.#...#.#..#...#..##..#...#.....##.#...##.#.#.#.####..#.#.#...#
.......#.....................#.........#...#.#...#.............#
...#.#.#...#...####...#......####..........#..#..#.#..#.####...#
.#.......................................#...#.#...............#
.....#.##..#....#.##..#.##..##.#.#.#.##..#.#.#.....##...##...#.#
...#.#.........#...............#...........#.............#...#.#
...#...#...#...#..........#..#.#.#...#...........###...###...#..
.............#.....#.#.#.......#...#.#.....#.........#..........
.#....#..#.#.#.#..##.##..#.....###.#.##....##....#.#....#..#....
...............#.........#...#.....#.............#.......#......
#..#.#.#.......#.....#.#.##....#.###...#...#.#....#.#....#####..
...........#.#...#.#...................#...#.#...............#..
.##.....##.#.#...#...#....##.......###.###.#..#...#....###.###..
.#.......#.............#.........#.........#.....#.#...#........
.....#.#.#...#...#.#.####......#.#.#..##.....##.......##.###....
...........#.............#.........#.........#.......#...#......
...#..##...#.#.#.....#.###.#.#.#.#...##..###.#...#..#....#...#.#
.........#...#...#...........#.....#.......#.#...........#.....#
....#.##.#.##...#......#.##..#...#.#.......#.#######...#...#.###
.......#.............#.................#.....#.........#........
.#.#.#....###....#......#...#..#..#.....#.....###.....#...##....
.....#...#.#.........#.........#................................
..####.#.#.#...###.#....##..###..#.....#...#.#.....#..#####.#...
...#.....#...#.#.....#...#...............#...#...#...#.........#
.#.#.#.#.#.###.#...##..#...##.##.....#...##.##.....#..#..#......
.................#...#...............#.............#............
.#...#....##.#.......#.##......#.###...##....#.#....##...#.....#
...#.....#...........#.............#.......#....................
.....##....#.##..###.#.#.#.##.##...#..#......#....######....#..#
...........#...#.....#...........#.#.#...#.......#...#.......#.#
.#.###....#....#..##.##.##.#.####..#.....#...#.#...#...##..#...#
.....#.......#.#.#.............#.....#.#.......#.#.#.........#..
..#..#.###........###......#.#.#.###.#.#.#..####...#.#..##..#..#
.#.........#...#...#.................#...#.#.....#..............
.......#.###.#.##.....###.#...###....##..#...#.......#.......##.
.#.....#...#.....#...........#...#.......#.....#...#...#.......#
.#.###.#.....###...........#...........#....#....#.#..##.......#
.........#.......#.....#.......#...#...#.......#.......#...#....
.####......##..#####.#.##....#..#..#.#..##.#...#.#...........#.#
.....#.#.....#.#...................#.#...............#.#.#......
.#.#.#.....##..#.#.#######.....#...#.....#.#.#.#.#..#.#..##.##.#
...............#...#.............#...#.#.#.........#............
#..##..#...#.....#.###.....#.....##..#...##..##..#...#.....#.#.#
.....#.........#.#.#...#.....#...#.......#.....#...............#
..#..#.#.####......#.#.#.....##....#..#..##.#..#.###.#..#..#...#
...............#...#.....#...#...................#.........#....
.#...#.#.........#.#.....#...######..........#.......#.##.##.#.#
.........#........S....#...#.....#...#..........................
..#..#.#...##.#...##.....#..###..#.......#.#.#..#....#....##.###
.......#.....#...#.................#...#.#.....................#
.#....#..#.###.#.###.........#.#...#.#.#..#..#.#.#.#....#..###.#
.#.......#...........#.......#...............#.#...#...#.......#
.#.#..#....#.#..#....#...#.#......#.#....###.#.#.#......##.....#
.................#.....#.#.............#.............#.....#...#
#........#.##.....#..#.#.###.#.####.##.....##..#.#..#..##.#...#.
.......#.......#.......#.............#..........................
....#.#.#.###.###..####.#..##....#...#..#####.###.#...##..#..###
