64
.....#.........................................................#
.#..#...#.#...#.##...##..#.#...#..#.##...#.#.#.#.##..#.#....#..#
.....................#.#.#.....#...........#.#.........#.#......
.##.##.....#....##.#...#.#.#...#..##.##..#.#.....#.#.#...#.#.#..
.......#.........#.#.#...#...#.....#.........#..................
.#.....#.#.###...#.#.#.....#.#.........##.....##.#..#....##.....
.#.......#...........#.#...#.....#...........#...........#...#.#
.#.#.#...#.....#.........##...###.###....#...#..##..#.##.#.###..
.....#.....#...........#...........#...........#.....#.........#
..#..##.####...#.#.#..#..##.##.###.#.#...#...#.#.#.#..#..#......
.......#...........#...#.....#.........#.#.........#............
.####..#....#.##.#.#.#.#..##.#...#.....#.#.#..#..#.#....#..##..#
.....#...........#.................#...#.#.#.......#...#.....#.#
.#.#.#.#.#.#...#.#...#......#...#....#.#...#.##.#.##..#.##......
...#.#...#.....#...#...#.........#.....#.#.#...#...............#
.#.#.......#.#.#.#.###...#....##...#.......#.#.#.##.########.#.#
...............#.......#...........#.....#.#.#.......#..........
.###......#....##...#..#..#..#...#....##...#.....##..#.#...##..#
.............................#.#.#.#.#...#.#.........#.#.....#..
.#......##...###..#..#..#.#......#.#.###...#....#....#.#..#.##..
...#.....#...........#...#...#.#.#.........#...#...#.........#.#
#..#.....#.##..#....#....#.....#.#...#..#.#..###.....#...#.#....
...#....................S#.....#.#.#.......#.............#...#.#
.#.######.##......##.#...#....###...##.#.#.####....#.##.##.#....
...............#.#...#.#.........#...#...#.#.....#...........#..
...........###..#...#....###...#.##......#.###...###.#..##.#....
...........#.......#...........#.....#...#...#...........#......
...##......#.##.##.#..##...#.#.##....#.#......##...#####.#.###.#
...#.................#...#...#.......#.....#...........#.#.....#
.#.###..#.#.#..#.#...#...#.#...#...##.......#..#.#.#.#....#..#.#
.....#.........#.#.....#...#...#.........#...#.................#
.#.#......##.#.#.#.##.#....#..#...###.##.#.........#.##.........
...#...................#.....#...#.......#.#.......#.....#...#..
..#........#.##.##.##.......##...#.#..##...#.#.#...#.#.#...#.#.#
...........#.....#.............................#.......#.......#
..##.#.#...#...#.###.......##..................#..#.#......###..
.#.......#...#.....#...#.......#.........#.#....................
...#.#.#.....#...#.....###..##.#..#.#..#...##.......#####.##.##.
...#...#.................#.................#....................
...#.#.#.#..#..#.....#.#...#...##....##..#.#..##.###...#....#..#
.........#...............#.......#.#...#.....#...#.#............
...#..#......#.#...#.#.###....#.##...#..##..#..###....##..####.#
.....#...#.....#.#.................#.#.............#...........#
...#...#.........#.###.###.#.##...##.#...#...#.#..##.#..#..#.#..
...#.................................#.#.....#.......#.........#
...###....###....###.#.###..#....#####...##..#.##.........#..#.#
.......................#...#...#.#...............#.#.......#....
.#.#######........#.###..##....#.#.......##..###...#.#.#....#..#
.........#.#.#.......................#.........#.#.#............
...#...#.#.....#...####.#..###...#.#..#.##.##............#...#..
...........#...#.........#.#.#.#...#.......#...#.#.#.#..........
.###...#.#.....#.####..#...#.#.##..#...#.......#.#.#..#...##....
...#.....#...#.#.....#...#...................#...#........G.....
##.#.....###...##..#.#.#...#..##...........#.#..##....##..#..#.#
...#.#...#...#.....#...#.#.....#...#...#...#...................#
.....#.#.#.#.#.#.###...........#.....#.........#...####..#..#..#
...#...#.....#.....#.........#.....#.........#...#...#..........
....#..####..##....#.#..##....##...#.#...###.#...#...#.#.......#
...#...........#.#...............#...#.#.......#...........#....
.......#..###..#...#..........##.....#.#..#....#.#..##.#..##...#
.#.#.#...#...........#.#.........#.#...#.......#.............#..
...#.#..#....#..##.#....#..#.#...#......##..##.####..###.#.#...#
.....#.....................#.............................#......
.#.#..#..#.#....##..####.#....#.#..#.....#.######..#......##.##.
