16
...........#...#
.#.#..##...###.#
...............#
.....#.#...###..
...#.#.#.#.....#
.#.....###...#.#
.#S#.#.....#...#
.#.##..####....#
.....#.......#.#
.#...###.....#.#
...#...#.....#..
..####..#.##.#..
.....#......G#.#
...#..#####..#.#
...............#
.########.##..##
