8
.......#
.....#.#
..S#...#
###.....
...#....
.#.#.#.#
......G.
##..#...
