32
.....#.....#...#.....#.........#
.#.#.#..#..#...#..#..#.####..#.#
.#...#.#.#.#.#.#...#.....#.....#
####...#.#.#.#.#.#..####...#...#
.......#.....#...#.....#.......#
.##..#...#...#.#.#.#.#.#.#.#...#
...#.#.......#.#...#.#.#.#.#...#
##...#.#.#...#.#..#..#.#.....###
...#...#.......#.....#...#.#.#.#
.##..#.#...#.#.#.#.###.....#.#.#
.....#.#.#.....#.#.........#...#
....##.#..#.##.#.##...#..#.###.#
.......#..S........#...#.#...#.#
.####..#.#.#..#.##...#.#.###.#.#
...........#.....#.#.#.....#.#.#
..##...#.#.#.#.#.###...#.#...#.#
...#...#...#.#.#.........#...#..
#..##..#...#.#.##..#...#.#.##..#
.....#...#...#.#...#...#...#...#
..##.#.#.#.#...#..######.#.....#
...#...#.#...#.........#.#.#...#
.#.#..##.#.##...##.#...#.###....
.......#.#.........#...#.......#
.#.#.#.###...##..#.#....##..##.#
.....#.......#...#...........#.#
.#####.....######...#.##..##....
.#...#.#...............#...#..G#
.#.#.#.#.#.#.#...#.#.#.##..#...#
.#.....#...#.#.....#.#...#.#.#..
.#.....###.###.......#..#...##..
.................#...#.........#
##.#.#.##.#.#.###..##....#.##.#.
