32
...#...............#S#..........
#.......##...#####...#.#####.#.#
.....#...#.............#.......#
.....##..###.#.#.#...#.#.###.#..
.....#.#.......#.........#......
.....#.###.##...#..#.....#.....#
.#.....#.........#.#.....#......
.#...#....##.##..#...#.#.#.....#
.................#.#...#.....#.#
.#.....#.#.#.#.........#...###..
.....#...#...................#..
#..#.###.#.........#..#.####.#..
.....#.....................#...#
...##..##......#.#######.#.#...#
.......#.................#...#.#
..#...#...###.##...##....###....
...#.#.#.......#.......#........
.###.....#...#...#.#...###.#.##.
.....#.#...#.............#......
....#..#.#....#.#.##......####.#
.#...#..........................
#.##.##..#.#...###...###..##..##
.........#...........#.........#
..#.##...#.#.###.#..#..###..##.#
...#....G#.#...#.........#......
...#...#.#.....#..#..#.#...#....
.........#.....#.......#........
...#.#.#.##.#...#..#......#..#.#
.......#.....#...#.#...#.......#
.#.###.##.#............#.....#.#
................................
..#####.#..##...#.#..#.#.#..####
