32
...#.......................#...#
.###.###.#.#####...#.##.####.#.#
.....#.#.#.....#.#.#...#S....#.#
.#..#..#.#...###.##..#.#.#####.#
.#.....#...#...........#...#....
.##.##.###.###.##.####.#...#.###
.........#.#...........#...#.#.#
.#..#####..#.#....##.#.##..#.#.#
.#.#.............#...#.....#...#
.#.#.###.###.#####.#..####..##.#
.#.#.....#.........#.......#....
.#.#####..##.#.#.#.#.#######.###
.#.#.......#.#.......#.....#...#
.#...#.#.#.#.#...#.#.#.#####...#
.#...#.........#.#..............
.#####...#####.#.###.#.#..##.#.#
.....#...#...#.#.#..............
.#.#.##..#.###.###.####..#..##.#
.#...#...#...#.#...#...#...#...#
#..###.###...#.#.###.#.#.#.###.#
...#...#...#.#...#...#.#.#.....#
.###.#######.#.#.#.#.#.#.#.#...#
.....................#.#.#.#.#.#
...###.#..##.###.#.#.#.#...#.#.#
..G#...#.....#...#.#.#.....#.#.#
.##..#....#..#.###.......#.#.##.
.....#.......#.#.#.#.#.....#...#
.#.#.#########.#.#.#...#.#####.#
...#...#.......#...#...#........
.###.###.#.#...####.##.#######.#
.........#.............#.......#
#.#.######..#.##.##....##.######
