8
.#S.....
....##.#
.#...#..
.#...#.#
.....#..
.#...#..
......G#
#...##..
