64
.....................#.....#...............#...................#
.#####...#...#...#.#....#..#.##.#..#...#.##..##......#.#.#.####.
.#.....#...#.......#.....#...........#.............#...#.#.#...#
.#...###...###.#.#.###...#..#...#..........#...#.#.###.#..##...#
.......#...............#.....#.................#.....#.#.#......
#..#.....#.####.#....#####.#.#.###.#.....#.#......#...#..#.###..
.....#.#.........#.#.......#.................#.#...............#
..#.##.#.#.#.#...#...#.....##....###.###.##..#...#..##..##..#...
.#.....#.#.............#.....#...#.....#...#...#...#...........#
.....##....##..#........##.#.#.#.#.#.........##.......##.####..#
...................#...............#.#.#...#.............#.....#
.....#.##...#..#.#.#..#.....#...##...#.###.......###.#..##.#.#.#
.................#.#...#...#.....#...........#.#.............#..
...#.###.###...#.#.#...#.#...##..##..##.#....#.##..#.#...##.##.#
.....#.............................#.....#.......#.......#......
##.#.....#..#.....####.#.#.#.#..###....##..#...#..#....#.#..#...
...#...........#.....#.....................#...........#.....#..
...#....##.#.#...##.....##.#.#.#.....#.....#.##.##...#.#..#..#.#
.#...#.........#.#...........#...........#.#.........#..........
.#.....#..#....#......#......#..##.#..#.##......##.........#.#..
.#...#.........#.#.........#.#.....#...........................#
......##...#.......#.###......##.#...#...#.....#.###.##.#..#...#
...#.........#.#.................#...#...#.#...#...#.....#...#.#
.####....##..#.#.#.###.#.#.#.#..#..#.....#...#.#...#...........#
.....#.#.#.................#.........#.....#......S....#........
...#...#.#.##.###..#....##.#.###.#..#....###.#....####.##....#..
.......#.#.................#.......#.................#.......#..
...#.#.....#.###.#..####...#..#..###.###.#.#...#...##.....##.#..
.#...#.......#.....#.......#.........#...#.#.....#.....#...#....
...#.#..###....#.....#..##...##.#.#..#.#.#.#.##....#.#####...##.
.......#...#...#.#.#.#.....#.#.....................#.....#......
.#.#..#..###...##........#.#.#..##...##.##........##.##...###...
...#.........#.....#.....#...#...........#.......#.....#........
...#.#......#####..##..#...##.#....#.#.#...##....#.###...#.#.#..
...#.....#.................#.....#.#...#.....#.........#........
.#...#####......#..#.##.......##..#.#...####.#..#..#..##........
.........#.......#.......#...#.#.......#...#.....#...........#..
.#.......#.#.#.#.##..#.#.##..#.#...#....#..#.##..####..#..##....
...#...#.#.....#...#...........#.#.#.#.........#.#.....#........
.#.#...#.####...#....#..#.#.#..............##..#...#####.#...#..
.#...#...............#.........#...........#.....#.......#.#.#.#
..##.#...##...##..##.#.....##......#.#.#...#.###...#.##..#.#.#..
...............#...#...#.....#.#...............#.......#...#....
#..#..###..#...#.##...##...##..#..###.###..#.###...#...#.#.###.#
.#.............#.........................#.....#.......#.#.#....
..####..#.###..#....##..##....#...#.##...##.##......#.###.....##
...#.........#.#...........#.#.................#.........#.....#
...#.#.#..##.#.##..#.#...#.#.......#.#.###....###.####.#.#.#.#.#
.........................#.#.....#.......#......................
.#..#...##.#.##.##.###.#.....#.#.#.#.#.#...###...#.#..####...#.#
.#.....#.....................#...#...........#.#.#.....#........
....##...#........#..#...#..##...#..##..####...#.#####...#####.#
.#.............#.....#.....................#.........#..........
.##..#.#.####..##.#.##.#...#..#....#.##.##.###.##....#.#.##.#...
...#.....#...........#.#.........#.......#.....................#
##...#.#.#.#.####..#...#.....#.#.#....##.#.##.##..##.#..##..##.#
.#...#G#.....#.........#...#.#...........#.............#.......#
...#.#.......#.#.#...####........#.##..#..#.#............#.#.#..
...............#.............#...#.......................#......
.##.#..###.#.##..#...#.###.#.#...#.....##.#..#.###..####.#...#.#
.....#...#.#...#.#...#.......#.............#...#...#.....#......
.#.....#.#.......#.##......#...##..#.#..#......#.#.....#.......#
...............#.......#.....................#...#.....#...#...#
#.###.#.##.......###..#..##...####.#####.##..#...#.##..####.....
