32
.......#...#...................#
##...###.#...#####.###.######.##
...#.....#.#...#...#...#.......#
.#.#...###.##..#.###.#.#.###.#.#
G#.#.....#...#...........#.....#
.#.#.#.#..##...###.#####.#.###.#
.#...#.#...#.#...#.......#.#...#
.#.#...#.#...##..#.###...#.#.###
.#.#.#.#.#.........#...#...#...#
..##.###.#.#.#####.#.#.#.#.##..#
...#.....#.#...#...#.....#.....#
.#.###.....#.#.#.#..###.##..####
.#.........#.#.#...#...........#
.####.######.#.##..#.###.#####.#
.#.......#...#.....#...#.....#..
...##.##.#..#.#######.#.#.##.#..
.#.......#.........#.........#.#
.#.#..##.##.####.#.#.###.#.#...#
.#.#...............#...#.#.#.#.#
.#.########.###..#.#.....#.#...#
...#.....#.......#.#S....#...#.#
##.#.##..#.#.#.#.#..##..##.#.#.#
...#.#.....#.....#...#.#...#...#
.##..#####.####.###.#..#.#.#.###
...#.....#.............#.#.....#
.#######.#...########.##.###.#..
.#...#...#...#...#.....#...#...#
.#.#.#...#.###.#.#...#####.#.#.#
.#.#...#.#.#...#...#.....#.#.#..
.#..##.##..#.#.#.#####.###.#...#
.#.........#.................#.#
######..##########..#.#.########
