64
...........#.......#.........#.....................#............
...#.........#.#...#..#..###.#.#.#.##.##.#.#.#.#.....#.#.##..#..
...#.........#.....#...................#...#...#................
...#...#.#.....#..#....#.#..###..##.##.#.#.....#.###.#....#.....
...#...........#.#...................#...#.....#.#...........#.#
............#...##...#...#.#####..##......#...#....#...#...#...#
.................#.......#...#...#.................#...#.#.#...#
......###....#.#.#....#..##....##..#.###.#.#..###.##.....#.#.#.#
.......#.....#.#.......#...#.......#...#.........#.........#....
.####.#...##.#..#####.####.#.##.##.#.......#.#...#.###.#...##..#
...........................#.....#.....#...........#.....#.#...#
........#...######...........#.###...###.##....#...#..#........#
...#.#.............#...#...#.......................#...#.#......
.....#...####..........#.....##..#.#..####.##.##.#......##.#...#
.......#...........#...#....G............#......................
#...##.....#..##.#..#...###.......###.##.#.#......#..##..##..#..
...#.....#.#.....#.....#.....#.........#.....#.....#............
..##.#...#.#........#..#....##.#.#.#....####.....#.....###..##.#
.....#.....#.....#...........................#.......#.....#...#
#.##...#.###...#...#...#....#.#....#..##..#....#.#..#......#.#.#
.....#.......#.#.....#.........#.............#.#.#.......#.#...#
..#......#...#.....###...#.#.....#...###.............#.#.#.....#
.#...#.#.......#.........#.................#.#.....#...........#
...#....##.####...#....#.###.#.#.#.###.#...#..##...#...#...#.#..
.....#.....#.....#...#.....#.......#...........#................
.##....#...#.....#...###...........#.##.###......#.#......##.#..
.................#.........#.#...#.............#...#.#.#.......#
.##.##.####..#.....#.#.......#..#..#.##..#.####.....##.......#.#
...#.#.......#...#.............#...#...........#.......#.#......
...#.#...#.........#...##....#...###...#...#....##.#.#.#.#.##.##
.#.....#...#...#.....#.........#...#...................#........
...###.#.#.#.#....#..#..#..#.#.#.#..#...##...#.##..####.#..#...#
...#...#.............#.........#...........#.....#..............
...#..##.....##..#.#..##.....#..#.#...##..##.#...##.####.....#..
.#.....#.#.......#.#.......#.#.........#.....#...#.......#......
.#..##.#.#.#.#...#.####.##.#.###.#.##..#...###.#...#.#...####...
...#.#.#...#.....#.......#.............#.#.#.#.#.......#.......#
##...#.#.#......####.#......#..#.#.#.........#.#.#.........#.#..
...#.#...#.#.......#...#.................#.#.#.......#..........
.###.#..##..####.#...#.#..##..#...##.#.#.#.#.#.......##....#.#.#
.......#.......#.#.....#...#.........#.#.............#.......#..
#.###..#...#.#.......#.......#.####..###.#..#...#....#.#...#....
.......#.#...#.#.....#...#.....#...............#...#...#...#...#
..##.#.....##..#.###...#..##.#.#...#..#.#...###.....###...#..#..
.....#.............#...#...#.#...#.........#.....#.....#........
...#.###.....#..###..###.....###...#...#.......#..#..#.#.###...#
...........#...............#.....#...#.........#...#...........#
.....###.###.###.#.##....######..#.#...##.##..####...#.#.##..#..
.............#.....#...#...#.......#.#...........#.#...#.......#
.##..#..#.##...##.##.#.###.#...##......#..####.....#.#.##..#.#.#
.#.........................#.#.....#...#...................#...#
.#...#..##.#..##...#.#...#.#.#..#.##.#.###..##..#..#.#.#.##..#.#
...#.....#.........#.#.......#.......#...#.#...#.........#......
#.##.##..#..##.###.#...###.#...#.#.#.....#...####........#.##...
.............#...#...................#...#.#.........#.......#.#
..##......##..##.#.#.....#.####.#..#....##..#....###.#.#.....#..
.#.........#.............#.............#............S...........
..#.#.##.#..#.....##.#.#.#.....##......#.##..##..#..#...##.#.###
.............#.#.....#.........#.....#.................#...#...#
.#.#......#.##...#.#...#.....###.#.##..#.#...#....##.#.###..##.#
.......#.#.......#.#...................#.....#.......#...#.#...#
...###..##.##...#.....##.###.#...###.##.#.##.#...#.#.###.#.#.#.#
.....#.............#...........#.............#...............#..
..###.#####.#...#######.....#.#####.##.#.##.#.#...##.#.###.##.##
