32
...#...........................#
...#.#.######.####.#.#..######.#
.#...#.#.......#...#...#.....#..
.#.###.#.##.##.#.###.##....###.#
.#.....#.....#.#G......#.#.....#
.#.#.#.#####...#.#.###...#...###
.....#.......#...#.#...#...#...#
.#.##..#.####..#.#.#.###.#.###..
.#.#...#.....#.#.#.......#.#...#
.###.####.##.....#.###.#.#.#.###
.#...#.........#.#...#...#...#.#
.#.###.###.#.#.#..##.##..#####.#
.#.#.....#...#.#.#.#...#...#...#
.#.#####.###.#.#...###.##..###.#
.............#...#.#.....#.....#
.###.#.#.########..#.#.#.#####.#
.....#.#.#.........#.......#...#
...#.#.......#.#.#####.#..##.###
.#...#.#.#.#.#.#.....#.#.#.....#
.#...#.#.#...#...#.#.#.#...###..
...#...#.#.#...#...#.#.#...#...#
..##.###.#.###.#.#####....##.#.#
...#.......#...#.....#.#...#.#.#
...#.###.##..#.###.#...##...#...
.#.#...#...............#.....#.#
...###....#.#####..#.#.#.###.#.#
.....#...........#.#.#...#.#.#.#
.##..##.#...##...#.#..##.#.#....
...#...........#.#.#...#.......#
.#.#...#####.###.#.###.#..####.#
.#.....................#..S#...#
##.######.##..#.###.#####.######
