16
............G#.#
.#.#.###.#.#.#.#
.#...#.........#
.##.........##..
...........#...#
...##..###..#..#
.....#...#......
..#..#.#.#...#..
.#...........#..
.#..#.##.#..##..
...............#
.#....##.##..#..
..S..#.#.#...#.#
..##.#...###.#.#
.......#........
...###..#..#####
