64
...#.....................#...............#.........#...........#
.###..#.##.#..#.##...#...#.#........##...#.###...#...#.#.....#..
.#...#...#...............#.......#...#...#.......#...#.....#.#..
.#.###.#..##...#.###.#.#.####.##...#.#.#...#.#####..#..###...#.#
..................................S#.........#.......#...#.#...#
.......##..#...#...#....#..#.#..#....##..##........#.##..#.#....
.......#...........#.................#.........#.............#.#
.#..##...........###...#..#..##..###...#...#.#..##.#.###.#....##
...#...#...#.#...#...#.........#.#.................#.......#...#
..##........#..#....#....#.#.#......##..#####...######...#.#...#
...#...#...#.........#...........#.#.........#...........#...#..
.#.#......#......#.#.#.#...#.#..##.#..#...##.#...###.##.##.#.#.#
.#...#.#.....#...#.#.......#.........#.....#...#.....#...#...#.#
....##.####.##..##...#.###...#.###.#...##..##.##.###...#.#..##.#
...#...#.#.....#.#...........#...........#.....#...........#...#
.#....#..#..#.#..###.#.#...#.#...#..#.##.#....##...###.#..##....
.............#.......#.......#.....#.....#...#.......#.........#
.....#.##..#..#..#....#.#.#......#.#.#..#.#.....###.#....#.#.#.#
.#.........#.................#...#.............................#
.###.#...#..#..#....#####..#.#...#.......#.##.#..###..##...#.#.#
.....#.#.......#.#...............#.........#...#.........#...#..
.#...###.#........#.#.#....#...........##.##.#.#.#.###.#.......#
.........#.............#.#.......#.........#.............#...#.#
...###..###.##.##..#..##.#.#.#.##.##.......#.#.###....##.#.#.#..
...............#...#.................#...#.........#.#...#...#.#
...###...#.#.#.#.#...#.#..#.##....#....#.##.#.##...#....#....#..
.........#...#...#...#...............................#..........
...##..#..##.#.#...#..###..##..#.###...#.#.#.#####......#...#.#.
...........#...#.....#...............#...#...........#.........#
..#...#..#.#.###.........#..##..##.#.#...#.##....#...#.###.###..
.#.........#...................#.........#.............#........
#..#.....#...#.###.#.......##..###.......##..#.#..###........#.#
...#...#...#...#.......#.............................#.........#
.#.####.##..####...#..##..#...##.##.....#.#....#...#..#.#......#
...........#...#.#.......#...............#.#.....#.......#.#...#
.#....#...#..............#.###.##....#.....#...#.#.#.###......#.
.............................#.....#.......#.#.............#....
.#.#######.##.###..##.###....#.#.#.#.###.#...#...##.......#.#...
.#...#.........#.............#.#.......#.......#................
...#..#.....##...####..#.#.#.#.###...#...###.#.#...###...#..#..#
.................#...#.#...#.........#...#...........#..........
.#.#......##...#.....#.#.#....#....#.###...........#.#.#.#.#####
.............#.............#.#.............#.........#.#........
#....#.#..#....##.#..#...#.#.#.......#.#.##...##...#...#.#......
...............#.........#.....................#................
##.....#...###.####.#...#..#.###....#..#...#.....#.#.####.###...
.............#.............#...#.............#...............#.#
.#.###...#.#.#....#....#.#.###.#.#..##.....#...###.#..#.##.....#
.#...#.......#.......................#.#.#...........#..........
......##...#....##.#.#...###.#...#...#...#..#..#...#.###.....#.#
.........#...#...#.....#.....#...#.......................#.....#
.....###.##..#.....###....#.##.....##....#.#.##....#.#..##..##..
...#...#.....#.........#...#.#...........#.......#.#.#.....#....
.###.#.#######..#....#.....#.#.#.###......###..#.#.#.#..###...##
.............#.#.....#.....#.........#.#.....#.#.#...#..........
...#.#.....#.#..#..#.........###....###..##........#.#...#.###..
...............#.............#...#.............#...#.....#...#..
.#...##..#.........#.#.#.##....#.#...#.#...##........##.#.#..#.#
.........#..............G#.#.#.#.........#.....#...............#
.##....##..#.##.....#....#.#..#....##.##.###....##..##.#.....#.#
.#.....#.................#.......#.#.....#.......#.............#
.#.#.#.#..##...###.....#.#.................###.....#.#.#.#......
...#.........#...........#......................................
.....#.#..#....####.##.####....###.#.##...#.#..#..#.#..#.####.##
