32
.....#.......#.................#
.......#.....#.#.#....##....#...
.....#...#...#.......#.........#
.......#.#.#.##...##.#...#.#....
...#.......#....................
....#......#.#.........###......
...#.........#..................
##.#..#...#....#..#....##.....#.
...#...#.......#.#..............
..##.#...#.#.....#..##.#.#.#.#..
.....................#.........#
.#..####...#.###.#.#.......#.#.#
.#.................#...#.#...#..
.#...##..##.#....#.#.......#...#
.......#.....#...#.#...#.#.....#
.#.#.#.#.##....#...#####.#..##..
.#S....#.....................#.#
.#...#.#.#.#.##..#...####..#...#
...#...#.......................#
.#.#.##....##.##...#.#......#..#
.......#...........#.....#......
.###.#..#.##..#.#....#.......###
.......#...........#.....#.....#
..#.##.#.#..#.####...##......#.#
.#.......#.....#.....#.....#...#
.....###...##..#....#.....##.#..
...............#.#...#.........#
...###...#...##..#...#.#..#..#.#
.#.....#.#.#.........#.#..G#...#
.#.#.#...#.###.#........#..#...#
.........#.................#...#
#.##...###...###...##......##..#
