32
.............#....G............#
.##..###.###...#..##.#.###.##.#.
.#.#.....#.......#.#.#.........#
.#.#.##.#.###.####.#.#.####..#..
...#.#.....#...#.....#.#.....#.#
##.#.#.##..###.#.####.##.#.#.#.#
.........#...#.#...#.....#...#.#
.#.#.##..##..#.###.##..###.###..
.#.......#...#.........#...#...#
.##.#..##..##..####..###.#####..
.....#...#...#.................#
.###..##.###.#####...#.###.....#
...#.............#...#.#.#.#...#
##.###.###.##..#..##.#.#.#.#.###
.#...........#.#...#...#...#...#
.#.#.######.#..#.#.#.#########.#
...#.#...........#.#.#.........#
.###.#.####.#.##.###.#.#####.###
.#...#.#...#.....#...#.........#
.###.#.#.#.###.#.....#.#.####...
.#...#...#...#.#.......#...#...#
...#########.#.####..#.#.###.#.#
.#.......#...#.#...#.#.........#
...###.###..##.#.#...####.####..
.#...#...........#.............#
.#####...#.#.#########..#....#.#
.#...#.#.#.#.........#...#.#....
.#.#.###.#.#.#..####...#.#.##..#
.........#.#.#S#.....#.#.....#..
#####..#.#.##.##.###......####.#
.........#...........#.........#
#######.###.#.#.###.########.###
