8
......G#
####.#.#
.....#.#
.##.##.#
.#S#.#..
.#.#.#..
.......#
####.##.
