8
...#S...
...##..#
.......#
...#...#
........
..#..#..
G.......
...#####
