8
.......#
.###.#.#
.#.#S...
.#..#.##
.......#
.#...#.#
G..#...#
##.#.###
