8
.#S....#
.....#.#
...#...#
...#...#
.#...#G#
.#.##...
.......#
.#....##
