16
...#.........#..
.###.#.#####.#.#
.....#.#.....#.#
.###.#...#####..
.......#.#.....#
.#.#####.#####..
.#.....#.......#
..####..####.#.#
.#.....#.......#
##.#.#.#...#.###
...#.....#....S#
.#.###.#..###.##
.#.......#......
.#.#####.###.#.#
G............#.#
###.##..########
