32
...............#...............#
.#........#..#..###.###.#..#....
...#.....#...................#..
.##..#......####.#.#..##.#.##...
.#.#...................#...#...#
...#.#...#...#.###...#.###.....#
.....#..........G..#.#.....#...#
...#...#...#...#....#....#..#...
...............#...............#
........####.#.#....##.......#.#
.......#...#.#.#.#.#............
...........#.##....#.......##..#
...#.....#.......#.#.....#.....#
.....#.#..#..##.##.#.##..#..#..#
...................#.......#.#.#
.##..#.#.#.###.###...#.##....#..
.........#.#...........#.....#..
.....#..##...#.#...##..#.#...#..
.......#...#...#................
....##...#.#.#.#.##.#....###...#
.#.......#...#.........#.....#.#
.##......#......######...###...#
.....................#.....#...#
#.#.##.##..#...#...#.#.#.#...#.#
.....#...#...........#..........
.###.....#.#.#.#.####..#.##..#..
.#.....#.........#.....#.......#
..##..######.##.##.#.#.###.###.#
.#...#S....#.........#.#.....#.#
.#.#...##..#.#.....#.....#.#....
...#.......#.......#.....#......
#####.#.#..#.####.#.###..####...
