16
G..............#
##.#.#.#.#.#.#.#
...#...#...#.#.#
.#.#.##..#..#..#
.#.#.#.#.......#
.###.#.#..####.#
...#...#.......#
.#.###..#.####.#
.....#.#S.......
.###.#..########
...#.#.#...#....
##.#.#.#.#.#.#.#
.#.......#...#..
.#.###########.#
...............#
#.#######.##.###
