64
.................#...........#.....#.........#...#.............#
...###.##...##.......#.#.#.###.#.##...##.#.#.###.#.###.#.#####.#
.#.....#...#...#.....#...#.....#.#...#.#.........#.....#.#......
.###.#.#...#.#########....######.#.###.#..##.#####.#.#.#.###.###
.......#.#.#.......#...#.......#.#.................#.#.#...#...#
####...#.###.#..####.#.###.#..##.#####.#######.....#...#.#.###.#
...#.#...............#...#...........#.#.....#...#.......#.#.#.#
.##..#.##....###.###.#.#.#.#.###.#.#.#.#..##.#..#..#.#.###.#.#.#
...............#.#...#.#...#.#.......#.#...#...#.....#.....#...#
#.##.#.#...###.#.#.#.#.#.#.#.#.#.####......##.######.#.#########
.....#...#.......#...#.................#...#.........#..........
.#...##.####.#...#...###.#.#######.#####..##.########.#####.##..
...#...........#.#.#.....#.......#.....#...#...#.....#.........#
.#.#######.#####.#.####..###.###..#.#..###.#.#...#.###.######...
.#.....#.............#...#...#.........#.#.#...#...#...#.......#
#..#.#.###.#.#.###.#.#.#.##..#.##..####..#...###.#.#.###..######
.....#...#.....#...#.#.......#.#.#.................#...#.......#
.#....##.###.##......#..######...###.#.###.#####.#####.######..#
.#.#...#.......#...#.#...#.....#.#...#.#...#...#.#...#.........#
.#..##...#.###...#.#..##.#..#.##.#.#.#.#.#...#.#.#.#.###..##.#.#
.#.#...#.....#.#.#.#...........#...#...#.#.#.....#.#...#.#...#..
.###.###.#.###.###.##.#.###.#.....##.#.#.#.#.###....#..#.#.##.##
.....#.#...#...#...........#...#.......#.#.#.......#.....#.#...#
##.#...#####.##..##..#####.#..#..#####.#.###.##..###...#.#.#.#..
.......#...#.#...........#.#.#...#.....#.#...#...#.....#.......#
.#####.#.#...#.##.########.#.#####.#.###....#...##.#.###.#####.#
...#...#.#.#.#...#.......#.#.......#...#.#.#...#.#.....#.#.#...#
.....#####.#..##.#.#####...####.#####..#.#.#.#.#.#.#.#.#.#.#.#.#
.#.#.#.....#...#...#.....#.............#.....#.#...#...#...#....
.#.#.#.#.#####.#.#.#####.###.#...#.#########.....#.###...###.#..
.#...#.#.#.....#.#.#.....#...#.#.#...........#.#.....#.#.#...#.#
.#######.#.#######.#.#.#.#...###.#######.#.###...###.#.#.#.###.#
.#.......#.#.....#...#.#.#.#.............#.....#.....#...#.#.#.#
...#######.#.###.#..##.#.#.#######.##.####.#####.##.####.#...#.#
.#.#.....#.....#.#.....#...#.......#.............#.........#....
...#.##..#####.#.#.....#.###.###.#.#.########..#.###.###.#####..
...#...#.#.....#.#.#...#...#.......#.#.........#.....#.........#
##.###.#...###.#...###.#.#.#.#.###.#.###.###.###.##..#.#######..
...#.#.#...#.....#...#.#.....#.#.#.#.....#...#.......#.......#.#
.###...#####.#..##.#.###.#####.#.#.#.###...#.####.####.#..####.#
.#...#.#...........#.#...#.....#.......#...#.#.....#...#.#.....#
.#.#.#.#.##..#.####....#.#.#.###.#####.....###...#.#.###.#.###.#
.#.#.........#...#...#.....#.#.#...#.....#.#.....#.......#...#.#
.###.#.####.##.#.#.###.#.#.#.#.###.#.#####.#.###.###...#...#.###
.....#.#...#...#.#.....#.#.#.#.....#.#...#.#.......#...#...#...#
.#.###...#.#.###..###..#.#.#.#...###.#.#.#.#.##.##.#####.####..#
....S..#.#.#.#.#.......#.#.#.........#...#.............#.....#..
.####..#.#.#.#.######..#.####..###.#####.#..##########.##..#.#.#
...#.....#.#.#.....#...#.....#.....#.....#.....#.....#...#.#....
##.#.#.....#.#.#.###.#######.###.#.#.####..#...#.###.###.#.#.#..
.#...#...#.#.#...........#...#...#...#.......#...#...#.....#.#..
.###.#.###.#.###.####.####.#.#....#..#.#####.#####..##.####.##.#
...#.......#...#...#.....#...#.#.#...#.............#.........#.#
.#.####..#.###...###.###..##.#.#.#.#...#.#######.#.#..##.###.#..
.#...........................#.#...#...#...#.................#.#
.#####..########.#####..##.###..#####.#..#.###.#.#######.#.###.#
...#...#...........#...........#.....#...#...#.#.....#....G....#
##.#.###.##.##..##.##.#....##..#.##..#.#.###.#.#.#.#.###.#.###..
...#...#.#...#.....#...........#...#.....#...#.........#.#.....#
.#####.#.#.#.#####.#.#######.#.###.###.#.#.###...###.#.###.#.#..
...#.#.....#.#.......#...........#...#.#.....#.......#.......#.#
##...#.##.##.#.#######...#.###.#####.#.#.###.#.#.#.#..#..#####.#
.....#.........#.............#.........#...........#............
##.#..##.##.#####.#..#####.##############..#######.#.##.##.#####
