16
.......#......G.
..##...#....##.#
.#.....#.#.....#
...###...###...#
..S....#.#......
.##...##.....#.#
.........#.....#
.##.#..#..##.#..
.#.......#...#.#
.........#..##..
.#.....#........
.#.#.#.##....#.#
...#.#.........#
..#..#..##.##..#
.....#..........
..##.#..#...#.##
