64
...........................#...#...........#....................
.#.##..##..#...##..###..#..#.#...#...##......#...##....##......#
...........#.....#...#...............................#.......#..
.#...#.#.#..#..#...#..#..#...#.##....#....######...#....#.......
.......#.......#...................#.#.................#...#...#
.#...###.##.#..#.#.###.###.##..###.#...#..#.##.#.#...###.##...#.
...........#.......#.........#...#.#...#.................#.#....
.#....#..#.#.#.#.....#...#.#..#.........#..#.#..#..###.#.#..##..
.........#...#...#...............#.#.#...#...#...#...#.#...#...#
.#.#.##....###.#.##.#..#..#.....#..#...#.#........##.....#....#.
.....................#.......#...#.............#.....#G......#.#
.###.#.##..#...........#.....#.#.....#....##..#.##.#....#..###.#
.#...#.#...........#.#.....#.#.#.....#.#...............#.......#
...###.#.#.#.....#.#...#...#.....###.###...#.....#...#...#.###..
...#...........#.#...#...................#.....#.........#......
.....######..#.#.#.#..#...#....#....#####..##..#..#...##...#.##.
...#.........................#...#.#...#.......#................
..#.##..##...#.#..#.##..#..#.##..#.#.....#..#....##.......####..
.......#.......#.....#...........#...#.#.#.................#...#
.#.#.#....##..####.#....#..#...####.#....##..####..#.##.##.#....
.#.......#...........................#.#.......#...#.........#..
.#..#.##.....#...#.##...#....##.#.##.#.....###.#....#..#..####.#
.#...#.............#...............#...#.....#.#.......#.....#.#
..#......#...#..#.#...#......###.#.#..#..#.#.#.#...##...#.......
...#.#.#.#...............#.#.....#.#...............#.......#....
.....#.#.....###.###...#...#...#..#..#.#.#..#......#..#.####.#.#
...#...#...#.........#.#.#.......#...............#.............#
..##.#.#.#.##......#.....#...#.....###.###.#.#.....#.#....#..#.#
.#...#...............#.....#...#.#.#.#.#.....#.....#...#...#...#
.#.###.##..#.#..##..........####.#.#......#...##.#..#......#..##
.#.#.........#...................#...#.#.....#.......#.....#...#
.#..##...##.###....##.#......#.....#...#.#......###..##.#..#....
.................#.....#.#.#.........#.......#...........#.....#
#.#.....###.#.#......#.#...#.##..###.###.....####..#.#.......#.#
.........#.............#.#.#.............#.............#.......#
.#...#...##...#.##...#....#........#...#.#.#...#..#.#.##.#.#.#.#
.......#.....#.....#.#...................#.#.#.#.#...........#.#
...#.#.....#...#..#....#.#..#..#...##.##.#.#...#.#...#.##.###...
.....#...#...#.........#.#...........................#.....#....
####..#....#...#.#.##..#.....####..#.........#.#..##.#####.#...#
....S..#...#.....#.......#.#.......#...#.#...#...........#.#....
...##......#.#.###...##.#.#..###.#.....#.#..##..#....#.#.#.###.#
.....#...........#.#.........#.......#...........#..............
.##.....##.###.#.#.....#.......####....#.##..###..##....#..#.#..
.....#.#.......#...........................#....................
...#.#.#.##..#..####..##.#.......#....###..#....####.#.....#..#.
.#.#...#.....#...............................#.....#...#...#...#
.#....##.###.#....##.#.#.#.....#.....#...#.....#..#...######.#.#
...#.........#.....................#.#.#.......#................
.#####...#.....#...#..#..#.##...##.....####.....#..##..#.#.#....
...........#.#.....#.....#.#.......#...#.....#.#.......#...#...#
.#.#...#.#.#.##.......#.#..##..#.#...#...#.#......##.####....#..
...#.....#.......#.............#.........#.....#...............#
...#.##.#....#.#.#.###....#..#.#.#.#.##.#.##..#.##.###.###.###.#
.......#.......#.#.....#.....#...#..............................
...#..........#....#.#.###..#......#..#.##..#...###..........#..
.....#.......................#.#...#.........#..................
.##..#.....#..#####...#..#...#...#..##.#...#.###.###.#.#.###....
.....#.#.#.#.....#.....#.......#.......#...#.....#.......#......
.#.#.#.#......#....###.#.....##......######.#....#.##..#.#.#...#
...#.#.#.......#...#...#.#.........................#.......#.#.#
#....#.....###..##....#.....##..##..##.###.##..#.......#.....#..
...#.....#...............#.............................#...#....
##...#.##....##.#####.#..######.#.#######.##...#...####..#..#.##
