64
.......#...........#...........#.....#...#.....#.......#.#.....#
.#.###...##..#..##...#####.##..#.#.#.#...#......####.#.#.#.#.#.#
.#.....#...#.#.......#...#.....#.#.#...#...#.#.......#.#...#.#.#
##.#.#.###.#.#.####.#..##...##.#.#.####..#.#.#########.#.###...#
...#.#...#.....#...........#...#.#.#...#.#...#.....#...#.#.#.#.#
.##..###.#.#.####.########.#.#.#...#.#.###.###.###.#.###.#.#.#.#
.#.......#.#.#.......#.....#.#...#.#.#.....#.#.....#...#...#.#..
.####..###.#.#.##.##.#.####....#.#.#.#######.#.#.##.##.###.#.#.#
.....#.#...#...#...#.#.....#...#...#.........#.#.......#...#.#.#
.###.#.###.#####.#.#.#.###...#.#..##.#..#..#.#..#.####.##.#..#.#
....G#.........#.#.....#...#.....#...#.#.......#.....#.......#.#
.#...#.#..####.#.##.####.#.###.#.#.#.#.#..##.###.###.##..##.##.#
...#.#.......#.#.........#.......#.............#.#.#.#..........
###..#.#.#.##..##..#####.#.###...#.####..#..#..#.#.#.#......####
.......#.#...........#...#.............#.#.#.#.#.#...#...#.....#
.#.#####..##.#...###.#.#.#.###.##.##.###.#.#...#.#.#...#.#.##..#
.#.......#.....#.......#.#.....#.....#...#...#.........#.....#.#
..#..#####.#####.#######..##.#.#.###.#..###..#.#.#.###..#.#.##.#
.#.....#.........#...#.......#.#.#...#.....#.#...#...#.#........
.#.###.#.#.####.##.#..###.#.##...#.#######...#.###.#..##..#.##.#
.....#.#...#.....#.#...#...#...#.#.#.....#.#.......#.....#......
####.#.###.#..##...###.#.#...#.#.#.#.###.#..##...#####.###.#.#.#
.......#...#.#.#.....#...#.#.#.#.#.#.#.....#...#.#...#.....#....
.#.##.#####..#.#####.#...#.#.#...#.#..####.#.###.#.#.###.###.#.#
.....#.....#.#...........#.......#.#.......#...#.............#..
.###.#.##..#.##..#.#.#.#.#.#..####..##.#.###.#.##.##.#.#.#..####
.....#...#...#.........#...#.........#.....#.....#.....#.......#
..##..##.#.#.#.#.#####...#..##.#.###.##.##...###...#####.#####.#
.#...........#.#...#...#.#.#...#.#.....#...#.....#...#...#.....#
.#####.#.#####.#.#...##..#.#.###.#.####..###.#.#..#..####..#####
.#...#.....#...#.............#...#.............#.....#.....#...#
...#.#.###.#.##..#.#.#.#.#####.#.##.##.##.####.######..#####.#..
...#.#...#...#.#.#.....#.....#.#...#.....#...#...#.....#...#...#
#.##.###.###.#.#.###...#.###.#.#...#.###...#.###......##...#.#..
...#.#...#.....#...#...#.#...#.#.#.....#.#.#...#...#.........#.#
.......#.###...###.#...#.....#.#...#.#.#.#.###.#.###.#.#####.#.#
...#...#.....#.....#.....#.......#...#.#.......#...#.........#..
...##..###.#.###.#.##.####.##.#..###...#.#.#.#.#.#.###.#.#...#.#
.#...#...#.......#.............#.....#.#.....#.#.#...#...#.#....
.##...##.#.#.###########.#####.##.##.#.#.###.#.#.###.####..#.#.#
...#...#.#.#...#...........#.#...#.#.#.#S....#...........#.#.#..
.#..##...#.#.#.#.###.####..#.###.#.#.#..####.#.#####..##.#...###
...#.....#.#.#...#...#...#.#.#...#...#.......#.#...#...#.#.#...#
.####.#..##....###.###.#.#.#...#.#####.##.##.#.#.#.#.###.#.###.#
.....#...#...#.....#.......#.........#...#...#...#.......#.#....
...#.#####..##..##.#.###.###.###.###.##....#.....#.#########.###
.#...........#.....#.....#.....#.......#.#...#.....#.......#...#
.#..######.#..####.###.#...#.#.#..##.#...#.#.#.###..##..##.###.#
.#...#.........#.....#.#.#.#...#.....#.#.........#.....#.#.#...#
...#.####..###.#.###.....#.#...##..#.#.#.#####...###...#.#.#.#.#
...........#.#...#...#.....#.....#.#.#.#.......#.......#.....#.#
#.#######.##..##....####...#.###.....#.#.#.#...##.####.##..#.#.#
...........#.#...#.....#.#.#.....#.#...#.#...#...........#...#.#
.#.#.#####.#.#.#######.....#.#.##.#......####.#####..#.#.#.#.#.#
.#.#.#.......#.#...#...#...#.#.#.....#.#.....#.....#...#.#.#...#
.#...#.###.##..###.#.#..##.#.#.#.###...####..#.#.#.#.#.#.#..#.#.
.#...#.#.....#.........................#.#...#...#...#.#.#.#...#
.#.##..#.###.####..#####.#####.#.#####...#.#.##..#.#.#.#.#.#.#..
.#.#.....#...#.....#.........#...#.....#...#...#.#.....#.#.#.#..
...#.#..##..##.####..#.#####.###.#.#.#####.#.#.#.#####.#.#.###.#
.........#.....#...#.#.#.....#...#.............#.#...#...#.....#
.#.#.###.#.##.##.#.#.#.#.#####.#.#######.#####.#...#####.###.#.#
.#...............#...#.#.......#.................#..............
##.#####################.#########.#.#.###.#####.#.#########.###
