8
.#.....#
.#.###.#
...#S#..
##.#.#..
.......#
.#..##.#
G.......
#.###.##
