16
...........#...#
.....#.#.#...#.#
.......#....G#.#
...##.#..##.....
.......#.#.....#
#..##.##....#...
................
..##.#.#.#.###..
.#.......#......
...#.#..#..#.##.
.#.........#....
.....#.##..#....
...#.....#...#.#
.#.#.###...##..#
........S.......
.##..###.#.....#
