8
........
.....#.#
G#......
....##..
........
.#...#.#
......S.
#....#..
