32
...........#...#.........#......
..#.######.###...####.##..#..#.#
...#...........#.......#.......#
##.#.##.##..........#.####.##..#
...........#.....#.........#....
.#######..##.#.###.#.#.#.#.#.##.
.........#...#.......#.#...#...#
.#.##..#.#.##..##.####.....#...#
.....#...#..S#.#................
#......#.#.#.#.#..##.#.###.#.#.#
.....#...#...#.........#.#.#...#
.##....#..####.#.##..#...#.#..##
.....#.#.#...#...#...#...#.#...#
.##.##.#.#...#.###..#..###..##.#
.......#...#.......#.........#..
..####.##....#######...#...###.#
.......#.#...#.....#.#.#.#.#...#
.####....##..#..#..#.....###...#
...#...#.........#.....#.....#.#
.##..##..#######.#.#...#######.#
.#...#.................#........
.#...#.#.#.##...##.#.###.#.#...#
.#...#.............#.....#...#..
.##...##..#..#.#.#######.###.#.#
...#...#.....#...#...#...#...#.#
.#.###.##.####..#..#.#.###.##..#
.......#.....#...#.#...#.....#..
.#...##..###.##......#.#........
.#.#.....#.#.#.....#...#...#.#.#
.#.###.#.#...#.#.#.##.##.###.#..
..G..#.........................#
###.######.#############.###.###
