16
...............#
..##.#.##..#.#.#
...#............
.#.#.##.....##.#
......G....#...#
.#....#...##...#
.....#...#.....#
.#.#.#..........
...........#....
..#.##....##.#..
.......#........
...####.......#.
..............S#
.#####.#.#.#.##.
...............#
#..#..#...###..#
