8
.......#
.#.###.#
.#...#S#
.##..###
.....#.#
...###.#
G.......
.#.#..#.
