16
...............#
.##..#.###...#.#
...#........G...
#....#.#.....##.
...#.....#.....#
.#.#.........#..
.#.....#.#.....#
..###....##....#
.#S#.........#..
.#.........#.#..
.#.#.....#.#....
.#.#.....#......
.........#.#...#
.#...##...#.#...
...#............
..##..#..###..#.
