64
.........#...#.................#...............#...............#
.#..#.##.#.#....##.#.#.#####.###.#..#####.#.##...###.#..##...#.#
.#.#.......#...#...#.#.................#.#...#.#.#.............#
.#.###.########..#...##.##.#.#.#.#####.#.#.#.#.#...#####...#....
.....#.........#.............................#.#.#.#............
.....#..######.##..###.#.####..####..##.##.#.#.#.#.#.##.##.###..
...#.......#.....#...#.........#.....#.....#...#.........#......
##..#..#.#.#.#.#.###.#.#.#.#..#..#.###.#.#.#.####..#.......#.#..
.#.#.........#.....#.....#.............#.#.#.#...............#..
.#...#...###..#......###.###.#..###.#.#..#.#....####.#.#####.#.#
...#...#.#...........#.....#.#.#.........#...#.......#.#...#.#..
.###...#.#...#..###..#..##.#...#.#.##.##.#.#.#.#...#.#.#.#.#.#.#
.......#.#.#.#.#.#...#.#...#.....#.......#.#...#.#...#...#.....#
###.##.#.#...#.#...###....##.###.#####.#.#..#.######.#...###.#..
.........#.#...........#.#.....#.....#.............#...#.....#.#
.#######.#.##..###...#.#.#.#####.###.#.#.###.#.#.#.#.###.###.#.#
...#...#.#.........#...#...#.....#.....#.......#...#.......#.#.#
...#...#.#.#.##..##...##.##..#...#....##.#...#.#.####.###....#.#
.....#.#...#.....#...#.....#...............#...#...............#
#####..#...#.#.#.#.#.###.#.###.######..##..#.#.#.#.##....##.##.#
...........#.#...#.#...#.#.#.#.#.......#...............#G....#..
.###.#######.#.#...#.#.#.#.#.#.........#..##.#####.##..##...##.#
.#.....#.....#.#...#.#.#.....#.#................................
.#...#......##.#.#.#.#.###..##.#.###.#.#...#####.###.##########.
.....#.#.#.....#.#.#.#...#.#.....#.......#.#.....#.....#........
.#.#.#.....#.###...#..##.#...#.#...###...#.#..####.###....###...
.#.....#.#.#.....#.#...#.......#.......#.......#...#.....#...#.#
.##..#.#.#...#.#...#..#..#.#####.#.#..##.#####.#...#...#.###.#.#
.....#...#...............#...#.........#...#...#.#...#.........#
.#.#.#...#####.#.###.#.###...#.##..#...###...#.#.#.######.##.#..
...#.#.#...........#...#.....#...#.#...#...#.#.....#.........#..
..#...#..#...#.#.....###.######..#.#..#..#.#.....#.#.#.##.##....
...........#.............#.......#...#.#.......#...............#
.#.#.#...#.##..#.#.###.#.#.#.###...#...#.###.#.#...#####..###..#
.#.....#.#.#.....#.......#.....#.#.............#...#...#...#...#
.####..###.#...#.#####...####..#....#######.#..#.......###...##.
.....#...#...#.........#.#.....#.#.#...#.....#.......#...#...#.#
##.#.....#.#.#...#.#.#.#.#.#.###.#.......#.#.#.######..#.#.###.#
...#...#...........#...#...#.........#.......#...#.........#...#
.##.##....###.##.#.##########..##..#.#####.#.###.#.#######..##.#
.....#.....#...........#...#...#.#...#.......#...#.#...........#
.##...#.##.#.#.#....##.#.#...#.#.##.#.##.###..##...#.#.####.####
...............#...#...........................#.#...#..........
.##....#.#####...##..#########..##.#.#.##.###..#..##.##...#..#..
...#...........#.................#...#.#.....#.#...#...........#
.#..##.#.####..#.#.###.#####..#..#....#..#.#.#.....##.##.#...#..
.#...........#...#.....#...#.....#.#.....#...#.#.......#.....#.#
.##..###..##..##.#.#.#.#.#.##..###...####..#......#.##.#..##...#
...#.......#.#...#.#.#.#.........#.......#.#.#.#.#.....#.......#
.###.#.###...#.###.#.....####..#...#...###.#.#.#.#.#######.###..
.#...#.....#.#.#...#.#.....#.....#...........#.#................
##...###...#...........###.###...###.###.###.#.#.###.#.##.####.#
...#.....#...#...........#...#.......#.#.....#..................
.########..#.#.#.#####.#.#.#.######.#..###.#..#..###.###.#.....#
.........#.#.......#.........#...............#.......#...#.....#
.#.###.#.#.#.###.#.#.####.##.#####.###.###.#.#.......#...#..##.#
.#...#.....#.#.#.....#...............#.........#.......#...#...#
.#.......#.#.#.#.###...#...#.###.##...#..###...#.###.##..#.....#
.....#.......#.........#.#.#.......#...#.#.....#.#.....#.....#.#
##.#.##..##..##...#.##.#.#....#..##.##..##.#.#...#.###.###.##..#
...#.................#...#.#S........#.....#.#.#...#.#...#.#....
...#.#.#.###.##....#.#.###.##.######.#.#.#.#..###.##.###.#.#..##
.....#.............#.....#...........#.#...#...............#...#
.####.#.#.#.##.#####.#.#####.##.#.##.###.#.###.###...######.#.##
