32
...#............................
.#......#..#.........#.####.#...
.#...#.#.......#................
.#...#.#.##.#.#......#......#.#.
...#.....#......................
.....#.#....#..#...#...###.#...#
.#.#...#.........#...........#.#
#....#.####.#..#.##..#.##..#...#
.......#.......#.....#...#......
..##......###...#..#.........#..
.#...#.......#.#S..........#.#..
.#...#...#...#...#.###..##...#.#
...#.......#...#...#...........#
.....#...#.......###.....###..##
.....#.......#...#.............#
.#.....#.....##.#..###.......#..
.#.....#.............#.......#..
.#.#.......#.#...###.....#.....#
...#...#.....#.................#
.#.#.#.#...#.#.#.#.#.##.....##..
.........#.#...#................
.###.#.#.#.#...#.#..##...##..#..
.#...#.....#.....#...#.#...#....
...####..#...#..##.#.#.....#.##.
...#.......#.................#.#
...#.#.###.....#.###...###.#.#.#
.......................#...#...#
.####....###...#.......#..###..#
.......#.....#...#.....#.#.....#
.##.##..#..#.#.#.#.#...#.#.#....
....G............#.......#......
....#.##..##..#...##.##..#..#...
