16
.......#S.......
##.#.#.#.#.#.#.#
.....#.#.#.#.#.#
.#.###.#.###.###
...........#...#
.#.#.#####.###.#
...#.#...#...#.#
.#...###...#.#.#
...#.......#....
.#..#.########..
.#.......#.....#
##...###....#..#
...#.#...#.#...#
.###.#...#...#..
..G....#........
#########.###.##
