16
..........S#....
.....#.#..##.#.#
.#.#...#.#...#.#
#......#.#.#....
...#.#..........
.#........##....
.....#.........#
.#...#.#.#.#...#
................
..###.###..#....
..G....#...#...#
.#.#.......##...
.........#.....#
#..#.#...#.#.#.#
...#............
##...###.#..#.##
