8
..S#....
.###.#..
.......#
..####.#
.#...#..
.#.#...#
......G#
####.#.#
