64
..........................G......#...................#...#......
.....#.####........##..#.......#...#........#...#..#...#.#.#...#
.....#.........#...#.......#.......#...#.#.......#.#............
.#...##.#..#...#.....##........#..##...#.#.#.......#.......##..#
.#.#.......#.#.......#.........#.......#.#.....#.#.....#........
##.##..#.##..#..##...##...##.........##...##.#...#...#.#.#..##..
.......#...#...........#...#.#...#...#.....#.#...........#.#...#
...#.##.##.......#.###.....#...#.#.#....#....#.....#.#.#......#.
.....................#.#.......#.....#.......#.............#...#
..###....##..#...#.#.#.#.####..#.##....#...#......####.#.#.....#
.#.............#...#.#...#...#.....#.....#.......#.....#...#.#..
...#....#..#.#.#...#.....##.......##...#.#.#.#..............##..
...#.....#.......#.....#.........#...#.#.................#.....#
....##.#.#..##.#.#...#.....#...#...#.#...#.##..#.##....##....#..
.........#.....#.#.......#.......#.#.......#....................
.##...#..#.#.....#....#..#...#..#....#..##.#.#..#..#......##.#..
.......#.....#...................#.#.......#.............#......
......##.#...#.#.#.#.#.#.#..##...#...#...####.####.#..#..#..##..
.....#.........#...............#...#.................#.........#
.##.....##.#.....##....##.###....#.##..#...#..#.#...##.#.#.##.##
.....#.................#.......#.......#...#.#...#.........#....
.#.#....##..##.##.##..##...#.#.#...##..###...#.#.##..###.#.#.#..
...............#.............#.......#.................#.#...#.#
.##......#.#.##..#.#.#.####....###.#.#.#.........##.#....###...#
...#.......#...#.....#.......#...#...#.....#.....#..............
.#.#.....#.#.#...#...#.##.#....#.#.###.###..#....#.#.#.#.#.#.#.#
.#.....#.....................#...................#..............
.....#.##.....##.#..##....##.#....#....#..##...........#.#...#..
.........#...#.................#...#...#.......#.#.#...#........
......##.#.#.#..###.....###.#..#.#.#.##..#.#.#...#.....#.#...#.#
.......#...#.....#.............#.........#.......#.#.#...#...#.#
.#..##.....##..#....##.#..##.#..##.#.#.#.#.#.#.#.#.#...#.##....#
.#.#.....#.....#.#.......#.#.........#.#.....#.........#.......#
...####.#..#.#.#....######..###..#.#.........#...#..##...#.###.#
...#.........#.#.........................................#...#.#
#.....#.#.#.......#....#.#...#.#.#.#.........#....####.#.#.....#
.#.#...#.....#.................#.............#.........#...#.#.#
....#..#.....#.#..#.#.###..#.#.....#####..#...##.##..#.....#.#..
.#...........................#...#.........#...........#........
.....###.#...###..#.#....###.#.#.#.#.#..#......#....#..#...#....
...........#.........#...#.....................#.......#.#.#...#
....##...#...##......#.###.#.....#.###.#.#.#..##.###..#.##.....#
.............................#.#.............#...#.............#
.#.#...#...#.#.##..#.....#.#.....#...#....#....#.#...##......#.#
......S..#.........#.........#.....#.#.....#.....#.........#....
.#.......#...#..##....##.....#.#.#......##.#..#..#.#.....##..##.
...#.....#.#...................#.........#.#.......#...#...#....
.##...#.......#....#.#.#...##....##.####.#.#.#.#.#...#.#........
.#.............#.........#.......#.........#.........#.......#.#
.....#.###..#..######......#.#...##.#..#..##.#.#..##..#.#..#.#.#
.....#...#.....#...#.....#.....#.............#...........#.....#
.#.#.#.#.#.#.###...#...#...#.#.##...#..#...##..#.#.#.....#.#.#..
...#.......................#...#...#.............#.......#......
.......#.##..#.#.#....#.#.#....#.###.#.###.#...#.#.#...##....#.#
.............#.#.................#...#.#...#.....#.#...#...#...#
####.#..##.#.#.....#.#.#.##.#..###...#.#...#.............###.#.#
.......................#.....#.................#.............#.#
.#......#.#..#.....#.....#.#.#.#...#...#.#.#......######...#...#
...#...........#.....#.......#...........#.....#................
.##...#.....#..##..###....##.#.........#.#.#..#..#.#..#...#...#.
.....#.............................#.#...#...........#...#.....#
.......###..#..#.##.....##.####..##..###.###.#..####.#....#.....
.......#.........#..............................................
.###...##....##..#....###......#...#...#.#...#####.#..##.....###
