8
..G....#
.#..###.
.#.#...#
........
.......#
...#.#.#
.....#S#
.####.##
