8
.......#
.#..#...
.#..S...
##....##
...#....
..##.#..
G......#
..#.....
