64
.............................#...#..............................
..#..#..#..##..#...#...###.#.....#.#..###.....#.#####.#..#.##...
.#...........#.#.....#.#.....#.....#.........#...#.....#...#...#
.#....#.####.#.#.##.##.#.#..##.#####.#.##.#.#..#.#.#....####.#.#
.#.............#.......#.#.....#.......#.................#......
.#..##.###.###.####..#...#...#.....##..#..####.##..#.......#####
...#...#...#...#...#.#.......................#.....#............
###..###...#.###.#.#.#.#.#.#.#...#.#.####.####.#...#.##..#.##..#
...#.....#.#...#.#.#...#.....#...........#.....#.#.#.#...#....G#
..##.#####..##.#...#.#.###.##.##.#.####.....#.##.#.###.#.#.#...#
.....#.......#...#.............#.#.......#.....#.#...........#.#
...#.#.#####.#...#.#.##.#.#.#..#.#####.#.####..#.###.##.##...#.#
.........#...#.....#.....#...........#...#.....#...........#.#..
.#.###.#.#.#####.#.###.#.####.####...#.#...#.##..#.##.#####..#.#
.#.....#...#.....#.....#...................#.....#...#.......#.#
.####.#......###.#...#..#..#.#..###.......##.....#.#.#.#..##.#.#
.......#...#.....#.......#...............#...#.....#...#...#.#.#
.#...#.###.#.#..#..#.#.#.#.#####.##..#.#.#..###...#....##..#.#.#
.#.......#...#.#.#.#.#.#...#...#...#...#...........#.#.#.#.....#
.##.#..#...##........#....#..#.#.#.#####.###.#.#.#.#.#.#.#.###..
.....#.........#...#.........#...#.#.....#.......#...#.....#...#
#.####.##.####.#...####.#..###.#...#.#####.#####.###.#.....##...
...............................#...#...#.....#..................
..##.#####.####......#.#...####.#.###...#.##.###.###.#.#######.#
.#.#.#.................#...#...........#...#.......#...........#
.#.#.#.#######.##.###..#...#.###.###.#.#.#.#....#....#.#.#..####
.#.....#...............#.#.#.#.........#.#.....#...........#...#
.#.#####.#.#..##...###.##...#...##.#...#.#####.#..####.##.#....#
...........#...#.........#...#.#.........#...#.......#.........#
.###.#.#.#...#.#.#######..#....#.#.#.###.#.#.#.#.###.#.....#.#.#
.....#.....#...........#...#.......#...........#.............#.#
.#.#...#...##.##.##.##.###.#.##..###.#..#..####.##.#.##.###..#.#
.#...#...............#.....#...#.#...#...#.#.......#.........#.#
..#...##..#.###.##.#...#..####.#.#..#..#.#.##.##.#.#.#.#.##.##.#
...........#...#.....#.#.......#.#.......#.#...#.#.....#.#.....#
...######..#...#...###.#.#####.###...###.#.#.....#.#..#.##.#.###
.#.........#.#.#.#.....................#.....#.#.......#........
.##.#..##.##.#...#.####..#.#####...###.#.#####.#.#.#.#.#..####.#
.......#.#...#...#.....#...#...#.#.#.............#.......#......
.#.#...#....##.#.#.###.#.###.#...#...####....#....##.#.#.#...#.#
.............#.#.#...#...#.....#.#.#.............#...#.#.#......
.#.####.######...###.#.#.#.#.###.#..##.#.###.###...#.#.#.##.##.#
.......#.....#.....#...#...#...#.#.#...#...#.....#.....#........
.###.#.#.##..#.##..#..#..#.###...#.......#.#.#.#.....#.###.#...#
...#.#...#...#...#.#...#...#...#.....#...#...#.#.#...#.........#
.#..#..#####.#.#...#.#..#..#.#####.#...##.##.#.#.###.###....###.
.#.....#...#.....#...#.................#.......#.......#.....#..
.####....#.#.#####....##...####.#.####...#.#######.###.#.##..#..
...........#.#...#.#.................#...................#...#.#
..####.#.#.##..#...#..###..#.#.#####.###.#.####.#..#.#####.#....
.......#.#.....#...#...#...#...........#.#.........#...#.....#.#
.#..####.##.##..#####..#.#.#...#.#.###.##....#...#..##.#.#.#.#.#
.#.#.................#...............#.#...#...#.......#...#....
.#.#.##.#..####.###..###.#.###..####...#.#.#.#.#...#..####...#.#
...#.#.....#.......#.........#.#...#.#.......#.#...#.......#...#
.#.#.#.##.###..#.##.#####.#..###.#..#####.#.#..#.#.#.#.#.......#
.#.#.#.........#.#S..............#...#.........#.#.......#.#...#
.#.#..#.##.##.##.##...####.###.#.#......#.######.#.#.###...#...#
...#.......#...#.#.......#.#.#.#...#...#.....................#.#
.#####..#..#.#.#.#.###.....#.#...#.##.#.##.#.###.#...#.####.##..
.........#...#...#.#.........................#.......#.#...#...#
.#.#...#..#..#.###...###.###.#######.#.#.#...##...#..#.#.#...#..
...#.........#...........................................#.....#
###.####....#.##..#.####..##..###.###..############.###.##.#.###
