32
.............#...............#.#
...#..##.#....#...#..#.##....#..
...#.........................#.#
.#.###.....#...#...#.##.##.#...#
.#.#.......#...#...#............
.....###.....#.#..#...#.##..#...
....G....#.....#...............#
.#....##....#....#....##...#..#.
...........#....................
.#.##...##.#.#.....##.#.....#...
.............#.............#...#
...#..##.#.#.#...#.#.#.#...#.##.
.#.#.#.......#...........#.#...#
.....#.#.#.....#...#...#.#....##
.....#.#...#.......#...#........
#.##.......###.#....##.#..##.#.#
...#.#.............#...#........
.....#....##.#.#.#.###.....#....
.......#.........#..............
...#.#...#.#..#.##.....##.##.#..
...#.....#.#.#.......#.#.#.....#
#..#.#.....#.#.....##......#####
.......#.......#.#.......#.....#
....##..#..##..#.#.#.##..###.#.#
.............#..................
.#.##.#####.....##.#.#..##.#...#
.......#.......#...........#...#
.#...#...#.....#...##...##..##.#
...#.#.#.#.....#S#...#...#......
...#.......#..#.##.#...#..###...
.....#.................#........
.#..###.#.#.#.###.#..##.######.#
