8
...#....
.#....#.
..S.....
..#.....
.......#
#....#..
......G.
...#.#.#
