64
...#...........#.......#.....................#..................
.##.....###.#....#.##.#...##....##.....#..##...#.#.#.####.#..#..
.......#...#.............#...........#.#........................
.#.##......#..#......###.....#...#.#.#.#.........#...#...##..#.#
.....#.........#...#.#...#.........#.#.#.............#..........
....###...#..#....#..#.#...#...#.###.#...#.###.#...#.........#.#
...#.............#.............#...#....G..........#.........#.#
.....#..##....#.....##...#.#..###..#.##..##.####..#....###.#...#
.........#.#.#...#.....#...#.#.................#...#.#...#.#.#.#
##..#.#....##..#.#.##.#..#.#.#.......#.#####...#...#.##..#...###
...#...#...#...........#...#...#...#...#.........#.....#...#...#
.....#...#.#...####..#...#.#..##..#..#.#.###..#......#.###.##..#
.....#.....#.........#...#.......#.....#.............#..........
...#...###..#.#....##..#.####.....#....#.#..##.#..##..##...#....
.....#...#.............#.....#.........#.#.#...#................
..##..#...##.#....#..#..#....#.#.##......#..###..#.#.#####...##.
...#.#.........#.#...........#...........#...#.............#.#..
...........###...#....#.##.##...##.#...#..#....#.#.#.#####.....#
.....#...#.#.........................#...#.#.......#............
.#.#.#.......#.#........####.#...#...#.###.#.......#......##.##.
.......#.#...#.#.......#.............#.#........................
.##.#.##...#...#...##..#.#.#.#.......#.###.....####.####..####..
.....#.......#...#.....#.#...#...#...#...#.....................#
##...#..###.......##.#.#.......#.##........###..#..#..##.#.#...#
...#.#.#.....#.....#.#.................#.#.........#.....#......
...#....##.#...#.#...#.....##.#.#..#.###.#...##..####....#.##..#
.#...#.........................#.............#.......#..........
.....#..##.......#.....#.##......#....#..#..#....#.#.#.#..##.#..
...#.......#.........#.........#...............#.#.#...#...#...#
...####.##.#.#...##..#......##.....###.#.#...###.#...#.#.#.###.#
.#.#.....#...#.......#...#.........#.#.#...#.......#............
.#.#..##.#..##...##......#.#....#.#..#..##...#...#...#.#..#..###
.......#.............#...#...........#.#.........#.#............
##.###.....##......#..#....#.#.#...#.#.....#.#.......#.####.....
.#.#.#.............................#...............#.#..........
.......#.###.#.#.#..#..#..####..#........#..##.##......#.#...##.
...........#...........................#...#...........#.....#.#
..#....##......##........###.#..#..#.....#.....#...#.#.#...#.#.#
.....#...#.........#.........#...#.#.......#.....#...#...#.....#
.###...#..##.#...#.##..#.....#.#...#....#..#..####...##.....##..
...#...........#...............#.............#...............#.#
.....#..##.......#.....#.....##..#....###.#....#.#.#.#..#.##.#.#
.#.........#.#...........#.....#...#.........#.#...#.#.........#
.#.#.######....##.###.#..#.#.#.........#.#.#.#...#.#.#..##...###
.......#.............#.....#.................#..................
#......#...#....#.#.....#....#...#...#.#.#..#..##.#..#.##..#...#
.........#.#.......#.......#.....#.......#...#..................
.#.#..##.....##....#.....#.....#...#.#...#.....####.##..#.#.##.#
...#.....#...#.#...#.....#.....#...........................#....
.#.#...##....#.#.....#....##...#..##.#.....##..#....#..##.....##
.#...#.................#.....#.....#...#.......#...............#
###..#.##.#..............#....##.......#.......#...##.##..#....#
.......#...................#.......#...#.#...............#...#..
.###.....##..#.#.....#.###...#..#.##..####.#..#.#..#.#.#.#...#..
...#.......................................#....................
.#.##.##.#.#..#..#.#.#..##.##....###...#.......#.##...#.####.#.#
.#.......#.....................#...#.#..........................
.#.....##........##...##..##.#####.#.###.#..#.#.......#.#...#...
...............#...#.#...#...#.#................................
.##....#..#....###.#.....#.#.......#..#.......#####.....#...#..#
.#...#.#...........#....S....#.................#...............#
.#.#.#.##.###...#..#..#.#..#.....#.....#.#...#.#..##..#..##.#...
.........................................#...............#......
##.####....#.#.#####.###..#...#.###.#..#..#######..#######..#...
