32
.....#.....................#...#
.###...#.##..####..#.#.###.#.#.#
.......#...#.#...#.#.#...#.#....
.#..##.#.#.#.#...#..####.#...#.#
.#.#.....#...#.#...............#
.#.#.########..#.##.##########.#
.#.#...........#.........#...#..
.#..#..##.##.##..###..#..#.#....
S#...#...#.#...#.......#...#.#..
..##.###.#..##.#.###.#.#####.#..
.....#.......#.......#...#...#.#
..####..###..#####..##.#...#.#..
.#...#.#...#.#...........#.#...#
.#.###.#.#.#.#.########..#..#.##
.#.....#.#.............#.#......
.###.###.#.##.###..###...#####.#
...#...#.#...#...............#.#
##..####.##..#.############....#
.#.#.....#...#.#...........#.#..
...#.#.#.#..#..#.###....##.#.#..
...#.#...#.....#...#...........#
...#.#.#.######..#.#####.#.###.#
.#.#.#...#...............#..G#.#
.#.#.#####.###..####..##.###.#.#
.#.#.............#...........#.#
.#.###.#..######.#####..###.##.#
...#...#.......#...#............
.#.#.##..#.###.#.#...#######.##.
.........#.......#...#.........#
##.###.#####.###.#####...#####.#
.........................#.....#
###.#...#.######.######...#####.
