32
...........#.....#.......#......
.###.#####....##.#.#..#.#..###..
...#.............#.........#...#
.#....####.#.###...###.#.###.#.#
.#...#.....#.#...#...#...#.#...#
.#.###.#.###.#.#.#.###.#...###.#
.#...#.#.....#.#.#.#.......#...#
.###.#.#.#####.###.#.###.#.#.#..
.....#.#.#.....#...........#.#.#
####...#.#.#.###.####.######.#.#
.....#.#.#.......#.....#.....#..
.#.##..#.#.#######.#.#.#.###.#.#
.....#...#.........#...#...#...#
##.#.####..#...######.#..#..##.#
...#.#.....#.#S..........#.....#
##.#.#.#####.####.#.####.#.###.#
...#...#.....#.....#.#...#.#....
.##.####.##.##..##...#.#####.#.#
.......#...#.....#.....#.....#.#
.#.####.##...#.#.###.#.#.#.#.#.#
...#.....#...#.#...#.#.#.....#..
.##....#..##.#.....#.#.#.###.###
.#...#.#...#.....#.#.#.#...#...#
.#.#.....#########.#...#######..
.#.....#...............#.......#
.###.#...##.#######..#.#...#####
.....#.#.....#...#.....#.......#
.#####.#####.#.#..##.#.#.#####.#
.....#.......#.#.#...#...#.....#
.##..########..#.#.#.#.###.#.#.#
...............#.....#.....#..G#
####.######.#########.##.##.##.#
