8
.....#S#
....##..
.....#..
..##.#.#
G..#...#
.#...#.#
........
..#..##.
