8
......G.
.#..####
.#......
###....#
..S#...#
.###....
.......#
...#..##
