32
.....................#.........#
.#.###.###.####.##.#.#...#####.#
.#.........#.......#.#.#...#...#
.#.##.##.###.###.#.#...###.....#
.#...#...#.....#.#.....#.#...#.#
####.#.##.#..#..##.#####...#.#.#
..G..#.......#.......#...#.....#
.###.#.###.###.##.##...###..###.
.#.....#...........#.#...#.....#
.#.###..######.###.#.###....##..
.....#.........#...#...#.......#
.###.###.#####.#.#.###...#.#####
.#...#.........#.#.......#.....#
.#.###.###.#.###.#..####.#####.#
.#...#...#.#.....#.........#...#
..#...####.#.#.#..###....###.#..
.#...#...#.........#.....#.....#
.#.###.#.#.###.###.##..###.###..
.......#.....#...#.....#...#...#
.#.###.....#.#..#.##...#.#####.#
.#.....#.#.....#.......#.....#.#
...#.###.##.###..#########...#..
...#...#...#.....#...........#.#
.###...##..#.###.#.######.####.#
...#.#...#.............#...#...#
##.###...#########.#.#...#.#.###
.#...#.......#...#.#...#.#.#...#
.###..##.#.#...#.#.#.#.#.#.###.#
...#.#...#.#.#.#...#.#S#.#...#.#
.##..#.#..##.#.#####.##..###.#.#
.............#.......#.....#...#
########.#######.###.#####.#####
