64
.................#.........................#....................
.###.#.......#.#.#...#.#.#.#.....#...#.#...#...#.#..##.....#....
.....#.#...#.....#...........#...#.....#.#...#.............#...#
....###..#......#.......##.#.......#.#.##..##...#.....##.#.#.#..
.......#.#.......#...........#.......#.#........................
...#...#...#..##.#####...#.#...##....#.#..##..##...#.....#.####.
.....#...#...#...........#.#.........#.................#........
.....#####.##...####......##.....#.....###...#...#...#...#.#.#..
.......................#...#...#...........#...........#........
...........#.#.#.#....##...#....###..##..#.#.###.#.....#...#...#
.......#.....#.......#...............#.....................#.#..
..##..##.#..#......#.#.#####.###.....#.#...#..#..#.#.##..#...#..
.........#...#.....#.#...........#...#...#.......#.............#
.#.......##....#.#...###.###..###..##.#..#...#.#.#..#......##...
.#....G#.#.#.....#...........#.#...#...........#.......#.#......
..##.#...#.##.....##...#....##.#.........#......#.####.......#..
.#.......#.....#...#...#.........#...#...............#..........
...#...##....##....#.#...#.........#.#...##..##......#.##..#.#..
.............#...................#.........#...#...#............
###..###...###..#..#......##.#...#..###.##...#.##....###.##.....
.....#...........#.......#...#.....#.....#...#...............#.#
.#..##.##......#...#..#.#....#.#..##.#.#.#...#.#.#.####........#
.#...#.....#.....#.#.......#.......#...#.#.#...........#.......#
......##.#.#.#.#...#.#.###.............#...#.......#.#.#####.##.
...#.........#.#...#.....#.....#...#...#...#.#.......#..........
...##.##.#.##..#......#....#...#..##.#.##.##.#.#.#...#.###.....#
.#.....#...#...........#.....#.....#.......................#...#
...###.#...#.#.###....##.####....#.#..####...##.#...##.###...#.#
.#...........#.....#...#...........#.....#.....................#
.#.#..#..##..###.#...#.#...###.....###...#..#.##..##.#...###.#..
...#.................#.....#...#...#.................#...#......
###..#.#.#.#...###....####.#..##.#....#.....#........#....#....#
.....#...#...#...#...........................#.#...............#
...#...#.....#.#....###..#.#.#.#.#.#.........#.#.###..#.##.##..#
.#...#.....#.......#...............#.#.....................#....
..##.....##..##........#..#......###.#..#..#.#.#.#.##....#...#..
.#...........#.......#...#.....#.......#.........#...#...#.#.#..
.#####.#.#.#.....#...#.#...#.#.#.#...#.##......#.#.#.#.#..#..#.#
.#...#.....................#...........#...#...#.#...........#S.
.#.#....###..#..#..##.##.###..#....##.....##...#...#.#...#..#...
...#.......#.#...#.......................#...#.....#.#.....#...#
..##.#.............##..#.....##.##.#.###.#...#.#.....#.#.#....#.
.........#.................#.......#...........#................
...#.....#.#.#.....#...###.#.#.#####.#.......#.#...##..#..#..#.#
.#...#.....#.........#..........................................
...#.#.#...#.......#.#.#.........###..##.##.#..####..#.##.##.#.#
.........#...#...#.....#...#...#.......#...#.....#...#.......#.#
.....#.#.....###....#.....#....#.#..##......###..#.....#.#.....#
...#.......#...#.......#...........................#.#...#.#....
.#.#.#...#..#....###...###..#....#.#......###....#..####....##..
...............#.....#.............#.....................#.....#
...#..#..#.#.#.#...##..##..#.#.###...#..##.#.#..#....##....##...
...#.#...#.#.....#...#.#.....#.#...#.....#...............#.....#
.#.......#.#...#.......#.#...#.###..###.###.#..#.....#####.....#
.......#.....#...............#.................#.......#........
.##..#.....#.....#.###.#..#...#..#.#...#...#..#.###.##...###...#
.......#.....#.....#.........#.......#.....#.........#.......#..
##.#####.#......##.#.#.#...###...#####..#.##.##...#....#...#...#
.#.............#...........#.......#...................#...#...#
.#.#.#.....##..#.#........#..#.#.###...##.#..####....#.#...###..
.........#.......#.......#.........#.......#.#.....#...#........
.....#.#.#.#.#.#..##...#...###.#....#..###......##.#.#.#...#.#.#
.........#.................#.....#.........#...............#....
..#..##..#...#.#.#.....#...#....#######..##.....##.###.....#.#..
