8
.#S#...#
.#.###.#
.#.#...#
...#.#.#
.....#.#
.#..##.#
G......#
#.###..#
