16
.........#.....#
..###..#...#.#..
...#............
##.#.....#.....#
...#G........#..
.###.#.......#.#
...#.....#.....#
.#.#...........#
.....#..........
...#.....#.#.#..
.........#......
.#....##.#..##.#
...........#...#
...#.........#..
.......#......S.
#.#....#.#......
