8
........
##.#####
S......#
.##..#.#
...#.#..
##.###..
......G#
.#.#.#.#
