32
.#.................#.........#..
....#.##.#...#..##.#.#..#....#.#
.#...#.....#.........#...#.....#
.##........#.#...##.#..#...##..#
.....#.....#.............#.#..S.
..##.####.#....#.#.#...#...#....
.....#...#...............#......
...#.###.#....#..##..#.#.#......
.#.....#...#.........#.........#
.##..#...##...##...#.#.#.#...#..
.....#...#.....#...#...........#
...####.....##.#...#.##..#.#.#.#
.#.#...#.......#.............#.#
.......#.#..........##.##..#...#
.............#.#...#.....#...#.#
###..#...#....##.#.....#.#...#..
...........#.....#..............
.##.##.####..#.....#.#.###.#....
.#...................#.....#.#.#
.#.#.##.#..#...#.#..##.#.#.###.#
......G..#.....#.......#........
..######....#..#.#..#...#....###
.....#.#.....#...#.....#.......#
##......##.#.##.#..#..#...##...#
...................#.........#.#
.#.#.#.##..#...#.#.#.......###..
.#.............#.........#......
.#.###..#......#####.......##...
.....#.....#.......#...#.....#..
.#####.#.#.....#.#.##....###...#
.............#..................
#..##.###.###.####..#...#....#..
