8
G.......
..#..#.#
......S#
..##....
...#...#
.#.....#
.#......
.#.#####
