8
....S#..
.###.#..
........
.#......
...#.#..
...#....
G.......
#...#...
