32
.......#...............#.#.....#
.####......###########.#.#.###.#
.......#.#.#.............#...#.#
##...#...#.#.##..######....###..
.#...#.........#.#.........#...#
.#.#.#.#####...#.#.#.####..#.#..
...#.....#...#.............#.#..
.###..####.#.#.###.#.###.###.#..
...#.......#...#...#.#.......#..
.....#.##....#######.#...#####.#
...#.......#.#...#...#.#.......#
.##.##.#...###.#.#.##..###.#####
...#.............#...#..G......#
##.#.#######.###.#.#.#.#.#####.#
...................#.........#..
.####.##.###...####.##..#.......
.#.....#.....#...............#..
.#..##....##.###...#..##..##.#.#
.#.....#...............#.......#
.#.#.#.#...##.##..##.#.###.#.###
...#.........#.....#...#...#....
###...####.#.#.##...#.##...###.#
.........#.#.#.#.......#.#.....#
.#######...#...#..####.#.#.##..#
.#.........#.#.................#
.#.##.#..#.#.#.##..#.#.#####.#..
...#...........#...#.#.....#....
....###..##....#.#.#..##.#.....#
.........#...............#.#.#..
#########..##.##.#..###......#.#
S................#...........#..
#.##.#.#....#.####..####..######
