64
.......#...............#.#...................#.........#........
.#.#####...###..##.###.#.#..#.##.##..#.##....#....##.....####...
...#G..........#...#.....#.#.#.......#.#.........#.......#.....#
.##...#.##.#.###...#####...#....##.###.#..#..#.#.#.#.#####..####
.........#.....#.......#.....#.....#...#.....#.#.........#......
##..##...#.##.......#..#.#.#.######......#...#.#.#....##.##..#..
.......#.#...#.#...#.#.....#...............#.#...#.#.......#.#.#
.#####.#.###.#...#...#.#.....#.#.#...###...#.#...###.#.#.#.#.#.#
...........#.............#.#.#.....#.......#...............#.#.#
..##.####.##.#.#.#.#.#...#.###.#.###.#.######.###.....##.#.#...#
...............#.....#.#.#.....#.................#.........#.#..
...#####.#.###.#.###.#.#...#############...##..###.#.#####.#...#
...............#.#.....#.#.........#.......#...............#...#
.##..#.#.#.#.##..####..#.#..##...###.#..#..#..##.#######....#..#
...#.#...#.......#.....#...#...#.......#...#.#...#...#.......#.#
.#.#.#.###.#.#####...#.####....#######....##..####.#.#.#..##.#.#
.#...#...#...#.......#.#.........#.....#.#.#...................#
...##..#.###....####...#.#####...#.###.#.#.###...##..#.#.#.####.
.#.....#.#...#...#...#.#.......#.....#.....#...#...........#....
.##..###.#.###.#.#.#.....#.#...#####.#.#.###.#.#...#.##..##..#.#
.....#.#.#.#.......#...#.#.#.#.....#.#.#...#.#.#.#.#...#...#.#.#
....##.#.#...##..##.##..##.#.##..#.#.#.#.#.#.#...#.###.####..#.#
...#...#.....#...#.........#...........#.....#.............#...#
.###..##.#....#.##.#..##..##.##..######..###...#.#..##.##..#...#
...#.....................#.......#...........#...........#......
#....#....##.##.#.##...#.#.###...#.#...##.##..#..###.###.#####.#
...#...#...#.#.......#.#.#...........#.......#.....#...#.......#
..###............#.###...###.#..##.#...#..###..#.......#.#.#.##.
.......#.....#.#.#.............#.....#.#...#...#...#.......#...#
.#.#.#.#.#.###.#.....#.#.#.###.#.....#.###...#.###.#.#.##.###..#
.#...#.......#.......#.#.#...#...#.#.#...#.#...#...........#...#
..##..#..#...#.##.#.##.#.##......#.##.##.#.####....#.#..##.#.###
.........#.#.#.....#...#...#.#.#.#.....#.#...#.......#.........#
...###.#.#.#.#.#.#...#.#.###.#...##..#.#..#..#.###....#..###.#.#
.#.....#...#...#.#...#...#...#.....#...#.....#.............#.#..
.###...#...###.#....####.#...#...#.....#######.##..#.#.###.##..#
...#.#.............#...#.#.......#...............#.#.....#.#...#
...#.#.#.#.#####.###.#.###.##..#.#.######.##..####.#.#..........
.#...#.#.#.......#...#.........#...#.......#.......#...#...#.#.#
.#..##...###.#..##.###.#.###..#..#.....#.#.######.###........#.#
...#.....#...#.....#...#.............#...#.............#.#.#...#
..##.#.#.#.####.###..#.....#...#.#..##.#######.###.###.#.#.#...#
.........#...#.............#.......#.........#...#...#.#.#...#.#
###.##.#.#.#.#.#...#.##....#.#.##...#.##.......#.##..#.#.##....#
.......#.#.........#...#...#.#...#.....#.#.....#...#.#.....#...#
.#..#.##...###.#.#####..#.##.#....#.##..##.#...#.#.#..##.###..##
...............#.#.....#...#.#...#.....#...#...#.#.#...#.....#.#
.##.##...###..#..#.#####..##.#..##....#..###..#.##.##..#.#####.#
.#.....#.....#...#.#.#.......#.#...#.......#.............#...#..
.#.#.######.##.###.#.#.##.####.#.###.#.##..#####...#..####.#...#
.#...........#.................#.#.....#...#...#...........#....
.#.####.##.#.#.#########..####.#.####....#.#....#####.#..###...#
.#.........#...........#.#.....#.......#...........#...........#
.##..#####.#.#..#.####.#.#.#.#######.#.###...#.###.#.###.##.##.#
.#...............#...#.........#.......#.........#...#.......#.#
.#.#.#.#.#..####.#.#.......#.###.##...#..###...#.#..##.#.#...#.#
...#.........#.....#...#...#...#.......#....S#.#.........#.#...#
.#.#####...#...###.###.##..#.#..#.#.##.#...###.###.##..###.###..
.......#.#...#...#.#.....#...#.........#.#...#...............#.#
.#.#.#.#.###.###.#.#.#.#.###.#..###...#..#...#.#.#.###.#.......#
...........#.....#.......#...#.........#.#.#.....#...#.......#..
..#.##.###...#.###..##.#.#.#.#.#.##.#....#.######..#.####.......
.......................#...#.........#.............#...........#
###.....#.#.##.#######.##.###.######.###...#####.#########..##..
