32
...........................#....
.#.#.##..#######.##...#....#.#.#
.#.#...#.#...#.#...#.........#.#
.#.###.#.#...#..##.#.#.#####....
.#.#.....#.#...#.......#.......#
.#.#.###.#..#..#.##.#.##.#.#..##
...........#.#.#...#...........#
.####..#####.#...#.#.#.#.#.##..#
.#.............#.....#.#...#...#
.#.####..#####.#.#.#...##.##.#.#
.#.....#.....#.........#.......#
.#.....#.......#.###.....#####.#
S..#...#.......#.#.......#...#..
#.#.....######..#...###..#.....#
.............#.........#.#.....#
.#.#.##.##.#.#.#..#..#.#.#.#.#.#
...#.#.....#.........#.#.#.#...#
#....#.....#.#.#...###...#.#...#
...#.#...#...#.........#.#......
..##.#...###.#.#####...#.##..#.#
.....................#.....#...#
..######.#..#####.####.###...#..
.#.....#.#.......#.......#.#...#
.#..##...###.##..#.#.#.....##..#
...#.#.....#...#...#...#.......#
.##..#.#.#.....#####.#.#..##..##
...#...#.#.........#.#.....#...#
..##.#.#.##..####..#.#.###..#...
.#...#.....#.....#...#...#.#...#
.#.###.###.####...#..#.#.#.#.#.#
.......#................G......#
.#.##..###########.#####.#..####
