64
.....................#.................#...#.............#.....#
.#.#.#..#.##.....##..#......##....#....###.#...###.#.#.#...#.#.#
.......#...#...#.........#...........#...#...#...#.#...........#
.#.......#..##..........###..#.....#..##.#.#.#.....#.#.#.#.#...#
.............#.#.....................#.#...#...#...#...........#
..#.##....##.#.#.#........##.###.##.##.#..##...#####.#..#.....##
.....................#...#.#.....#...........#..................
.###...#.#.##.....#...#.#..#.##....#........#........#.#.#.#.#..
.......#.#...#.............#...............#....................
.#.#.....#.......#...#.....#.##.#.##.#..#..#.#.#####...#.#.#...#
...............#...#.................#.......#.............#...#
.####..##......#...#.#.#.#.###..##.#.#.#.#.......##..#####.###.#
.....#...#.....#.....#.........#...#.#.#.......................#
.###.....#.#.....#.#...#....#.....#....#.##..#..##..##.......##.
.#.....#...#...........#.............#.#.......#.#..............
.#.#.......#.#..#..####..#.#...#..##.....#.#...........#.##..#.#
...#.....#...#...............#.#...#.........#.................#
.#.#.#...#.#.......#.#..##.#.#.#.#...###.#...##...#....#.#.#....
.....#.....#.#...............#.#...............................#
..#....##....#.##....#..##.......##....#..###....#....##........
.#...#...#.......#...................................#.........#
...#.#.#...#####...#..##..#..#.#.#.#..##..#.#....#...#...###.#..
.#...........#.........#.............#.........#...#...........#
.#..#..###.#...#.#...#...#.#.....#..#.....####.###....#...##.#..
.....#...#.#.#.....#.#.....#.#.....#.............#.............#
.#.#.....###.......#.##.#..#.#..#..#..##...##......#.##.#..#.#..
.....#.#.#...#...............#.....#...............#.....#......
##.#.....#..#.#..#.#####.#.#...##..#..#..#...#....#...#.........
...........#...................#.......#...#.#...........#......
.####.##.#.#...#.#.#.##....###.#.#...#.......#.###.#.#.####.#..#
.....#.......#...#.................#.#.......#.........#.....#.#
.....#.###.#.#.###.......##.##.#.#.#.##..###.#.#..##.##..#.#....
.....#.........#...................#...........#.....#.........#
...#..#..#..#.##.##......#.###.....#...#...##....#.#....#....#.#
..S....#...#.....#.....................#...........#.....#.#...#
.##..#..#..#.#...#.#.#...#....##.#...#.......###.#..#..#.....#.#
...............#...#.............#...#.........................#
.#.#.##....#...#.#.#.#..##..#....##....#..#....###..#....#....#.
.#...........#.#...#.#.....#...............#.........#.........#
.###...##......#.##..#.#.##...##....#.........##...###.###.###..
.............#.....#.#.......#...................#.....#...#....
###.#......#.#..##...###...##......##.....##.#.#...#....#..#.##.
.................#.#.....#.....#.................#...#...#...#.#
...##..........#.#..##.#..##.#.#.....#.###..###..#...#...#.#....
.....#.....#...#.............#...#..............................
.#...#.#.#..#..##..#.#.#.####....#.....#...#.#.....#.#.....#.#.#
...#.........#.......#...#...............#.....#.....#.......#.#
.#.#...####....#.#.#.#.##..#..##...###.#...#.#....##...#.#.#...#
...#.#.................#...#.......#...#.#.#.....#...#.........#
..#......#....##.#...........#.####....#.....#.#.....#..#.......
.#...#.#...#.........#.#...#...#.....#.....#.......#...........#
....#..##..#.#.#.#.#...#..#..#........####.#.#...#####.#........
.......#...#.#.#.............#.....................#.....#....G#
...#.#.#.#.#.#..##.....#.#...#.##.###..##.#..##....#..#..#.#.#..
...................#.....#...#.........#...........#.#.....#...#
...#..##.##....###.....#.###..##..#....#.#...#.#.....#.....#..##
.......#...........#.#...#.......#.#.....#.#.........#.#.....#..
.......###....#..............#...#..##...#.#.#.....#.#...##.#...
...#...............#.....#.............#.#.....#...#............
.......##.##.##...##.#...#...##...#.##......#..........#.#...###
.#.........#...........#...............#...#.....#.............#
..#.....##.#...###.#.......#..#.#..##.##.......#.#.#...#.#.....#
.........#.....#...........................#.............#......
#...##....##..#...#..###..#..#......###.####.#...#.#....#.#....#
