16
.#....S#.......#
.#....##..##.#.#
.#.........#....
...#.#..##......
.....#..........
.###.##......#..
.........#.#....
.#.#..####......
.#..............
.#...#.###.#.#.#
.#.#.........#.#
.#..##.#..#....#
.........#.....#
..##.##.##.###..
............G..#
.....#.#....#.#.
