32
.............#...#.........#....
.....#.......#.#...#..##...#....
.#.....#...#.....#..G....#...#..
.#.#......##.....#.....#.###...#
...#...#...............#.......#
..#..##..#.##...##.##..#.#.....#
.....#.....#.............#.....#
.#.###.#.##.##.#.#..#..#.##..#.#
.....#.......#.......#.....#...#
.###.#.##.....##..##.#..##.##..#
...#...................#........
.#...#..##.#.#....#....#.#.#...#
.......#.............#.....#....
#.#..#...##..#....#.....#..#....
...............#.............#.#
.#.....#.....#.##...##.#.#.#...#
.......#.............#.........#
...........##..#..#..#..#..#####
.......#.............#.........#
.....#.#...##........#......##..
.#.........#...#.......#...#....
.#..##.#...#.##.....###..#...#..
...#...#.......#.......#...#....
..####..##.#.#....#.##.#..##.#..
.....#..S.......................
.#......#..#.##...##..##.#.#....
.#.#...........................#
...#...#...#...##.####.#.##.....
.#.#.......#...#...........#.#.#
.#.#...##....##..##...#......#.#
...#.......#...........#.......#
#....#.....#.##.##..#####.##..#.
