64
...........#.........#.........#.....#.....#...#...............#
.#####.###.###.##.##.###.#..#....#.###.#.#.#......#######.#..#.#
.........#.#...#.............#.#.........#.#...#...#.........#.#
.#.#.###.#.#.##.##.###..#.##.#..#..#####.#.#.###.#.#.#####.###.#
.#...#...#.#.#...#.#...#...#.#...#.#.....#...#.........#.#...#..
.#####.#.#.#.#.#...#.###.#.#.##..#.....#....##...#.###.#.##..#.#
.#.....#.#.#...#.#.#.#...#.......#...#.#.#.#...#.......#.....#.#
.#####.###.#.###.....#.#########.#.###.#..##.#######..####..##.#
.....#.....#.#...#.#.#.................#.#...#...#...#...#.#...#
...#.#.#.###.#.###.#.#.######.######.###.#...#.#.#.###.#.#.##...
.#.#.#...#...#.#.....#...#.....#...#...#.#.#...#.#.....#........
.#.#.##..#.###.####.####.#.#.#.#...#.###.#.####....#.##..###.#.#
...#...#.....#...#.....#.#.#...#.#.......#.......#.....#...#...#
####...#.#.#.###.#.......#.#.#.#.#####.#.##.##...#.###.#.#.#####
.......#...#.#...#.......#.#.#...#.....#.#.....#.......#.#.#...#
.##.#.###.##.#.###.###.#.###.#...#.#.#.#.###.###....##.#.#.#.#.#
.........#...#...#...#.#.......#.#.#.#.......#...#.#.#.#.#...#.#
#####.##.#.#.###.##....##.##.#...#.#.####..###.###.#.#.##.#..#.#
.........#.........#.#.........#.........#.......#.#.#.#...#.#.#
.#####.#######..##.#.#.##..#..##.#.#.......#######.#.#.#.#.#.#.#
.#.....#.....#.#...#...#.......#.........#.#.......#.#...#...#.#
.#.#####.###.#...#.###.###.#.###.###.#...#.#.#.####..#####.#.#.#
.#.#.........#...#...#...#.#.......#.#...#.#...#.......#.....#.#
.#.#.###..##...#####.#.#...#.#####.#.#####.#.#.#.##..#.#.###.#..
.#.....#.....#...#.....#...#...#.....#.....#.#.#.#.......#...#..
.#.###.#.####.#....##.####.###.#.#..##...###.#...#.#.####..##..#
...#...#.........#.......#.#...#.#.#...#.......#...#.....#...#.#
###..#.###.###.###.#####.#.#.###.###.#####.#...#...###.#.#.#...#
.........#.......#.....#...........#.....#.#.#.........#...#.#..
.###..##.#.#.###.#.##...##.#.#.###....##.#.#.###.#.#.###...#...#
.#.............#...#S#...#...#...#...#.#.#.#...#.........#.....#
.###..##.#.###.###.#.#.#.#.####....#.#.#.#.#..##.##..#...#####.#
...#.....#...#...#...#.#.........#.....#...#.....#.............#
.#.#..#####..###.#####...#####.#.#.#.###.##..#######.#####.#####
...#.......#.#...#...#.#.........#.#.#...#...#.....#...........#
.###.#.###.#.##..#.#...#.#...##.....#..###.###.##..##.##..##.#.#
.......#.#.#...#...#.#.#.#.......#.....#.#.......#.....#...#.#..
.####.##.#.###.#..##...#.#.###...#.###.#.##.####.####..#.#.###.#
...#...#.......#.#...#.#.#.....#.....................#.#.......#
.#.#...#.###.#####.#.#...##.##.####.##.########..#.#.#.########.
.#.#.#.......#.....#...#...#...........#.#.......#.#.#...#.....#
##.#.###.#.###.#########.#.#.#.#####.#.#.#.#.#.###.#.#...#.###.#
.......#.#...#...#.#.........#...........#...#.....#...#.....#..
.##..#.#.#######.#.#.###.##..#######.#.#.#.#..##.#####.#.####..#
.......#.........#.....#.....#.....#...#...#.............#.....#
.###...#....#.####.#######.#.#.###.#######.###.#.#.#####.#.#####
...#.......#.......#.......#...#.............#...#...#.#.#.....#
##.#...###.###.#####.#######.##..#...#####.###.##..#.#.#.#.###.#
.#.......#...#.#.............................#.#.............#.#
.#######.#.#.#.#.#.###.###.###.#####.###.###.#.#.###..######...#
...........#.#.#.#.#.....#...........#.....#...#...#...#...#.#.#
.###.#.#..#..###.#.#..##.###.#.#####....##.#.#####.#.#...#...#.#
.#.........#...#.#...#.#.....#.....#...#.........#...#.#.#.....#
.#..##.###.#.#.#.#.#.#.#####...##...####.#############.#...#....
...#.....#.....#...........#...#...#.......#.............#...#.#
#.##.###...#..##.######..#.#.#.#...######.....##.###.#.#####...#
...#.#.....#.#.....#.....#.....#.#.....#...#.#.....#.#.....#...#
.#.###.##....####..#.#.#.####.##.###.#.#...#.#..##...#######.#.#
.#.....#.....#...#.#.#.....#.........#...#...#.........#.....#G#
.#####.##.#..#...#.#...#.#.#...###.##..#####.#.###.##....###.#.#
.#...#.#...#...#.#.#.#...#.#.#.....#.....#.....#.#.......#......
.#.#.###...#####.###.###.#.#..####.#.###...##.##.#.#.......##.##
.........#...........#...........#.....#...........#.....#.....#
####..#####..######.#######.#.####..#####...###.######..###.####
