16
...............#
.#.#.....#.####.
.....#.......#S#
.#........##.#.#
.#...#..........
..##.#.#..#.#..#
...#.#.........#
...#.#.#...#....
.....#...#.#...#
.#.#.#...#..#..#
.#.....#...#....
.....#.#..##...#
......G#.......#
.#.#.#...#.###.#
.#.............#
##...#....#...##
