8
.#..G..#
.......#
.......#
.....#..
.#.....#
.#...#..
......S#
.#.##.##
