16
...#.........#.#
.#...#.#...#.#..
.....#...#......
.#.######.####.#
G..#...#...#...#
..##.#...#.##..#
.....#.#.#......
.#.###.#...#..#.
.#...#...#.#...#
.#.#.####..###..
.#.......#.#....
.##..#...#.#.###
...#...#...#S#.#
#..###...#.###.#
.......#.......#
.#..#.#.####.###
