16
.#.............#
.#.###..######.#
.#........S....#
.#.#.#..#.###.##
.....#.......#.#
..####.....#...#
.......#.......#
...####..#..##.#
.#.#.....#.#...#
.###.#####...#.#
...........#...#
######.#.#.#.#.#
.........#.....#
.#.######...##..
.#..G..........#
#..##..####.###.
