16
.....#......S#..
.#.....##.###...
................
.#.#...#..##....
.............#..
..#..#...#.#...#
...#.#..........
.......###.#...#
.........#.#...#
...#..#..#...#.#
.#....G#...#....
..#....##...#...
.............#.#
.#.#.##......#.#
................
###.#.#..###..##
