16
................
.#.#.#...#.#...#
................
.#..#.##...#...#
...........#....
.#.#.#####.....#
..G..........#..
.##..#......#..#
.........#...#..
.#...##....#.#..
.......#.......#
.##..#.#...###.#
................
.#.#.#..##.###.#
............S...
#...####....##..
