16
....G...........
...###..#...#.#.
...#.......#...#
.....#..#.......
...........#....
.##....#.....#.#
.........#...#..
.#..#..#.###.#.#
...#.....#.....#
.#...#.#...#.#..
...#...........#
##.#.#.#........
...#........S#.#
.#..#........#.#
.......#.......#
####..####.#.#..
