8
.....#.#
..#..#..
..S....#
..####.#
...#...#
...#.#..
.....#G#
#....##.
