32
...#............................
.#.#.##..#..###....#.#..#..#....
...#...#...........#.#.....#...#
...#.#.#..###...#..##...#.......
.......#.......#.........#.#...#
..##....##...#......#..#....##.#
.....#.....#..G#.............#..
...........#......#.##.#.......#
...#.#...#.#...#.....#.......#..
.#.#.........#.##..#......#..#..
...#...#...........#.....#...#..
##....#....##..##..#........##.#
.............#...#...........#.#
.#...#.###.#.###..#####.##...#.#
...........#.....#.........#...#
...#.#.#..............#..#.#...#
...#.#.#.......#...........#...#
.....#.#.#.##.#..#.##....#.##..#
.......#...............#........
...#...#.##....#.#.#.#....##...#
.......#.........#.............#
.#...##..#.#.#....#..##.#.##.#.#
.............#.......#...#......
.###.#.#.#...#.#.#.#.#...#.#.#..
.......#.....#...#.......#......
.###..#..#...#.#.##..#.#........
.#...............#.....#...#...#
....#..##..##..#.#.#...#.....#.#
...#.............#.#...#.....#..
.##..#.#.#...#..##...#...#.....#
.....#...........#......S......#
####..####.#..#..##.....#....##.
