8
...#...#
.#..##.#
.#S#...#
.###.#.#
.....#..
###.##.#
......G#
####.###
