8
.......#
###..##.
S.......
.#......
.#.....#
...#.#..
......G#
..####.#
