64
...............................#.............................#.#
..##...#.......#.###.##....###...#..#........#.#.......#...#...#
.....................#.#.....#...#.....#...#.......#.#..........
...#.....##.##..##........##.#...##.##.#...#...#.#....##...#....
.....................#.....#...#...........#.#.....#.#..........
..#...#.....#..##.....#.##.##.#..#.#.##...##....##...#.###.#.#..
.....#.......#...#.......#...#...#...........#.#...#............
..##...###.......#..#.##..#..###....##.###.....#.#.#.#..#.....##
.......#...#.#.............#...........#.........#...#.....#....
..#..#.#..#....###.....#...###.###.......#..##.#.....##..#.###.#
...#.......#.......#...#.........#.......#......................
.....#######...#.#..##.#.....#...#..#.......##...#..#.##.#.###.#
.#...............#.#...#.#.....#.........................#......
.#..##...####......#.##..#..#.#....#....##.#.....#...#.#.....#..
.#...........#.....#.#...........#...#...............#.....#....
.#.#..##.#....##........##.######....#..#.#.#........#.##..##..#
.#.......#.....#...#.....#.........#.#.........#...........#.#.#
.####.##...#.#.##..#.#.#.#..##.##.##........####.##....#...#....
...................#G..#.#.....#.....#.........................#
##.#.#.##.#.##...#...#.#.#.#.##....#.#.#....#...##...##.##....#.
...#.#...............#.....#.#...#.#.........#.....#.#.....#...#
...#...#.#.###.........#.##..#...#.....#...#...#.....#.....#...#
...#.#.#.......#.#.....#.....#.......#.#...................#.#..
.##.........##.##....#.......#.#.......#.##......###.#.#.#.#...#
.....................#...............#.#.#.....#...#.....#......
.#####.#..#....#...#.#.....#..###....#.....##..#.#.#.#..#...#..#
.......#...........#...#.....#.#.....#.............#.....#.....#
...##.##.#####...#..##.#....#..#.#...#..##.#####..#.##.#.....###
.............................#...#.........#.....#.....#.#......
.....###.#...#.#.#.#...#.....#.............#..#..#.#.#.....#.#..
...#...#.#.........#.#.....................#.#...#...#.....#....
...###....##..##.....#..##.#...#...##..#...#.......#...#.##....#
.....#...#...........................#.......#.......#.#.....#.#
.#.#...#....###..###.........#.#...#.##....#.###...#.....#.##..#
.......#.......................#.........#.#.#...#.#.....#......
....##.#.#...#...##..##..#......##.##.##..##.....#.##.#.##...#..
.........#.....#.........#.....#.............#...........#.#....
.#..###..#..#..###..##.#.#..#..#.##..#.#.###....#.....#..##..#.#
...#.............#...........#.........#.........#...#.#........
.#...##..##..###...#.#..#....####...###.#.##...#.#...#...####..#
...#.......#...#.#.........#...........#...................#.#.#
....##.#...##..#.#.....###.#.###..#....#.#....#.#..#..##.....#.#
.....#...#.......#.......#.#...#.........................#.....#
.###..#..##..#.#.#.#.#.#.....#..#..#.#..#....#.....##.##...#....
...............#...........#...#.....#.....#.#...#.......#...#..
......#....###.###.#..##.#...#...#.##..#...#..#..#...#..#####...
.#.......#...#.....#...........#.......#.#...#...#.............#
.....#.###...#.#....#..........##....#.#.##.##.#.#.#....#..#.#..
.#...#.......#.#...............................#...#.#.......#.#
.#.....#####.#....#..#.#.#.#.#.#.#..#...#....##...##.#.#.##..#.#
.......#.............................#.......................#..
.#...#####.#.###...#...###.#.#..#..#.#...###.#.#...##..#.#.#...#
.#.....................#.................#.................#...#
...#...#..#.##.#..####....##.#.#.#.##.####...#...#.###...##..#..
.#.#.................................#.....#...................#
...#.....#.#.#..#.###........#..###.##.##.#....#...#.#.###.##...
.....................#...........#.....#.......#............S#..
.#.#.#.#.##.....##.#.#......###..#..#..#.#.#.#.#.....###.....#.#
...............#.........................#.#...................#
.####....#.....###..###..#.....#......##..##...##.###..#.#.#.#.#
.#.......#.#.............#.............#...#.#.........#........
.#.......#.#.#.#.......#####.#.#.#..#..#......###..##......##..#
...............#...#...............................#...........#
###.##..#.##.#..##...#.#..##.###.##.##..#...#..#....#..###...##.
