64
...........#.......#...................#...........#............
.#.##.#.##...#.......#.#..#.##.#...#.#.#..#.##.#..#.......#.##.#
.................#...........................#.#...#.........#.#
.#..#......#...#.#...#.......#.....##....#.#.....#...#####.....#
...#.......#.....#.....#.......#...............#.........#......
.##...##.#....##.#...#.##...#..##.#...........##.##..#.#.#..#.##
.........#.........#.#.....#.........#...#.#.#.......#...#.....#
.###.#.#...#..#..###.#........####...#...#.#.#..#..#.##..##.##.#
.......#.#.....#.........#.#.......#.#.....#.#...............#.#
.......##..##.....#####..#.#.#...#.#.###.#...##..###...#.#.#...#
.#.......#.#...........#.............#...#.#...............#.#.#
..###.#..#.#..#..#.#.....#.#...#...#....#.....#.###..#..####...#
...........#...#.......#.#.#.....#...#.#...#.....#.............#
.#.#.#.#..#..#.#...#.#.#.....#.......#.#.#.#.#....#.....####.#..
.......#.....#.....#.#...#.#.........#.....#.#.#.....#.........#
.#.###......#....##....##...#..###.#...##..#.....#.#.#.#.#.###.#
.#.#S..#.............#...................................#.....#
.#......####.#...###.#...###...#....#.#...###..#...#..#..###...#
.........#.....#...........#.....#.....................#.......#
...####..#.#..##...#..####...#....#....#..#.#.######.#...#.#....
.......#...#.......#.....#.....#.....#...............#...#.....#
...#...##...######..####.##.##.....#...#...#.....##..#.#........
.#...............................#.....#.................#.#...#
...#...#.......#...#.#.##.#...###..#.......#.##.###..#.#.#.#..#.
...............#...........#...........#...#.....#.....#.......#
...##....###..#.#.#..#.###.###..#.....##.#.#..#....###.#.#.#....
.#.......................#...#.......#...........#..............
...##...#.##..##...#.#.#..#....#.#.#...#.#.............###.....#
.#.................#.....#...#...#.........................#.#..
.#...####.#....#...##.#..#.#.#.#...#.###.#.#..##.#.#.#.#.#...#..
.............#.............#.#...........#...#.......#...#.#....
..#..#..#..#......##..####.....#....#...#..##..####.#.##.#....##
.#...#.#...#...#.#...#...............#.................#.#......
.#.#........#...##.#.#.###.#...#.#.#..#..##......#.###.#..##...#
...#.............#.....#...#.#...#...............#...#..........
.###.#.##.#.......##.#.#.#...#.#...#...###.#.#...#.###.#...##..#
.....#.......#.#.....#.........#.....#...#.......#...#.....#.#..
.#.#...##.#..#.#....#...##........#.##.#.#......##...##.##.....#
.......#.#.............#.......#...#...........#................
.####.#..#.....#.#.##.#..#.......#....#..##..#.....#.....###.###
.#.........#.#.............#.....#...#.#...#...#......G.........
.#..####.#.##...####.###..#......#.###.#.#....#......###.#.#..#.
.#.......#.....#...#...#.......#...#.......#.......#.....#......
.#.#...###.#..#.##.###...#.#.#.#...#.######..#.#.......#.#.###..
.#.#...............#...#.......#.............#.......#.........#
.#.#...###.#.#.##......#...#.....####.......##.#.##.............
.............#.....#.........................#...........#.....#
#...#..#.#.#.####....#.#.#.#.#..#..#.#...#....#..#.......#...#.#
...#.....#.#...........#...#.#.........#...#.......#.....#.#...#
...#.#.#....##.##..#...#.....#.#..#....#.......##..#.#.##.#..#.#
.....#...#.......#...#...............#.#.#.............#...#....
...#..##.#.#...#.#...#.####..#.....###......#......#........##..
.......#.#...#...#.......#.....#...#...........#...........#...#
#..#.#...#.#.#.....#..##...#.........#####.#.##.##...##..#.#.###
...#.#...#.....#.........#.#.............#.........#.#.....#...#
.#.........###.#...#.#.###.....#..#.#.##.#.###.#..#..#.#.#..#..#
...#.#...#.......#...........#.....................#...#.......#
##.......#...#...#.##..#...#.#...#..#....#..##.#.#.#.#..##..#..#
...#.......#...#.........#...............#...#...............#..
..###..#.#..#.#..#.#..#...#.#..###.#..#..#............###..#....
.............#...#.#.......................#.......#.....#......
.##.....##.#...###.#.#.....###.##.#..#..#.....#..#...#.#.#...#..
.............#.....................................#.#.........#
##...#.#..#......#.#.##.#.#...##.##...######.#.......####..#..##
