32
...#...................#.......#
.#...##.##.#..###.....#..#......
.#.......#.........#.........#.#
...#...##...##.##..#.#..####....
.....#...................#.....#
.......#.#.......#.#..#.........
............S#...#...#.....#...#
.#.#.#....#..#.#..#....##......#
.............#..................
...#.####....###...#..#.....#..#
.................#.....#.......#
.#....##.#.#.#.#.#.#...#.#......
.#.....#.#...#.....#...#...#...#
#..#.##..###....##.#........##..
.............#...#.#.....#.#....
.#.#.#.......#.###.#.##..#.....#
.#...#.....#.#...#.........#....
.#####.....#......###...#....#.#
...........#...#.....#.#.#.#....
##.#.##.##.......##......#...#.#
...................#.#...#...#..
...##..###...#.#.#.#......#.....
.............#.......#.#........
.##.###.####...#.##...##.#.###.#
...............#.#...#...#...#.#
.#.##..##........#.#.#.....##..#
G#.....#...#...........#.......#
..####.#.###.#.#..##.........###
.........................#......
.....#.#.#..###....#.#.#.#......
...................#............
##...###..###....##..#..##.#.#..
