32
...................#...........#
..#.#...##.#...###..............
.....#.....#...#...............#
.#.#....##..#.....#.#..##..#...#
...#.....................#.....#
..###..#...#.#####...###.#.#..#.
.....#.............#.....#.#...#
..#..#.#...#.#.#.#####.##....#.#
.......#.....#.............#..G#
.#....###......#.#.#####.#.##..#
.............#.....#.#..........
.#...#.........#.#.......#....##
...............#...#...#...#...#
.....#.#...#####.#..###..#.##...
.................#.....#...#.#..
....#.....##...#.##..#..#.......
.#.#...#.....#.#.#...#.........#
##...#..####.....#.#.#.##.#.....
...#.......#.#.........#.......#
.#.....#...#.#..#.##......##...#
.......#.#...............#...#..
...##.....##.#.#...#.#.###.....#
.#...#.#...#....................
#..#....#.....##.#.......###....
...#....S#.#.............#......
.#.....#.#..##..##...###..#.##..
.......#.#...................#..
.#.##..#...#.#...#..#.#.###.....
.......#...#.#...#.#.......#...#
.....#####.#....####.#...#.....#
.........................#......
.##..#.#.#.#...##.######.#.#.###
