16
...............#
...#.#.#####...#
.....#........G.
.#...#..........
.#...#..........
...#.#..#..###.#
...#.....#......
####..#....#.###
.....#...#.#...#
.#..##..##..##..
....S#.#.....#..
#.###.....###...
.............#.#
.#.#.#...#......
...........#...#
..###..####.##.#
