8
........
.#.#.#..
....S#.#
...#...#
...#...#
#..##...
G......#
.#....##
