64
...#.......#...#.....................#.............#...#.....#.#
.#.#.###.#...#.#..##.#.##.###..#.#.#.###.#.####....#.#.###...#.#
...#.#.#.........#.........#...#...#.....#.#.....#...#.....#.#..
.#.#.#.######.##.#.###.#.......##..#.#.#.###.#.#.#.##...####.#.#
.#.#.#.......#.....#.......#.#...#.#...#.#...#.#...#...#.....#..
.###.#.....###.#.###.#####...##..#.#####.#..##..##.#...#...#.#.#
.......#...#...#.#...#.#...#.....#.#...#.....#...#.....#.......#
.#.####..#...#.#...#.#...#.#.#.##..#.#.###.#...#.###...#..####.#
.#.......#.#.#.#...#...#.....#...#.......#...#.#...#.#.....#.#.#
..###..#.##..###.###.#.#####.###.#.#.#.#.#.#.#####.#.#####.#.#.#
.....#.#...#...#.#...#.....#.#...#...#...#.#...#...#...#...#...#
..##.#.###.#...#.#.###..####..##.#.#.#####.###.....####..#...###
...#.......#...#.#.#.#...#...#........S#...#...#...#...#.#.....#
.#.#.#.###.#...#...#.###.#.#.#....####.#.###.###.##..#.#.#..##..
.#.....#...#.....#...#...#.....#.....#...#.#.#...#...#...#...#.#
.###.##..#########...#.#.#####.....#######.#.###.#.###.......#.#
...#.#...............#.#...................#...#.....#.#...#...#
##.#.#.##..#####..##.#.#####.###.###.#.###.###.#.#####.#.#####.#
...#...#.#...#...#.....#...#.........#.#...#.......#...#.......#
.####..#.#.#.#..##.#####.#.####..#...#.#.#.#.##.#.##....###.##.#
.#.............#...#.....#.#.....#...#...#...........#.......#.#
.#.#..###.######.#...####..#.####.#####.##.###.#.#.###..####.#.#
.#...#.....#.....#.#.#.....#...#.........#.#.#.#.......#...#...#
.###.###.#.#.####.##...#.#.###.#...#.#.#.#.#.#.#.#.#.###.##..#.#
...........#.........#.#.#.......#...#.....#.#...#...#.......#..
...###.#.#.#.#####...###.###.#.#.###.#.#.#.#.#####.#.###...#...#
.#.....#.#.#.................#.#...#.........#.......#...#.#....
.###..#..#.#.##..#.#####.###.#.#.#..##########.#.#.###.###.##.##
...#...#.#.#.#...#...#.#.#.....#.#...#...#.....#...#.........#.#
##..#..#.#...###.###.#...#.#.###.#...#.#.#.####....#.###..##.#.#
.#.#...#.......#...#.#...#.#.....#.#...#.#.....#...#.......#...#
.#..#..#####.#.#.#.....###.###.#.#..###..###.#.###.#.#.##..#.#.#
.....#...........#.....#.#.........#.........#.....#.......#...#
..#..######...######...#.#########.#....###..#.#####.#..##.#.#.#
...#...#.............#.....#.....#.#...#.....#.......#.#...#...#
.#.###.###..##.######.##.#.#.###.#.#.#.#.#.#.#.#.#####.###..#..#
.....#.#.....#.............#.#.#.#...#.............#.....#...#.#
.#.#...#.###.#.#######.#.#.#.#...####.#..#.#.#.##....###.###.#.#
...#.#.#...#.....#.......#.#.#.#.........#.....#.#.........#....
.#.###.#.....###...#####.#...#.###.###########.#.#.#.#.###.#.##.
.......#...#...#...#...#.#.................#...#.....#...#.#...#
.#.#######.#.#####.#.#....##.#######.#...##..###.#####......####
.#...#.............#.#.#...#.........#.....#.........#.#.#.....#
.#.#.#.#..##.###...#.#.##....#####.#.#...#.#.#.#####.#.#.#####.#
.#.#...#...#.........#.#...#.........#...#.............#.#.....#
.#.####..###.#.#.#..#..#...#.#.#######.#.###.##.##.#.#####.###.#
...#...#.#...#.#.#.#.#...#...#.#...#.............#.#.#.....#...#
####.#...#..##.#.#....####.#####.#.###.#####.#.##..#.#.######..#
.....#...#.....#.#.....#.....#...#.....#...#...#...#.#.#.......#
.#.#..#######..#...#.....###.#..####..#..#..#....#####.#.##..#.#
...#.#.....#...#...#.....#...#.#...#...#.......#.....#.#...#...#
.....#.###.#.##..###..###..###...#.#.#...#####...#.#.#..##.###..
.#...........#.....#.#...#...........#.#.#.......#...#.......#..
.##......####..#.#.#.#.#.#######.#####.#.#.##.#..#.###..##.###.#
...#.#...#.......#.#...#...#...........#.....#.....#...#...#...#
.#.#.#.#...#.#.#.#..######.......###.###..##.#.####..###.#.#.#..
.......#.#.....#.#...........#...............#.............#...#
.##.##.#.#.####..#.#..########.########.####.##..#########..##.#
.....#.#.......#.#...#.....#...#.....#...................#...#..
.###.#.#.####..#.#.###...###..#....###..###.#####.##.###.#.#.#.#
...#.#.#.#.....#.#...#.....#...#.#...#...........#.....#..G#...#
##.#.#..##.#...#..##.#.###.#.#.#...#.#.#.####.#....###.#.###.#..
...#.......#.......#.....#...........#.........#.....#.........#
####.#.#.###.##.#####..###..##.#..#.#############.######..######
