64
...............#.......#.....#.....................#...#........
.#.#.#.###.###...#.##..#.#.#.###.##.#######.######...#.#.#.#####
G#...#...#...#.#...#.#...#...........#.....#.....#...#.#...#....
.#....##.###.#.###.#.#.#.#.#######.#.#.#.###.###.##.##.#.#.#.#..
.#.#...#...........#.#...#...........#.......#.#.....#.#.......#
.#.#####.#.#.#..####.#.#.###########..#####..#.#.....#.######..#
.#.#.......#.......#...............#.......#...#.#.#...#........
.#.#.#..##.#.#.##..#.####.##.######.####.#.#.#.#...####..#####.#
.#...#.......#.#...........#...................#.#.#.........#.#
.####.######.#...#..#..#.#.#.#..############.##..#...##.##.#.#..
.......#.........#...#.#.#.....#...............#.#...#...#.#....
.#####...#####.#.####..#.#.###.#.##.####.#####.#..######.#..##..
.....#...#...#.#.#...#.#.......#...#.......#.............#...#.#
.###.###.#.#.#.#.#.#.#.#.#.###.#.#.#.###.#.#..###.##.###.##..#.#
...#.....#.#.#.#...#...#.#...#...#...#.......#...#...#.....#....
.#.###.###.#.#.######..#####.#...#.#########.#.#.#.##....###.#.#
.#.#.#.....#...#...........#.#...#.#.....#.#...#...#...#.......#
.#.#.#.##.########.#.#.###.#..#....#.#...#.#....##...#######.###
.#...#.........#.......#.....#...#.......#.........#.......#...#
.#.#.#.#.#.###.#.##.#.##########.##.##.....##.####...#.#.#...#..
.#.#...#.#.#.#.#...............#.#...#...#.#.......#.#.#.#...#.#
.#.#.####..#.#..########...###..##.#.##..##....#..#..#.#.#.####.
.#.#.......#.#.....#...#.....#...#.#...#.#.....#.#...#.#.......#
.#.#####.###.#.#.#.#.#.#.#######.#.##..#.#.###.#.#.####.#.#.##.#
.#...#.......#...#...#.#.#...........#...#...#...#.........#...#
.###..##.#.#..#####.##.##..#####.#....###.##.#.#...#.#####.#..##
...#...#.#.#.......#...#...#.......#.#.......#...#.#.......#...#
...###.#.#.###.###.#..##..##.#.#####.#.#.#.###.#.#.###.....##..#
.#...#...#...#.......#...#.#.......#...#...#...........#...#...#
.#.#.#.#.##..###..#####....#.#####..###.####..#..####.##.#.#.#.#
...#.#.#.........#.......#.#.#...#.....#.....#...#.#S....#...#.#
.#.#...###.##.#..#.###.#.#.#.#.......###.###....#..##..#.#####..
.#...#.#...#...#...#.#.....#...#.#.#.....#.......#.#.....#.....#
.###.#.#.###.#.####....##..#.#.#.###....###..###.#.#..###..##.##
.....#.#.#.....#.....#.#.#.#...#...#.#.....#...#...#.#...#......
.##..#.##..##..####..#.#.#.#.####..#.#..#..#####.#.#.#..##.#.#.#
.#.........#.#.....#.#...#...#.......#...#.....#...#.#...#.#...#
...####..###.#####.#.#.#.#.#.#.#.##.##.#...#...#..##.#.#.#.###.#
.#.......#.....#.#.#...#.......#.....#.#...#.#.#.#.#.#.#...#...#
..###.##.###.#.#.#.####..##.#####..#...###.#.#.#...#.#####.#.###
...#.......#.#...#.......#.......#.#...#...#.#...#.#.....#.#...#
##.###..#..#.#.#.##.######..##.#.#.##....###.#####.#####.#...#.#
.......#...#.............#.#...#.#.......#...#.......#.....#.#.#
..#.#....#.##..#.##..#.#.#.#..##.#####..####...#####.#.#.#..##.#
.......#.#.....#...#.#.#...#...#.#...#.#...#...#...#...#.#.....#
.######..###.##..#.###..##.#.#.#.....#......###..#.#####...#.#.#
.#.......#...#...#.......#.....#.......#.#...#...#.......#.#.#.#
...#####.#.#####...#####.#.#.########.##.###.#.#####.#..##.#....
.#.#.....................#...............#.........#...........#
.#.#.###.###.#.###.#...###.#########.#...#..#####...##...##..#..
.#.#.#.......#...........#.......#.....#.#.......#...........#.#
.#.#.#.###.###.#######.#.#.#.###.#...#.####.###..#####.#####.#.#
.#...#...........#.........#...#...#.#...........#.......#...#.#
.###.#.##....#.#.#.###.##.####.#####..##########.#####...#.###..
.#.....#...#...#...#.#...#...#...#...#.........#.......#.#.#...#
.#.###.#.###.#.#.#.#.#.#.#.#.###...###.###.#############.#.###.#
.#...#.#.......#...#.#.#.........#...#.#.#...#.....#.....#.....#
.###.#.#.#########.#.#.####..#####.#.#.#.##....#.###.##.####....
.#...#.#.#.#...#.....#.#.....#...#.#...#...#...#.#...#.#.....#.#
.#.###.#.#.#.#...##..#.#.#####.#.#...#.#.....###...###.#.##..#.#
.#.....#.#...#.....#...#.#.....#...#...........#.......#.....#.#
...#.###.###########.###...#######.##.#.##########.#.###.#..##.#
.....................#...#...............................#.....#
##.###########.##..##.######...###.###.#.###.#########.###.#####
