16
..............G#
..##...##....#..
...#.#.........#
...#.#.#.#.....#
.........#...#.#
..#..##....#.#..
S......#.......#
.###.....##..#..
.............#..
...##..###.#.#.#
.........#...#.#
..##..##....#..#
.....#..........
.#.#...###..##.#
...........#...#
###.#.#...#.###.
