16
...#..G....#...#
.#.#.#.###..##..
.....#..........
.#######...#.#..
.......#.......#
.#.###.#.##.....
.#.....#...#...#
..#..#.#.#....#.
.....#.#.#.....#
...###.#.....#.#
.#...#...#......
.#.......#.#####
.#...#.....#..S#
.#.....#......##
...#............
..#####..#.##.##
