32
.......#.................#..G...
.#.#.....#..##.###.#...#......##
.....#.....#.....#.........#....
.....##..#.#.....#####.....###..
...........#.........#...#...#.#
...#.#...##.........##.....#....
...............#...#...#.#.....#
.##.#...##.#.#.#.#.#.#......#...
.#.....#.....#.......#...#...#.#
#.....#...#..#.##....#.....#.#.#
...........#.......#.#.#........
.###...#.#.......#.#.#..##.#.##.
.#...#.....#.....#..............
..#....###.#.##...##.....#.##...
.........#...#.......#.........#
...#.###......#..#.......##..#..
...#S#.......#.......#.......#..
.........#..#..#.#..#.....##...#
.....#.........#.#.........#...#
..#..#.#..#.##.#....###..#.#.##.
...#...#.......................#
#..####........#..........##....
.................#.#.#..........
.###.......####.........#....#.#
.......#.....................#.#
.########..########..#...#.#.#..
.................#.....#...#.#.#
#.##.#.#.#.....#.#........##...#
...#...#.......#................
.#######...##..###.#..##.....#.#
.........#.....................#
#.##..#..##.##...#.##.##########
