32
...............................#
.###..#.#.###..##.......##.#...#
...#.#S..................#...#.#
#..#.##.##..#.##..#..##........#
...#...................#.....#..
.#...#...#.#...........##.#....#
...........#.#.................#
#.#....#...#..##.##.#......#.#.#
.#...#.......#...........#...#..
.#...#.#...#...#.#.#.#.#.##..#.#
.......#...#...#.#...#.#.....#..
.##.####.....#.#.....#...#.....#
.....................#.....#....
.###.####....#..#.###..#.#.....#
.....#...#.#.#..................
###.#.........#.##.#...##....#.#
.........#...#...........#......
.#.##...#..#..##.#.............#
.............#.........#.....#.#
....#..#............#...#.#..#.#
.....#.......#.#................
.....#.........#.##..##..#..#...
...#...#.......#.#..............
.#..#.#.#..##....#....#.##.#.#.#
.................#.#.........#.#
.##.#........#.#.........#..##.#
.............#..................
.#..####.#..##.#.###....####.#.#
.......#...#.............#.....#
.#.....#.#.......#...#.#...#....
.........#..........G..........#
#.#...#.#..#..###.#...#.###.#.#.
