64
...#.....................#.......#...................#...#.....#
.#..####...####.######.###..##.....#.#...#####.#.#.#.#...#.#...#
.#.........#...#.......#...#.....#.#.#.#.....#.....#...#.....#.#
..##.....#.#.#.#.##..#.#..##...##....#.#.#.#..###..##.#.##...#.#
...........#.....#.......#...#.....#.......#.......#.......#....
.#...#.###.#.#..##.#...#...#..####..#.##.#.##.#..#....##.#..##.#
.#.#.......................#.....#.....#.#.#.....#.....#.......#
.#.#.###.###.#.##....##.#...#..#...#...#.#.#..#..#.#...###.#.#..
...#.#.......#.#...#.....#...#...#...#.#.#.#.....#...........#.#
##.#.#.#.###...#.##...##..#..#...#.....#.#.###.######.#.....##..
...#.#.......#.....#.......#...#.....#...#.....#...#.........#..
..#####.####.#.###.#.#.#...#.....#.#.#.#..##.#.#.#.#.#######....
.....................#.............#.........#...#.#............
.####...######.....#.#.#.########..######.##..###...##.#.#.###.#
...#.........#...#.......#...#.....#.............#...#...#.....#
##...#######...######.##.#.#.#.####..#.#.#...#.#.###.##.##...#.#
.....#.....#...#.......#.....#.....#.......#...#...#.......#....
..####.##..#.#.#.##..#.#.#...###.#.#.###.##.##.###.##..#...#.#..
.#.........#.....#.#...#.......#.#.#.....#.................#...#
.#.#.###.#####..#..#.##..#####.#...#####.#...#..###....#.#.#.#..
.#.................#...#.....#...#...#...#.#.....#.#.#.....#.#.#
.##..###...#.#.##..###.#.###.#.#.###.#.###.##..#.#.#...#..#..#.#
.........#...#.........#...........#.....#.....#.#.....#...#....
.#.#.#.###...#..#.#####.##.###...#...###.##..#.#.#..#.#..#.##..#
.......#...#.#.#...#.........#...#.....#...........#.....#.....#
.#.##.##...###.#..#..#.###...#.#.#.###.#.###.##..#...##.#...##.#
.#.#.....#.....#.#...#...........#.....#.........#...........#..
.#.#.#####.#.#.....####...####.#.##..#.###..##.##.#######..#...#
.#...#...#G#...#...#.....#.....#.....#.#...#.#.......#.#.....#..
##.#...#.#..#..##.##..#..#.#.#.#.#.#.###.#.#.####..#...#.#..##..
...#...#...#.........#.....#.#.....#.........#...#.....#.......#
.##...#....##...##..#....#.###..##.#.#####.....#....##.#######.#
.#.....#.....#.#...............#...........#.#...........#...#.#
..####.##......#.##..#....##.##...##.#.#.###.#.#.#...#.##..#...#
...#.............#.......#.......#.#...#...#.#...#.#.#.....#...#
...###.#.#.###.##.....##.#.#######...#.###...###...#.#..####.###
.....#.#.#...#.....#...#.#...#.......#.........#.#.........#...#
.###.##..#.#.###.##..#.#.#...####..###.#.#.#.#.#.#..#..###.##.##
...#.#.....#.....#...#.....#.............#.#.#.....#.....#.....#
##.#...#######.#.#.#######..###..###..##.#.#..##.#....#####.##.#
...#...#.......#...#.....#.....#...........#...#.#...#.........#
.#.#.#.#.#####....##..#..#.#.#.##..#.#...#.#..##.###.#.#.#...#.#
...#.....#...............#.........#.#.#...#...#.#.....#.......#
..#..##..#.####.##.##...##.###.###.#.#...#..##.#...###.#...#.###
.#...#.......#...........#.........#.#...#...#.....#...#.#...#.#
.#.#####.#####..###..###.......#.#.#.##..##....###.#.#...###.#.#
...........#.......#...........#.............#.#.#.#...#.......#
..#.#..#.#.#.###..#..#.#.###..###.#.#..#.##..#.#.#.#.#.#.....#..
.....#...............#.....#.....#...#.#.....#...#.#.........#..
.###...#######.#..##..#..#.#.##..#.#.#.#.#.####....#..##.#..##.#
...#...#...#.....#.......#...#.......#.#.#.......#.....#........
.#.##..#.#..##.###.#.#.#..####.####..###..#.#....#####.##..###..
.......#.....#.....#.....#.........#.#...#.....#.......#.....#..
.##.##.#.###.#.#..##.#.#.#.###.#.##....###..#..#.#.#.#.#.#...#.#
.........#.........#...#.#.#...#.....#.......#.#...#...#.#.#.#.#
.#.#.#.###.....###.###.#...##..######..#####.....#...###.#.#.#.#
.#.#.#.....#...#.......#.#.............#.............#S..#...#..
...#.##.##.##..#.###..#..####..#.#.#.#.#..#####....#.####..##.#.
.#.#.........#.#.#.........#...#.#.............#...............#
....#######..#...#...#.###.#.######..#...##..#.#.###.###.#####.#
.#.......#.......#.#.#.....#...#.........#...#.......#...#...#..
.#.#.###.#.###.#.#.#.#...#.###...#.....#...#.#..##.....###...#..
.....#.....#.....................#...#.....#.......#.#.........#
######.#.##..##..######..#.#.##.#.######.#.#####..##..##.####.##
