32
...........#.......#.....#.....#
.#.#..##.#.#.#.#...#.###.###.#.#
.#...#...#...#.#.............#.#
.####.#...#.#..#######.###.#.#.#
.#G....#.......#.....#.....#...#
.#.#...##.##..##.##...##..###.#.
.#.#.#...#...#...#.#............
.#.#.##....#.#.###.##########...
.#...#...#...#.#...#.........#.#
.#...#.#...###...#..##.##..#.#..
...#...#.#.#.........#.#...#...#
.###...#...#.###.#.#.#.#####.#.#
.#...#.#.#.......#...#.#...#...#
...#.#.#.##.###.##.#.#.#.#.#.#..
...#...#.....................#.#
.######...###########.##.##.#.##
.............#.........#.......#
###.##.###.#.#.###.#.#.#.###.#.#
...........#.#.#...#...#...#.#..
.###.##.#.##.#.#.##....###.#.#.#
.....#.........#.#...#S......#.#
.##..#.#######.#...#.##.##.#.#..
.......#...#...#.#.#...#...#.#.#
..#.####...#.#.#.###...#.#..##.#
.#.......#.#.#.#.....#...#.....#
.####.##.#...#.############.####
.#.....#.........#.............#
.#..#...######...#####.#######.#
...#...........#...#...#.......#
####..##..########...#...#.###.#
.........#...........#..........
############.#.####..########.##
