8
........
.#.#...#
.#....G#
..#..#.#
........
.###....
..S....#
..#.###.
