32
..G....#.......#.......#.......#
.....#.#.###......#..#...###....
.....#.......#...#.........#....
..##.#.##.##.##..#.###..........
...#.........#.....#.......#....
.........##..#...#.#..#....#...#
.....#.........#.........#.#...#
#.......##.#.#..#.##.#..#...##..
.....#.......#.....#...#.#......
..#......###.#.#...#.###...#....
.....#.......#...........#.#.#.#
.........#.....#...#.#.#........
...#...#.#.#.#.#................
.###.....#.#......######..#..#..
.....#...............#...#...#..
....#.....##...####..#.#.#.##...
.....#.#.........#.....#.....#..
.....#...#...#..##...#...##.#..#
...#.#...........#..............
##...#.##....###...#.....#......
...........#.....#...........#S#
.###..##.#..##.#.#..#..#..#..#..
.........#.........#...#.#.....#
.#...###...#.#........#..#.##..#
...................#.....#.#...#
.#.....#....##.....#........##.#
.......#.......#...#.....#......
.#.#.#.#.........##.......#..#.#
...............#.....#.......#..
.....#.#..#.#..##..##.#..#.#...#
.#.....#........................
.#.##.###.##.#...##..##...####..
