64
...#.....................#..............G..#....................
.#...#.#...###...#..##...#.#.#...###.##.#.......###..#####.###..
.#.......#...#.#.......#...#.#.#...#.........#.....#.....#.....#
.##.#....##..#...##..#.#...........##..##....#..##..#..#.....#.#
...#...#...#.#.#.......#.........#...#...#.......#.......#.#....
...#...#..##...#.....#...#...###.##..#.##......#...#...#...##...
.....#...................................#.#.......#...#........
..#...#....#.#...##..#...#....##.##...........##.....#.#.#.#.#..
.#...#.........#.........#...................#.................#
.#.....#.....##..#..#..#.#.#...#.........##.....#.###....#..#..#
.........#.#.......#.....#.....#...#.#.................#........
.###...#.#......####.#...#.##...##...###.#.###.#.#.##...####....
.....#.....#...........#...........#.....#.......#...#.........#
.....#.#...........#...#.#..........##.###.#....####..##.#.#.#..
.....#.#.....#...........#.......#.........#.#..................
.###.#.#..#...#....#.###.##.....#..#.#.#..##.#....#..#.#.##..#..
...#.......#...........................#.....#.....#.#.#........
.#...##........#.#.#.#.#...#.......#.##.#..#.#...#.#.......###.#
.#.........#...............#.....#.............#.#.............#
...#.#.....#.###..###.##..##.##....##.##.#.#.#.#...#.####......#
.....#...#.#...#.#...#.....#.....#.#.....#...#.....#...........#
.#...##......#.....#.........#.#.###.#.#.#..#.####.#..##...#.#.#
...#.....#.#.#.#.#...#.....#...#...................#...........#
#....#...#...#.###.#...#.#.#...#....#.###.##...#.....#...#..##..
.............#.....#...#.#.............#.....#.......#...#.#....
..##...#..#..##..#...##..#.###.######....###...#...#####.#.##...
.....#.....#...............#.......#.....#...#...........#.....#
...#...##..#..##...#.#.#.#.##.........##...#.##.#..##..###...#.#
.#.#...#...........#...........#...#...............#............
.#.#.###.#.#.#..##.#.#.#.###.#...#...#.#.##.#..###.#...#...#....
.....#...#.................#.....#.#.....#.........#...........#
.#.........##..#..#....#.#..####...#...#.#.#.#####.##.#.#.#..#..
.......#...#.......#.....#.....#.....#.......#.#.....#.......#..
...###....#..#...###....#..#.#...#####..##.#.#.#.#.##..#.#.#...#
...#.........#.#...........#...#.....#.....#.#.........#.......#
...#....##.#.....#.#.....#...##....#.#..#....##..#.####..#.#.#..
.........#...............#.......#.#...#...#...#.........#.....#
.#...###.......#...##.#....#.....#..#.....###..#.#.#.#.......##.
...#.....#.....#...#.......#.#.........#...#...#...#.#...#.....#
...#.....#.#..##.###.#.....#.##...#.##..##...#.....##..#.#...#.#
...#.....#.#...............#...#.....#.#.#.#.#.....#...#...#.#..
.#.#...###...#.###..####.#..#........#.#...#.##.#........##....#
.............#...........#...#...#.................#.......#...#
.#...#..####..#.#..#.#.#....##...#.#.#...#.#..#......#.#.#....#.
.......#.....#.....#.#...#.#.....#..............................
##.###.#.......#.#...#.#.#.#..#....###.###.....##.#..#...#..#.#.
.#.#.....#...#...............#.#.#.......#.......#..............
.#......##..##...#..##.#.#...#.#...##..#....##...#..####.#.#.#..
...#...........................#.............#...............#..
.####.....#.##...#..####...###.....##.##.###.......##..#####....
.......#.....#...#.........#...#.#.........#...#.......#........
.#.###.#...#...#.##..#.###.#.#...#.......#..#..##..#.#...#...#.#
.....................#...#.#.....#...........#...#.#...........#
.##..##..#....####.....#...#...###..##...#....#......#..#....#.#
.....#.......#.......#.#...#...........#.#......................
..##....#..#.#.#.#.#.#...#.##.....#...#......#.#.#.#......#...#.
.................#...#.......#.....#.................#.......#..
.#####.#...#.#.#...#...##.##.#...#.......#.#.#.....#....#......#
.........#.#.......#...#.......#.....#...#......................
..#...#.........##.#...#.#.###.##.....#..#...#.#....#..#..##....
.......#.#.........#.#.#.#.#...#...#.#...................#...#.#
##...#.#..###...###..###.#.#.#.#...###..#...#..##.....#..#.#.#.#
..........................S#.....#.....#.......................#
##..###.#..#...##........#......#..###...#.#....#..#.#.###.#.#..
