8
......G#
.#.####.
.#......
.#..##..
.#S.....
..##....
...#...#
#.######
