64
.....#.................#...#...................#...............#
.###.#.#.#.##..##.##...#...#.#.#.#..#..#.....#.##..#.#.....#.#.#
.#...................#...#.....#.#...........#.......#.#...#...#
...##.#..#..###.....#..#..##.#....#.#......#.#.#...#.......##..#
.....#.#...#.....#.........#.....#.......#.....#...#.....#......
...#.#..##.....#.#....##...#...#.#.#.##..#..##..##.#...#.#####.#
...#.#.....#.......................#...........#.......#.....#.#
.#.#.#........#...#.#.#..#.##..#.#.....#....#..#.#.....#.#.#.#.#
.......................#.......#...........#.........#.........#
.#######...##.....##.#..####..##...##..#...#...#.....#.#...###.#
.............#.......#.......#.....#.........#.#.......#.....#..
...##.##.##...#......##.##...#...#.#..###..#.......###...###.#.#
.#.........#.#...........#...#.#.......................#........
...#...#.....#.........#....##.#.####.##.#....##.......#....##.#
.#.#...#...#.#.#.....#...#...............#.............#........
.#.#..##..#....#.#.#............#..#.####....#.#.#.....#...#...#
.#.......#...#.#.#.....#.....#.......#...#.........#.#.....#.#.#
.#.#.###...#.#.....#.#...#.....#...#.###..#.##.......#....#.....
.#.....#.#...................#.#...#...............#.#.#...#.#..
.....###.......#.#.#.#.#.#.#....##.....##....#.##......#.#.#...#
...#...#........S#.#.....#.#.........#.....#.......#.#..........
...#...#...#.#...#.....#.#..##.#..#....##.##..#....#.##.##.#...#
.....#.....#...#.#...............#...#.....#...#.#.#...#...#....
..#..##....#.....#..####.#...#.#.....#.#.#.#.#.........##.##.#..
...#.#...#...#...#.#.................#.#...#...#.....#..........
.......#####.......###.#.###.#.#...#.....#...#....##..#.##.###.#
.....#.....................#...#.....#.#.....#...............#..
...#..#..#......####.##.##..#...#..#.#...#..#.#.......#.........
.................................................#.........#.#.#
..#..##.##.#.##.#....##..#...#.###...#.##.....#.....##..#..##...
.....................#...#...#.................#.....#.#.#.....#
..#.##.###..##...#...#.#.####..#...#.###...#...#..#..#.......#.#
...........#.....#.#...........#.......#.......#...............#
.#.#..##.........#.....##....#...#.#...#.....#...#...#......#..#
.#.#.....#.........#.........................#.#...#...........#
....#.##.#.###...#.....##......###.####.####.#.#...#.#...#.#....
.........................#.#.#.........#.....#...#.....#...#....
.#..##..#.##..#.#....##..#...#...#...#.....###.#.#..##....#..#..
...#.#.....................#.................#...#..............
####.#..##.#....##.#.#..#..#..#.....#..##..#.#.#.......##....#..
.#...........#.........#.....................#.......#.........#
.#.....#.#...........###...#...#.#...##.....#.....#....#.#.###..
...#.#...........#.........#...................#...#.....#.....#
...#.#...#...#.#...###.#.....###.#.#.....#.##...#..#####.#.....#
.....#...#.#.......#.................#...#.....#................
#...###....#.#.....#...#.#.#.##.###..###..##.#...####.######....
...........#...#...........#.................#.....#.........#..
.#.###.#....##.#...#.#..#......#..........#..#.....#..###.####..
.............#.......#.#.#.#.....#.....#.......#...#...........#
...#.....#.#.#.#..##.#.#.#...#...####...##.........#.#.##....##.
.........#.....#.#.....#.......#.....#.....#.........#.........#
.....###.....###...#..##.###...###..#..#.#.#####.#.#.##...##.#..
...#.............#...#.......#...........#...#...#.#.#...#.....#
.#.##.....##...#..#..#.#.#.###.#....#..#.##........#...#....#...
...............#...#.....#.................#.........#.....#.#..
.#....#..#.###.#......#...#..#.#.....#..##.##.##..#..###..#..#..
...#.#.....#.#.#.....#.......#.......#.......#...............#..
...#...#...#.....#.#.#...###...#####.#.#.......#..#..#...#..##..
.#.........#...................#.....#.........#...#.....#.....#
.#...###.#...#..#..........##.##...#..#......#.#.#.#..##.#....#.
.............#.....#.............#...............#.#...#.......#
.#..#.#.###...###..#.#...#.#.#.#.#...###..#....#.#.....#.##.....
...............................#.....#..........G#..............
.##...#.####...####..##.....#.....####..#.###.#.#...#.#....##...
