64
...#...................#.....#.....#G............#.........#...#
.#.#...#####.##....###.#..##.....#.#.###.#.##.##.##..#####.#.#.#
.....#.....#...#.....#.#...#...#.#.#.#...#.....#.....#...#.....#
.#####.#.#.###.#...#.#.###..####.#.###.#####.#.###.##..#.#####.#
.#.....#.#...#...#...#...#...#...#...........#...#.#...#.......#
.#.##.#..##..#.#.###.###.#.#.#.#####.#####.#####.#.#.#.#.#.###.#
...#.....#.........#.#...#.#.#...#...............#...#.#...#.#.#
#..#..##.#.#.#..#..###.##..#..#..#.###.#####..###..#.#.#####.#..
...........#...#.#...#.....#...#.#...#...............#.......#.#
.###.#.###.#...#.###...##.####.#.#...###.##.##...#####.#.####..#
...#...#...#.#.#.#...#.#.......#...#...#.....#.......#.........#
.#.##.#..#.#.#.#.#.###.#.###.#.###.##..#.####.#####..#.#...#.#.#
.#.#...#.#...#...#.#.#.#.........#.#.#.#.....#...#.......#.#.#.#
##.#.#.#.#.###.#.#...#.#.#.#######...#.#...#.#.#.###.#####.#.#.#
...#.#.....#.#.#...#.....#.#.......#.#.....#...#...#.#...#.#...#
.###.###.###.#.#.#.#.#...###.#.#.###.#####..######.###.#.#.#..##
.............#...#.#.....#...#...#...#.................#...#...#
####.#######...#....#.####.###.#####.#.###.###.#.###.###..##...#
...#.......#.....#.........#.......#.#.#.....#.......#...#.....#
.#.###...#.#.#.####..#.###.#.#####.#.#.#.##..##.##.#######.....#
.#.....#.#.#.......#.#.....#.#...#.#...#...#.#.#.............#.#
.####..#.#.#.#.#.#.....#.#.#.#.#...#...###.#.#.#.#...#.###.###..
.......#.#...#.#.#...#.#.#.....#...........#.#.#.#.........#...#
####.#.#....#..#.###.#.###.###..##.#...#..##.#.#.##########..#..
.......#.#...........#.......#...#.....#.....#.#.#...#.......#.#
.#.###...#.##.##.###.#######.##..#.#..##.#.#.#...#.#.#.#######.#
.#.#...#.......#...............#...........#.#.......#.......#.#
..##.###.#.###.#.#..####...#####.###.#...#.#.##..##.###.##.#.#.#
...#...#...#...#.#.............#...#...#.#.#.....#.......#.#...#
##.###.#.#...#.#.###.#.#..####.##..####..#.#####.#.#.#.#..####..
.....#...#.#.#.#.....#.#.....#.....#.....#...#.....#.#.#.......#
.###..#..#...#..######.###.#.#.#..##.#######...#####.....#####.#
.#.#.#...#...#...#.....#...#.#.....#.........#.........#.....#..
.#...#....##...#.#.#.###.###.###.#.#.#############.#####.#.###.#
.#...#.....#...#...#...#...#.............................#.#...#
.####.###..#.#########.##..#...#.#.###.#...#.##.####.#.###...#..
.......#...#...#...#.#...#.......#.#...#.....#...#...#...#.#.#..
####.#.#.#####.#.#.#.##..#.#.#####.#.#.###.#.#.#.#.###.###.#...#
.....#.#.....#.#.#.....#.#.....#.....#...#...#.#.#.#.........#.#
.#.#.#.#..##.#.#.#####.#.#.###.#.###.##....#####.....#.##..#...#
.#.....#.........#.....#.#.....#.#...#.......#.....#.#...#.#.#.#
.#########...###.##.####.###.###.#.#.#..#.##.#.#.#.#.##..#.#.#.#
...........#.#...#.........#.#...#.#.#...#...#.#.#...#.....#...#
.##.#.#..#.###.#.#.###.##.##...##...###..#...#.#.#.#.#.#.#####.#
.#.....#.#...#.#.#...#.#.....#...#.............#.......#.#.....#
.#.##..#..##.#.#.###..##..######.#.##.#.##.#.#...#.###.###.####.
.....#.....#...#...#.....#.......#.#.......#.#.#.....#...#...#.#
.###...###.###.#.#.#.#####.#######.....#...#.#.####..###.###.#.#
.#...#.........#S..#.....#...#.....#...#...#...............#...#
.#.#.#..####.#.#.##.#.#..###...#.##..##.#....##.##.###.###...#.#
...#...#...#...#.........#.#.#.....#.......#...........#.....#..
.#.#####.#.####..####.#.##.#..##.#.#..##.###.#.###.#.#...##..#.#
.#...............#...#.....#...#.....#.....#.#...#...#.#...#....
.#########.#..##.###.#.###.#.#.#.#.#.#.#####.###.###.#.###.....#
.#.................#.....#...#.#...#.#.#.....#.......#.......#.#
.#####.#.###.###.#.#....##.###.###.#.#.#.#.##....#.#.#.#####.#..
.....#.#.....#.....#.#...#...#.#.....#...........#.#.#.....#.#.#
..##.#.#..#..#.#.#.###.#.###.#.####...#.########.#.#....#......#
.....#.#.....#.#.#.....#.....#...#...#...........#.....#...#.#.#
.#######.#.#.#...#####.##.##.###.###.#.#.##..#.###.#.#.#.###....
.....#...#.....#.#.....#...#...#...#.....#...#...#.....#.....#..
.###.#.#.##.####.#.#.#.#.#.###.###.###.#.#.#..####.#####.#.###.#
.......#.........#...#...#.......#.........#...........#.......#
#########.#############.#############.##.##.###...###.#########.
