8
.......#
.#.#....
...#G#..
.#.#.#.#
.#.#...#
#..###.#
S..#...#
#.##..##
