64
.#...........#.............#.....#.....#.......................#
.#.#.#..#.##.#.###.#..###..#.#.#...#...#.#...###.#..##.###.#####
...#.#.....#.....#.#...........#.....#.#.#.#.......#...#...#...#
.##..#.###....#..#.###.#..#..#.###.#.###.#....###..#....#..#.#.#
...#.#.#.#.#...#.#.....#.....#.......#.......#...........#...#.#
####.#......#..#.#.#.##.####.#..###.##..##.#...#.#.#.#.#...###..
...#.....#.#.#.........#.....#.#.......#...#...#.......#...#.#..
.#.#.#.##..#.###..#.##...##....#.###...#.#####.###..##.#####.#.#
.#.........#...#.#...............#.....#.#...#.......#.......#.#
.##..#..####...#.#.#.#########.#.##..#.#.#...#####.#...###...#..
.....#...........#.............#...........#...#...#.#.#...#...#
...#.#.#..##...####.#####.####.#.###.#.####.##.###.#.....#.#....
.#.#.#.....#.......#.....#.........#.........#.....#...#.....#..
.#.#.#####..###.##..........###..#.#######...#.#..##.#.#.####..#
.#.#..............S....#.#...#.....#...#.....#.#.......#.....#.#
##.#.##..#..#.##.##.##.#..#..#.#.###.#...#.#.#.###.#.#.#.###.#.#
.....#.........#.#.........#.#.......#.......#.........#...#...#
.###....####...#.......##..#.#.#.#.#..####..######.#.#####.#.#.#
...#.#...#.#...#.........#.#...#.........#.........#.#.........#
.#..###....#.#..##.#.#.....#...#.#.#.#.#.###.#.####.#..#.#.###.#
.........................#.#.#.#.#.....#...............#.......#
.#.#...##..#.##.##.#.###.#.#.#.#####.#.#.#.###.#.#####.#.#####.#
...#...#...#.........#...#...#...................#...#...#.....#
...#.#.#.#.###.#....##...#.#######....##.#..##.###...#.###.#.#.#
.........#.....#...#...#...............#.#.....#.......#...#.#..
.#.#.##..#..##..##.#..##..##.###.###.##..#####.#..###..#.###..##
.#...#...#.....#...#...#.....#.........#.....#.......#.....#...#
##.#.###.####..#.###.###..#.#..##.##...#.###.#.##....#.#.#.###.#
...#...#.....#.#.....#...#.....#.....#.......#.......#...#...#.#
.#.###.###.#.#..#.##...##..#.###.####.#..##.##..#.####.#...##...
.....#.............#.#...#.#...............#...........#.......#
..##..##.#...#.#.#.#.##..#.#########.#.###.#.###.###.###...#.#.#
...#...........#.#.....#.#.........#.#.#...#.#...#...#.....#....
#..#####..#####.....#.#...#######..###..#..###.###..#..#.#.#.#.#
.#...............#...............#...#...#...#.#...........#.#.#
.#.##..#.###.#.#.#.#.##..####.######..#..#...#...#.##.###.#..#.#
...#...#.....#...............#.....#...#...#.#.#.......#...#....
......##.###.#..##...#.####..#......#....#.#.#..#.##.##..#.#...#
.#.....#...#.......#.......#.#...#.#...#...........#.#...#.....#
##.#.#.#..##.#.#.###.##..###.#.#.#.#.#.#...#...#.###.#.####..#.#
.............#.................#.#.........#.#.......#.#.......#
.###...##..##..#..#.#.###..#####...#.#######..#.##...#.#.#.#.#.#
.#...#...#.....#...#.......#.....#...#.....#...........#.#...#..
.###...#.#.#.##.##.#...#...#....##.##..#.#######.###.###.#.#....
...........#...#...#...#...#.#.....#...#.................#...#.#
.##...###..#.#.#.#.#...#.#...##....#.###.###.#.##..########..#.#
.......#.....#.#.....#...............#...#...#.....#.........#.#
.#.#####.#...#.#.#.###.#.#.###....###..#...##.####...#.###.#.#.#
.#.......#...#.....#.......#.........#.....#...#...#.......#...#
.###.##.##.#.#.#.#.#.#.##..#..#.#..#....##.#....#.##.###.###.###
.....#...#...........#...............#.#.....#.......#.#.....#.#
...###.#.###...###...###.#..#.##...###...####.#######....##.##.#
.#.#...#.....#...#.#...#.......#.....#.........................#
.....###.#..####.#..#....#####.##.##.#.#######.####.#.#....#.#..
.#.#...........#.......#.....#.....#...........#.........#.#.#.#
.#.#...#.#.#.##..#.#####.###.#...#.#.#.#.#.#.#.#.#.#.#####.#.#.#
.#...#...#.#.....#.....#.......#.#...#...#...#.#.......#...#.#.#
.....#.#.###.###.#.#.#.##..###...#####...#.###.#.#.#.#.#.###.#.#
...#...#...#.......#.#.....#...#.......#.........#...#.#.....#..
.#...#.###.###...#...#####..#..#.#..#.##.#####.#.#.##...##.#..##
.#.#.#.....#.....#.#.#.........#.......#.................#G#...#
.#.#.#..####.#.#.###...####...#...##.#.#.....#.#..#..#.###.###.#
.....#...............................#.........................#
.#..#.#####..#.###.##.###.#############.#########.#####.####.#.#
