8
.....#..
..##.#.#
.#S.....
..####..
...#...#
##.#.#..
......G#
###.####
