32
.....#..........................
..#.##.........###.#...#...#...#
.......#.............#..........
...#.##.#....#.#.##..#.###.#.#.#
.........#...#.....#.....#......
..##...#...#..####.#...#.#......
.......#.............#..........
.#...#..#######...#..#...#....#.
.....#...........#.............#
.#..#..#..##..#.##.#......###...
.................#.............#
.#.#..#..##.####.....##.#..#....
.#.#.....#.......#......S#...#..
.#.##.#..#.###.#.....#.#.......#
.................#.....#.....#..
.#.###..##...#.#.....#.#..##.#.#
.#.#.....#.........#.....#.....#
.#.#..##..#..#..###.##.......#.#
.#.#...#.....#...#..............
##.#.#.###.#..##.......#.....#.#
.....#.#.#.......#..............
..#..#.#.#...##..#.#........##..
.#.............#.#...#...#.....#
.#...#.##..#.#...#....##..#....#
.#.#.......#.......#.....#.#...#
.#..####.#.##....#.####.##..#..#
.......#.#.............#.......#
.##..#.#..#...#......#.....#....
G............#.#.............#.#
#..#.#....###....#..######.#.#.#
................................
##...##..#.#..###..#.##...#.##..
