8
........
..###..#
.#..S..#
.#.###..
........
....##..
G.......
#...#...
