8
.....#.#
..##.#.#
S#...#.#
##...#.#
...#...#
..##....
......G.
##..####
