16
.......#.......#
.##.#....#...#..
..G......#...#..
.#.#.#.####.....
................
....##.....#.#.#
.........#.....#
##.#.##.....#...
.......#........
.#..#......#...#
.#........S..#..
.#.......####..#
.#...#..........
.##.##...##..#..
.........#.....#
#.#.##...#.###.#
