64
...#.#.....#.............................#......................
.#...#.###...#.#.#####.#.#.#.##########..#..#.##.#######.####...
.#.....#...#.#.....#.....#.#.................#...............#..
.###.#...#.#.#####.#####.#.#.#.#.#####...##..#####.#.#.#####.#.#
.#...#...#...#...#...#...#.#.#...#...#.#.........#.........#.#.#
..#.##....####.#..##.#..##...#...###.#.#....####.#.#######.#.###
.....#.#.....#.#.....#...#...........#.....#.....#.....#...#....
.###.#..####.#.###.#.##..#.#.###.###.#.#.###...##.##.##..#.###.#
.#.......#.....#...#...#...#.#...#...#...#...#.....#.#...#.#...#
.#.#..#..#...#.#.#.###.##.##.#.###.#.#.###.#####.#.###.###...#.#
.#.#.#.......#.#.....#.#...#.....#.#.#.#...#.....#.....#.......#
#..#.#.#.#.###.###...#.##..#.###.#.#.#.#.....#######.#.#....##..
...#.#...#.#...#...#.#...#.......#.....#.#.#...#.....#...#.....#
.####.##.#.#.###..##.##....###.#.#.###.#.#.#.#.#.#.###.#.#.#.#.#
...#...........#.#.#.....#.....#.....#.#...#.#...#.....#.#...#..
.#.#..##...#..#.....##...#####.#.###.###.#...#.#....#.#..###...#
.#.#.#...#.#.#.....#...#.....#.#.#.#.#.......#.#.#.....#.....#.#
.#.#.....#.#.#.###.#.##.###..#.#...#.#.######...##.###.#.#.###.#
.#...#.#.....#...#.#...#...#.......#.#.......#.#.........#......
.#####.#.####.#....###.#.#.#########.####.##.#.#.#..#.#..#.#####
...#.#.#.#.......#.....#.#.......#...#.....#.#.#.#.#...#...#...#
##...#.#....######..####...#...#....##.#.#.#.#.#..##....#.#....#
.#.#.....#.#...#.......#.......#...#...#.#...#.#.............#.#
.#.#.#####...###.######..#..#.####.#...#..####.########...####.#
.#...#...........#.....#.#.#.....#.#.#.........#.#.......#.....#
.#..##.#.#####.###.##..#.#.#..##.#.#.#.#.#.#.#.#.#.###.###.#####
.#.....#.#...#.#...#...#...#...#.....#...#...#...#.#...........#
.###.##.##.#..##.###.###.#.#...#.#.#.#.#.#.#.###.#.##.######.#..
.....#...#.#.....#.#.............#.....#.......#.#...........#.#
..##.#...#.###.###.#.###.#.#.#.#.#.###....####.######.####.###.#
.#.......#.#.......#.....#.#.....#...#.#.#...#.............#...#
.#.#####.#.#.#.###.#...#.#####...#.#.....#.#.##.######.#...#.##.
.....#.....#...#...#.#.....#...#.....#.#...#.....#.#.....#.#....
..##.#######.#.....#.#.#.#...##.#..###.###.#...#...#.###.#.###.#
...#.......#.....#.#.#.......#...#.........#...#...#.#...#...#.#
..##.#..##.#.##..#.#.####...##.#...#.#.#.#.###...###.#...###...#
.#...#.....#.#...#.......#.#...#.#.#...#.......#.....#...#...#.#
...#####.#.#.#.#.#####.#..##..##.#.#.#.###.#.#...####..#...###.#
.#.......#.......#S....#.....#...#.#...................#.....#..
..##.#########.#.#####.###.###.#.#.##.##.###...#.#.###...#.###.#
...............#...#...#.....#...#.....#...#.#.#.#...#.#.#.#....
.#.#.###.#.##..##..#..##.###.#.###.###..##.#.##..#####...#.#.#.#
.#.......#.#.....#.#.......#.........#.#...#.....#.....#...#.#.#
.#...#.###.#.##..#.#######....#.####...#.#.###.###.###.#...#.#.#
...#.#...#.#...#.........#.....#.....#...#.....#.........#.....#
##.#####.#.###.####.###..#..##.#.#.#.#####.##..#.#.#######.###.#
.#.......#.#...#.......#.#.......#.#.........#.#.............#..
.#.###..####..##.###.#.#..##.###...#.##.#.##.#...#.####.##.#.#.#
.#.........#...#...#...#...#.....#...#.#.....#.....#.........#.#
.#.#####.#.###.###.#.#...#.#.#...#.###.#.###.#######.##..#.###.#
.#.#...#.#.........#...#...#.#.#.....#.....#.......#.#.#.#.#...#
.#.#.#.#..######..######.#.#...#####.#.##..##..###.#.#.#.#.#.#.#
...#.#...#.....#.....#.......#.....#...#.....#.....#...#.....#.#
####.##.#..#...#.##..#.#.##.##.#...###.#...##.####.###.#######.#
.....#.....#.#.......#.#.....#.#.#...#.#.#.......#...#.......#.#
.###.#.###.#.#####.#.#.#...#.#.#.#.#.#.###.####..#.#.##.####.#.#
.......#.......#...#...#.#.#...#.....#.#...#.....#.....#...#.#.#
.#.#######.#.###..##...#.#..#.#.##.###.#..##.#.###.#####.#.#.#..
.#...#.......#...#...#.........#.#.......#.......#...#...#.#...#
.#.#.#.#.#.#.#.###.###.#.#.###.#.###...###.##.##...#.#.###.###.#
.....#.......#.#...#...#.....#.....#...#...............#...#G..#
...#.#...#.#.#.#####.####.##.###.#.#.#.#.##......###..##.##..##.
.......#.#...#...............#.......#...#...#.........#.......#
##########..###.#####.#####.###..##.#..#.##.###########..#####.#
