32
.......................#.....#.#
.#.##....#..#...####.#.###.#.#..
.#.....#G#.........#.#.....#...#
##.#.#.#.#######.#.#.#.###..##.#
...#.#.#.#.#.........#.........#
.###...#.#.#.#...###.#..###.....
...#.#.....#.#...#...#.#.....#.#
##.#######.#..###..###.#.#####..
...#.....#.#...................#
..##...#.#####.#..#....#.#.###..
...........#.........#.#.#...#..
.#.#...#.#.....#..##.#.#.##..#.#
.#.#.......#...#...#.......#...#
.....##.##.##...##.#...####....#
.......#.....#...#...#.........#
.#.###.#.#.#..##.#..##..##.###..
.................#.....#...#...#
.#.#.#####.#.###.###.#.#.#.##..#
.....#...............#...#.#...#
##.#..#.##.####.##.#.###........
.........#.....#...#.........#.#
...#####...#.#....##.#.#.#.#...#
.#...#...#.#.#...#...#.#.#.....#
.###.#..#..#.##....#..#......#.#
...#.#...#...............#......
.#...##..#...#.#.####..####..#.#
.#...#.....#...#...........#.#.#
.####....##....#.###.#####.#.#.#
.#...#.#.#...#.#...........#.#.#
.#.#.#.#......##.#...#.#.####..#
...#.....#............S........#
##.###..#.....####.###.#.##...##
