64
.........#G......................#...#.....................#...#
..#..#...#...##...#.##...#.....###.......#####.#.###.#...#.#.#.#
...#...#...............#.#.............#.....#.............#...#
.#.#.###..#..#.##.#.#......##....#..##..###..#........#..#...##.
...#.....#...........................#.......#...#.#............
.#.#.#.#.#..#.#..#.....#.####..#...#.#.....#..#.##.#.#.#..#..#.#
.#.......#.........................#...#...#...#...#............
......##.....#.#####.#.#...##.......####.#.###...#......##.#...#
...#.#...#.#...#...........#...#.#...#.......#.....#............
.#.#.#.#.#.#...#....#.....#..#...##..#..##.#...#...#..#.#..##...
.#.....#...#.....#...........#.#.....#...#.#.#.#.#.......#......
..###.###.#..#.##..#.#..####.........#.#.#...#.#...##..#.#...#.#
.#...........................#...#...............#...#.#...#....
.##..........#.#.....#.#..#.####...##..#.#...###.#.#.#.#..##.###
.#...#.#.............#.#.............#.#.#.....#................
...####..#.#.#####......####.#.#..###....#.....#...#...#.#......
.........#...........#.......#.#...............#...#...#.......#
..#.#....#.##.##...#..#..#...##..####.##...#..#..........##.....
.....#.....................#...#.........#...#.....#.#.........#
.#.#...........#.#.#.....##.....#..#.......##..#..#....###......
.........#.....#.....#...#...#...........#.....#...#.#.........#
.#...#.#..##.#.#.##..##..#.#....#.#....###.###.#.....#...##..#.#
.#...........#...#.#.....#.#...........#...........#.#.#.......#
...#.##..#.#...#.....##....##....##..#.....#.....#.#.......#..##
...#...........#.....#.................#.......#...#...#........
...###.##....#..##.#....##.#...#...#..####.....#.#.##....#..#...
.......#...#.#.#.#.....#...#.#.#...#.....................#......
.#.#...#...#.#.#.#....#..#.#.#..#......#.#...####..#..##.....#..
...#.#...#.........#.........#...............#...........#......
#.#...###.#.#.#..#.....##..#.#.#.#.#.#.#.#.#.#.#.....#.#.#.#....
.......#.............#...#...#...#...............#.....#...#.#.#
...##.##.##.##...#.##............##.####...#.#..##..##..........
.........#.........#...#...#.#.........#...#.#.........#.#...#.#
.#...#####.#####.###......#..#...#..#..#......##.#.##.#....#....
.........................#.....#.#...........#...........#...#.#
......#..#....##....#..###.#.....#.#.....#.#.#..###..##.##.#....
.#.#.............#...............#.#.#S......#.#.............#..
#....#....#....#..##.........#..#..#.....#.#...#......###.##.#..
.......................#.....#.#...#...............#.......#.#..
.##..###.###.#.#..#..#.#.#.......##...##...#.#...##...##.....#.#
...............#...........#.........#.#.......#...#.#.......#..
..###.#..#...####....#######...##...#..#.#..##.##..#.#...#...#..
...........#.......#...#.............................#.#.......#
...#.....#.#..##.#.#...#....##.........#..#....#...###.##...##..
.......#.#...#...#...............#...#.....#.#...#...#.........#
.......#.###.#.#.#..##.#####...#.#...#.#.......#.#.#.#...###.#..
...#.........#.#.#...#.............#.#.#.#.#.......#.#.......#..
........##.#.#.....#.......#...#.###.#...#.#.#.....#.#..##.#...#
.#.........#...#...#.#...................#...#.........#...#...#
.....#...###..##...#.#.#...#....##.#####.#..#....#####.#.###...#
.......#.........#.......#.....#...........#...#.............#..
.##..#.....#.#.#.##..#...#.........#....##.#.#..#.####.###.#....
.......#.......#.........#.....#...#...#.....#..................
#..#.#.#.#..##...##.#......#.#.....#.#...#.#.#.#.#.#.##..#.###.#
.......#.................#.#.............#...#.......#.....#....
.#.#...#.###.#.#......#..........#..##.#..##.#...#.###..#..#.##.
...........................#.............#.......#.....#...#.#..
...#..##.#.#####.#.....#.....##....#.###.#.#.###..#.###..##.....
...#.....#.......#.#.........#.....#.......#.#.........#.......#
.....#..##.....#.#.#.####.##....#..#.#...#...#..#...#..###......
...#...................#.........#.#.....#.#.......#...#........
.#.##..#.....###...##......####......#.##...#....###.....###.#.#
...................#.......................#.........#.....#....
##.#..####.#.#...#.##.#....#..##...##.#.##.#.#.##..##.#.###.#.#.
