8
G.......
...#...#
.#.#...#
.#...#..
......S.
..#.##..
........
#.##..##
