8
...#...#
.#.#.#.#
.....#S.
....##..
G#......
.#.#.#.#
.....#.#
##..#...
