32
.........................#......
...#.#.###....#..#....##...###.#
...............#...#............
...#.#...##.#..##.##.#..##.#.#..
.......#................G..#....
.#.#.###.#...#...#.###...#.#...#
...#.....#...#.....#.....#.....#
.....#..##.#.###..#.##.#..#.#...
...#.....#...#.....#............
....##.#...#...###.#....#.#..#..
.........#.#...#.#...#...#......
###..#......#.#..###.#..#......#
.........#.....................#
....#..#....#..#...#####..#.....
.#...#.................#.#......
.#...###..#.##.#.#.#.......#..#.
...................#.#.#...#....
.#...#.#.#.#.......#.#.#...#.#..
..S....#.......#...........#...#
.#.##..#....#..#...####..###....
.........#.....#.........#......
..#..#...#..#.###..##...#..#.#..
.#.................#.....#.#...#
.........#.#.#.#..#...##.....#..
.#.....#.#...#.......#.....#...#
.....#...#.#.#......#...###.##..
...............................#
...#...#...#..###...####.##..#.#
.#.#...#.........#...#.......#.#
..........###......#.....#...#..
...#.....................#......
.##.##.###.##..#..##.####.#..#..
