16
.......#......G.
.##.##....##.#.#
.............#..
......###.#...#.
.....#.....#....
##.....#.#..##..
.........#.#....
.#.####.#.......
.....#S....#.#.#
...#.#.#.###.#.#
...#...#.#.....#
.##....#.#...#.#
.........#.....#
....#..#........
.....#.......#.#
.##....###..##..
