32
.....#.....#...........#.......#
.#.#.#.#.....####....#.#...#...#
.........#.#.....#...#...#.#....
....######.........#....##......
.#.#.....#.........#.........#.#
.#...........#.#.....#..........
.#.......#.#.#.........#.......#
.##..#.#####.#.##.##.#.#.####...
.....#.#...#........S..........#
..#.#......#.#.##..#.##..#.#.#..
.........#.....#................
##.#.#....##...#..##.....#...#..
...#...#...#...................#
.#..##.#...#..####...#...#.#.#..
.............#.......#.#...#.#.#
.#...#..##..#..#.....#...#...#.#
.#.#.....................#.#...#
.....#..####...#.#..#..#.#...#.#
...................#............
.....#....###..##.##...#.#.#.#..
...................#.....#.....#
..#........#...#.#....#..#.#.#.#
.......#.#.......#.#...#.......#
#....#.#...#..##.#.#.#.#.#..#..#
...#.#.#.............#..........
.##..#.....#....#..##....#.#....
.....#...#...#...#.....#.....#.#
.....#...#.......#.##.#.#..#.#..
.#.....#.......#...............#
.....#......###.....#########...
..........G.....................
.......#..#.#..###.##..#..#..#.#
