16
................
######...#.#.##.
.........#.#..S.
...##.##.....#.#
.........#.....#
.#....#.#.##...#
...#.#.....#...#
#..#.#.#.#.#.##.
.......#...#...#
.###..#.....##.#
.........#......
.#.#.###.......#
................
....#....#......
.#G........#...#
#..#..##.##.##..
