64
.....#...........#...#.........#.................#.....#.......#
.#####.####....##..#.#.#.#.###.###.#..#..######..#.##....#.#..##
.#.....#...#.#.....#...#...#.......#.....#.....#.#.......#.....#
.#.#.#.#.#.#####.#####..##.#.#.#.######..#.####..#...###.#.#.#.#
...#.#.#.#.......#.......#.#...#.#.....#...#...#...#...#.#...#.#
...#.#.#.###.#.#.#.......#.###.#.#.##..#.#.#.#.##.##.###.#.###.#
...#...#.#...#...#.........#.......#.#...#.#.#.......#...#...#.#
.###.#.#...#.#.##.#..#..###.###.##...#.#.###.###...#.#.#######.#
.#...#.#...#.......#.#...#...........#.#...........#.....#.....#
.#.#.#.#####..#.##...#.#.#.########.##.######.##.#.#.##....###.#
.#...#.#.#...#.....#.............#.....#.......#.#.........#...#
.#.###.....#.#.###..#.###..#.#..#..#.###..####.###.###.#....#...
.........#.#.............#.#...#...#.....#...#...#.#............
##.####.##.#.#######.##..#.#.#.#..##.#.#.#.#.###.#.#.#.#.#.#...#
...........#.#...#...#.......#.#.....#.........#.#.#.....#...#.#
.##.########.#...#.###..####..#..#.#..#####..#.#.#.#.#.#.#.#.#.#
G..........#...#...#.....#.#.#.........#.....#.....#...#...#...#
.###.#####.#########..#....#.#.###.##..#.####...##.###.#.#####.#
...........#...........#.#...#.........#...#.........#.#...#...#
.###.#.#..#.##...#.###.#..########.#.###.#.#####.#..##...###.#.#
.#.................#...#.........#.#...#.#...#...#...#.#.#...#.#
.#####..#.##.##.##.#.#.#.###.###.#####.#..##....####.#.#.#.###.#
.....#...#...#.....#.....#.............#...#...#...#.....#......
.###...#.#.###..#.##.#.#.#.#.##..#...###.#..#####..#.###..##.#..
.#...#...#...........#.#...#.......#...#.....#.....#...#...#....
.#.####.#..#.#######.#...###.#.######..###.#.#.###.#.#..##.#..##
.#...................#.#...#...#.....#.........#...#.#.#.#.#....
.#.###.#..##.#..##.#.#.#.#..####.###.#.#.##.##.#.###.#...#.###..
.#...#.#...#.#.....#.#.#.#.#.....#...#...#.....#...#.#...#.....#
..##.#..##.#.#####.#.###.#.#.###.#..#..#######.#####.#..##.#.###
.#.....#...#.#.#...#.....#.#...#.#.#...#.......#...#.#.#...#...#
.#.##..#.......#.#.#######.#...#......##.#####.#.#.#.#.#.#..##..
.....#...#...#.......#.....#.................#.#.#.#.......#...#
.#...##.##.###.##.##.#..#.##.#.....#######.#...#...######..#...#
.#.#...#.....#.....#...#.....#...#.............#.#.....#.....#.#
...#.#...###.#.###.##..#.#####.#.####..#...###.#.#.###.##.#.##.#
.#.#.#.#...#...#...#.......#...#.#...#...#.#S#.#...#.....#...#.#
.###...#.#..##.#...#.##.#..#.###..##.###.#.#..#.##.#.##..#.###.#
.....#...#.......#.#.#...#.#...#.....#.....#.......#.#...#...#.#
######.##..#.####.##.#.....#.#..#.####...####.#.#.##.#.#####.#.#
.....#.#...........#...#.....#.......#.#.#...#.....#.........#.#
.#.#.#.#.#.##..###.######.#####..###.#.##....#.#.#.#.##.##.###.#
.#.#...#...#.....#.........#...............#.#...#.........#...#
.###.##..###..##.#.##..#.#.#.#.####.###.#..#.#.#.#...#.#.###.#.#
...#.#.#...#.....#...#.....#...#...........#...#.#...#...#...#.#
#..#.#.###.#.#.#.##..#.####..###..##.#.#..#####..###.#.#.#.###.#
...#.#...#...#.#...#.#...#.............#.......#...#.#.#...#...#
.###.#.#.##.#.##...#..##.....#.###.#.#.####..#.###.#...#.###.#..
.....#.#.............#...#.#.........#...#.....#...#.#.#.....#..
.###..##.....#.#.#.##..###.#.#...#...#.###.##.#..###.#...#.##.#.
.#.......#...#.#.#.#...#.....#...#...#.........#.......#.#.....#
.#.###.###..##...#..##.#...#....##.###....####.###.###.#.#..##.#
.#...........#.#.#...#.......#.#.#.#...#...#...#.......#.#.#.#.#
.###.####.##.#.#.#....######.#.#.#.#..#.##.#.###..#..###...#.#..
...#.#...#...#.....#.......#...#.....#...#.#.......#.........#.#
.#.#...###.#...##..###.#.#..#.##.#####.#.#...#..##.##..#..###..#
.#.#...#...#.#.#.....#...#.........#...#.#.....#...#.........#.#
.#.#.###..##.#...##.##############.#.###.#####.#..##..##...#.#.#
.#.......#...#.#.......#...#.......#...........#.....#.#.....#.#
..####.#.#.#########.#.#.###...###..#.###.#####.....##.#.###.#.#
...#...#.#...#.......#.#...#.#.............#...#...#.#.....#.#.#
##.#.##...##...###.###.###.#.#...#...#####.#.#.#.#...#.#.###.#.#
.....#.........#...............#.........#.............#.......#
####.#######.##.#.##..################..#.#################.#.##
