64
.............#...................#.......#..S#..................
.....##.####.#.#.#.#...#...#..##....##.....#.#.....#......#.....
.#.#.....#...#.#.........#...........#...........#.#...#...#....
...##..#.#.###...#.#.#.#.#.#..##...#...######.##...###.##.......
.#.#...................#.#...#.......................#.......#..
.....#...#.#.#..##..#.##.....#.....#.###.#...#....##.#...#..##..
.#...#...#.....#.#.#...#...........................#...#........
...#...#.#...#.#.#.#............##.......##.####...###.......#.#
.....#...#...#.#.....#...#.#...........#...................#.#..
#.#....#.#.###.#....#.#..#..#....##...#..#.##.#..#..#..###.#.#..
...#.........#...#.......#.........#...........#...........#...#
..##.#.#.##........#...#......###.....##.#.###.#.#.........#....
.......#.......#...#.#.....#.....#.................#.......#...#
.#.#.#...#.#.#....#...#..###.#...#.#.#...###..###....#.#.#.#.#..
.....#.........#.#.#.......#...#.......#...........#...........#
...###..#..#...#.#.#....#..#...#...#.#..#..###.#...##..#.####...
.........................#.....................#.......#........
..#......#...###.##.#.#..#####..#.#.#....##.##.#.....#...#.#..##
.........#.......#.....#.....#.........#.#.......#.........#....
...####......###....#..##....#...#.#.....#...#.#.###...#.#.#.#..
.#.....#.....#.............#.......#.....#...#.#.....#.......#.#
...#.#.#.#.#.....#....#.....##.#..##.##..#...#.....#.#.####.#...
.......#...#.......................#...............#.#.....#...#
...#.##....##.##..#........#.#.#...#...#...#.#.#...#.#.........#
...#.....#...........#.#...........#.......#.....#.#...#...#.#..
.#.#....##.#.#.#...##.##..##...#.###.##.###........#.#...###.#..
.#.....#.....#.#...............#...........#.....#.....#.#......
.###.#.........#.#...#.#..###..#.....#.##..#...#....##.....##...
.#.....#...#...................#.....#...#...#.....#...#.#.#....
.#.............#.#...#.#...#......#..##.#...####..#..##..#.#....
G#...#...............#.........................#...#.......#...#
.....#.#........#.##.#.#.#.#...#.#...#.#.....#...#......#..##..#
.....#.#...#.....#.....#.#.#.......#...#.#.#.....#...#.........#
.#.###.#.#.#.....#...###.#.#...#.#...###.#.#..#....#..#......#..
.#.#...#...#.............#.#.........#...#.....#...........#....
...#.##..#.#.#.#..##.###.#..#.##.#.#.#.#...#.#.#.#...#...#......
.........#.........................#.........#.#...........#...#
..#..#......#..#.#.....####....##..#.#..#....#...#..####....##.#
...#...#.....#...............#...#.#.#.........#.............#.#
.#..##.#...#...##..##..#...###...#.#..............#...#.##.#....
.#.....#.....#.............#.................#...#.............#
...#.###...#...#.##...#..#.#.#.#.......#...#.#...###.......#...#
.#...#.........#...........#...#.........#.........#.......#...#
.........#.#.#.#.#.....##........##.##.....###...#...##....###..
.................#.#.............................#.......#......
..#.....##......##...##.###....##..#.......#.......#....#.....##
.........#.................#.......#.#.............#.#..........
#..#.#...#...#.#.....##....#.##..#.....###...#.#.....#...#.##...
.............#.............#.....#.............#.........#......
...#..#..#....#....#.#.......#.#..#..#.#..###..#..#...##.###.###
.#...................#.#...#.......#...........#.....#.#.#.....#
...#.....##....#.#....##......#.#..##.....#.#..##...##.....#.#..
.......#.....#...#...............#.............#...........#...#
...#.#.#...####.##.#.#...#....#######....#.#.#.#...###.......#..
.#.....#.#.........#...#.......#...........#.............#......
...#..##.....#.#.#.#.#.#.###...#.#.#..####...##...##...#.#..##.#
.#...................#.....................#.........#.......#..
.#...#.#.###...#...#...#.#..##.#.##..#....##...#.#...#.#.#.#.#.#
...........#...........#...............#.............#.....#...#
.#..##.#.#...#..##.#.##..#.....###...#.#.#...#..###....##.......
.#.......#.............#.#.....#.......#.#.........#...#...#...#
.#.#...#.#...#.#.#...#.###.....#.#...#.#.##..#.#.#.#.#.#.##....#
.................................................#...........#.#
..#.#...##.#.##.#..############..#.##.#.#...#..#.###..#.#..##.##
