8
.....#G#
..#..#.#
S......#
.#.##...
.#.....#
...#.#.#
.......#
#..#.###
