8
.#....S#
.#.#####
.#.#...#
.#.#.#.#
...#.#.#
.##..#.#
G....#.#
###.###.
