64
.#...............#.#.............#.....#...........#.......#...#
.#.###.####.#.##.#.#.###...#.#.#.....#...###.#.#...#.#.#.#.#...#
.#.#.#.............#.#.....#.#...#.#.#.#.#...#.......#.#.#.#.#..
.#.#.#.###.#.#.###.#.###.###...###.#.##..#.#.#.##.##.##....#.###
...#.#...#...#...#...#...#...#.....#.....#...#.....#.....#......
.###.#.#.#...#.#.#.###.#.#.#####.##.##.##.##.#####.##..###.#.#.#
.#...#.#...#...#.......#...#...#...........#.....#.......#......
...#.....#.###.#.#.#.#.#..##.#...#...#####.####..#.###.####....#
.....#.....#...#...#.#...#...#...#.#.#...#.#.....#.#...#.....#.#
##.#.##.##...#####...#.#.#.###.#####.#.#.#.#.#.###...###.#.###.#
.....#...#...#.......#...#.....#.....#.#...#...#.........#.....#
.#.#.#.#.#####.#.#####.#..####.#.##.##..####...#..##.##.##.#####
.#.#...#...#...........#.....#...#...#.#.....#.................#
.#.#.#####.###.#.#.#.###..######.#.#.#...##.##.#.###..##.####.#.
.#...#...........#G#...............#...#.......#.......#.......#
.####.##.#.#####.#.#.#.###.###.#.##.######.###.#.#####.##.###...
.........#.........#...#...#...#.............#...#.....#.....#.#
.###...###.#.#.###.#####.#.#.#.#..##.###.#.#####.#.##..#.###.#..
.....#.#.....#.....#.....#.....#.#.#.....#.........#.#.#...#.#..
....####.###.##..###.#####.#.#.#....###.##.###..####.#.###.#.#.#
.#.............#.....#.....#...#.#.............#.........#.#.#.#
.#.######...##.#..##.#.#.##..#.#...###.#.#.....#.##..###.#.###.#
.....#.....#.........#.....#.#.#.......#.#...#.....#...#...#...#
##.#.###...#.#.#.#.###.#####.#.#.#.#.###.###.....#.#.###.#.#.#.#
.#...#...#...#...#.....#.....#.#...#...#.#...#...#.#.......#...#
.#.###.###.#.###########.####..#.#.###.....###.###.#..#####.##.#
.#.#...#...#.....#.......#...#.#.#.......#...#.....#.#.......#.#
.#.#.###.#.#####...#######...#.##..#.#.#######.###....####..##..
.........#.....#...#.....#.........#.#.#...#...#...#.......#...#
.#...#########.#####.###.#.#####.#####.#.#.#...#.#.#####...#.#.#
.......#.....#.#...#...#...#...#.....#...#.#.....#.#.......#.#..
.##..#.#..####.#.#.###.#.###...###.#.#.#.#...#####.#.#...###.#.#
.#...#.#.....#...#...#...#.........#...#.#.#.......#.#...#...#.#
...#.#.#.##..#.#.#.#.#####.######.#.####...###.#..##.#####.#.##.
...#...#.#.......#.#.....#.#...#...#.....#.....#.#.#.#...#....S#
#.##.#.###..####....####.#.....#.#.#.#######.#.#.#.#.###.##.####
...........#...#.#...#...#.#...#.#...#...#...#.....#...........#
.###########.###.#..##.#.#...#...##.##.###.#.#####.#.##.######.#
.#.......#.......#.#...#.#.......#...#...#.#...#.....#.........#
.###..###..#####.#...#####.#.####....#.#...#.#.#..##....##.#...#
...#...............#...#...#.....#.#.#...#.#.....#.#...#.#.....#
##.#.#####.#.#.##..###.#.####.##.#.#...#...######..#####.#.#####
...#.#...#.#.#...#.............#.#.#...#.#.#...#...#.....#......
.###.#.#.###.###.###.##########..#.#.###.#.#.##..#...#.#.#.#.#.#
.#...#.#.....#.#.#.#.#...........#.#...#.#.#.....#...#.#...#....
..##.#.##.##.#...#.#.#..##.#######.#.#.#.#...####.####.#.###.###
.....#.....#...#.#...#.#.....#.....#.#...........#...#...#.....#
#.##...###.#.###.###.#.#.###.#.#.###.#.###.####.##.#.#.#.#.##...
...#.#...#.#...#...#.#.#...#.....#...#.#.#.........#...#...#...#
.#.#..##.#.###..##.###.###.#####.#.###...#.#.#######.###.#..#..#
.#...#...#...#...#...#...#.#.....#.#...#...#.....#.#.....#...#.#
.####.##.###.#.##.##.....#...####..#...#########.#.##..#.###.###
.......#...#.#...#...#...#.#.......#...................#.......#
#.####.####..#.#...####....#######.#.#.#.##.#####..###.###.#.#..
.....#.#.......#.#.......#.........#.#.....#...#...#.#.......#.#
.##..#.#.##.#..#.#####.###.#####.###.#...#.#.#.#.###.####.##....
...#.#...#...#.#.........#.....#.#...#.......#.#.........#.#.#..
.#.#..####.#.#.#.#...##.######.#...###.#####...######..#...#.#..
.#.......#.#.#.#...#...........#.#...........#.#.......#.#...#..
.####.##.#.#.#.######..#...#.#.#.########..#.#.#....####.#.##...
.......#...#.#.#...#.#...#.#...#.............#.#.#.....#.#...#..
.###.#.#...#.#.#.#...#.#.###.#...#####..######.#.###.#.#.#####..
.......#...#.........#.........#.....................#.........#
.#..##########.#####..#.###...#.#############.####.###.#.#######
