32
.#..............................
.#..#.##.#....#...#..##..#......
.........#.............#.#.#.#..
..#.#....#.###.#...#.#..#....#..
...............#...#............
..###..#......##.#.#......#..#..
.....#.........#...............#
.#.......#..##...#.##..#...###.#
...#.....#.....#.#.....#........
.#.##.##..##.....#...#.....#.#.#
.....................#.........#
...#.#...........##.###..#......
.............#...........#.#G..#
##.#.#...#.##.....##...#.#.#....
.........#...#...#.....#.......#
.##..##......#...#.#..#..##....#
.#.......#.#...#.#..............
.##.#.##.....#.##.##.#..##.....#
.......#.#.#.#.....#.........#.#
...##....#.....###.##..#.#...#..
.....#...........#.........#...#
.#.#...#.###.###.#######...#.#.#
.............#...#.............#
#....##..#.....#...#...###.#....
...#.....#.......#...#...#.#...#
..#..##.#..#.....#...#.....#..#.
...........#...............#...#
....#..##...#.#............#....
...#....S........#...#...#.....#
.#.#.#..###..##.####.#.#..##.#..
...........#....................
#.....#..#.##.....##..#####..#.#
