64
...................#................S........#.......#..........
.####..##..#.#.#.....#.#.#.#..##....####..##....#.#..#.#####.#.#
.#...#.....#.#...#.....#.#...................#...#.....#...#.#.#
.#.#...##..#.###.#..#.##.#.###.#.#..###..###.##..#...###.#.#.#..
...#.......#.......#.....#.#...............#...#...#............
...###.#...#.###..##.#.#.#.###.#.#.#.....###..####.###.#.#.#.#.#
...#...#.....#.....#.....#.#...#.............#...#...#...#.....#
#.#..#.##.##.#.#.#.###.#...#..###.#...##.#.#.....#.#.#.##..#.#.#
.....#...........#...#.#...#...#.........#.....#...#............
.###...#.#.#.#...##..#.....#...###.#.###....####.#...#####.#.#.#
...#...#...#.#.#.#.....#.....#...#.......#...#.#...#.........#.#
...###.#.#.##..#...#.#.#.#.###...#.#.###..#..#.#....#.#..#...#..
.#.....#.#.........#.#...#...#...............#...#.#...........#
.#######.#.#.####....#.#.###.#..###.#...##.#.#.#.#.#..####.###.#
.#...#...#.#.......#.....#.......#...............#...#.#.......#
##.#.#.##..####..#.#######..###....####..###.##..#.#.#.#.#.#.###
.......#.........#.......#.....#.#.#...................#.#.#...#
..########...#.#..#.#..#.#...#......###....#..##.#.#####.#.###.#
.#...#.....#.#...#.#...#...#...#.#...........#...#.......#.....#
.#.#.#.#.#....##.#.#.#.#####.#.#.###.#.#.##..#.#####.#.#######.#
...#.#.#.#...#.#.....#...#.............#.......#.....#.#.....#..
.#.#...#..#.##.#.####..#.#####...##.##..##...###.#.##..#.#...#.#
.....#...........#.#...................#...#.....#.....#...#...#
##...###.#..######...####.##...######.##.#..##.#..###......#.#.#
...#.#...#.#.......#.........#...#.........#...........#...#...#
.##..#.#.#.#....####..#...##.#...#.#.....#.#.#.##.#.##...#..####
.#.........#.#.......#...#...........#.#.....#...#...#...#.#...#
.#####...#.######..#.#.#...###...#.#.#...###.##....#..##......##
.....#.#.#.............#...#.......#.#.#...#.#...#.........#...#
..##.#.#..####.##.##.#...###...#.#..##.##..#.#.#.##.#.###..#...#
.....#.#.............#...#...#.#.....#.......#.............#.#.#
.#.#..#..#.######.#..###...#.#.###.#.###.#####...##..#..####.#.#
.#...#...#...................#.....................#...#...#.#..
...###.#.########.####.#####.#.##..##..#.#.###.#...###...#.###..
.................#...........#...#...#.....#.#.................#
.###.#.#.###.##..#.##..#.####.##.###.###.###.#.#.#.#..########.#
.....#.#.......#.......#.......#...#...........#.........#.....#
.###...#..#.##.#####.#.##.####.###..#####...##....##.....##..#.#
.#...#.#.............#.....#...#.....#...#...#.#...#.#.........#
.#.#.#....##.#.##..#######.#.#.#.#.#.#.....#..####...###.#####.#
...........#...#.......#.........#.#...#.........#...........#.#
######.###.####..#...#.#.#####.###.#..##.#####.#.#.###..##.#.#.#
.......#.#.......#.#...#.........#.#...#.....#.......#.....#.#.#
.#.#..##.#####.###.#.######.#.##.#.#....####.#.#######.#.#...#..
...#...........#.....#...........#.........#.#.......#.........#
#....###.#######......##.#..##.#.###.#....##.....#.#..#.##.###.#
...#.............#.#...........#.....#.#.......#.........#.#....
.###...###.####....###.##..##.##.....#.##.######.#.###.#.#.#.##.
.#.........#...#.....#...#.....#.#...........#.......#.....#...#
.###.####..#..##..#...##.##.##.#.###.###.##..#.#####..###.#..#..
...#.#...#...#...#.....#...#...#.#.......#...................#.#
.#.#.#.#.##..#.#.#....#.##.#.###...#.....#..####.#.#######.###.#
.#.....#.........#.........#.............#...#.............#...#
...#.#.#.#..##.#.#.#.#.#..##.##.###.#..#..##.#..##.#.#####.#.###
.......#.#.....#.#.......#.........#...#.......#.#.#...........#
.##.##.#.#.#.#.#..##.###.#.#.###.#...#.####.#.##.#.#.##.##.#.#.#
.#.....#.#...#.........#.#...........#.#.........#...........#..
.#.....#..#..#...#####.#.#.#..####.###.#.#.###.#.#.##....#.#...#
...#.........#.#.......#.#.#...........#.#.......#.#...#.#.#...#
####.#.####.##..####..##.#.##..#.#.##..#.##..#.##....#...#...#..
.....#G..#...............#.......#.#.#.......#.#...#.#...#...#.#
..####...#.#.#.#####.#.######.###....#..##.#......#...####.###.#
.......#...#.........#.......................#.......#..........
##.#....#########...#.###..#.#...######..##.##.##.####..#.##.###
