16
.#G.............
.#.#.###.#.#...#
.#.............#
....#.##...#...#
...#.....#...#.#
......##.#...#..
...#...#...#.#..
..#.##.#.....#.#
.......#........
##.##.##.#.##..#
.#..............
.......#.....#..
.#.......#...#.#
.###.###.###...#
.....#S......#.#
..####.#..##..#.
