32
.#..........................G..#
...#.#.##..###.#.#.#.#.####.##.#
.....#.......#.#.#.#...#........
.###...####....#.#.##..#..###...
...#...#.........#..............
##.#.###.#.#..##.#.###..#.##.#.#
.......#.....#...#...#.....#.#.#
.#.###.#.##...##.#.#.#...#.#.##.
.#.#...#.#.#.......#.#...#.#...#
.#...###....#.#.##.#.#.#...###.#
...#.............#...........#..
###.###..#.##....#...##..###....
.......#.#...#.......#.......#.#
.#.##..#.#.#.#.#.#.##..#.#.###..
.#.........#.............#.....#
.#####.##......#.#####.#.###.#.#
.....#...#.#...#.....#.....#...#
####.#.#.#.#.#.###.....###.#.#.#
...#...#.#.#...#...#............
...#..##.#.#.###.#.#.#...###.#.#
.........#...#...#...#.#.....#.#
.####...###..#.#.#.#.#..##...#..
.#.....#..S#.......#.......#....
.#..####.###.#..##...####..#...#
.......#.#.#...#.......#...#.#.#
.##.##.#.#.#.##..###.#...##..#.#
.#...#...#.......#.#...#...#.#.#
.###.#.#.#########.#.##.#.#....#
...#.#...............#.......#..
##.#.#..##.##....#####.#.#####.#
.....#.........#.........#.....#
###.##..######.#..#...##....##.#
