64
.#.......#.............#.....................#...........#......
.......#.#.....#.#...#..####.#....###.....##.#.###.....#.#..#...
.........#.#.........#.............#.....#.........#.#..........
..##.......#.....#...#.#...#.##.###..#.....###.....#.#....##.#.#
.....#...#.........#.....#.#.............#...........#.....#....
.#.#...#...#.#.#......#.##.......#.###...##.####.##.##.#...#....
...................#.............#.........................#...#
.###..#.##....######.#.#......##.#..##.......#.....##.##.#...#.#
...#.......#.#...#...#...............#.#.......#...............#
#........#.....#..........#.#..#.#...#.##.##.#.#.#.#..###.##...#
...........#.....#...#...#...................#...............#.#
...#..##.###...#.#.#.#...#.#.####..#...#.#..####.#..##.#..###...
.#...........#.......#...#...............#...#......G#.........#
.#......##.##...##.#.#...........#...#.#.##....###.#...#...###..
...........#.......................#.................#...#.....#
...#.##.......####.#....##.###.##..#..#...##.#.........#...#.#.#
.....................#.................#.......#...........#....
##.#....##..#..#....##......#.#...#..#.#...#.#.#.##..#.#..#.##..
.#.#.#.#.......#.......#...#...........#.......#.........#.....#
.#.#.#...#...#.##.#.###..#.#..#.##.....#..#####.#......#.#.##.##
...#.....#.#...........#.#.......#...........................#.#
.#.#.#..##.#.#.#...###.##..#..##.#....###........#.##..#.###.#..
.................................#.........#...........#........
..#.##.....#.....##..##........###.######..#.#...#.......###....
.......#.#.............#...#.................#.............#...#
..##...#.###.#..#.#.##.....##..#...####.###..#.#...####........#
.#.....#.........#.....#.........#...........#...#.......#.....#
.#....##.##..#.#..##..###......#.#.#.#######.#.#...#.......#.##.
.#.#.........#.#.............#...................#.............#
...#.#.#.......##.##..#.######..##.......#.#.#.#.###.#.........#
...........#.........#.........#...#.....#.#.........#..........
.#.#......##..#..#.##...##.#.#.......##.#.#..####...##...#...#..
...............#.#.....#.#.....................#...............#
...#.##......#.#...#...#.#.#.....#.##.###..##..#.#.....#...#.##.
.#...............#...........#.#.....#.......#...............#..
.#...##.##.#.#.#.#.#.#....##.......#.#.#..#......#.#...#.#...#.#
.#.................#...#...#.#.....#...............#.#.....#...#
...#...#.......##..##....#.#.##........#.......###.......#.###.#
.........................#.......#.......#.........#.........#.#
...#...#...#..#..###.#.#.#.##.####.....#.#.#...#..#..#....#..#..
.................#.................#.....#.......#.......#.#.#..
...#.#.#.......#.#.##..#..##..#.###...##.......#.#.##......#.##.
...#.#...#...#S..........#...............#.#.#.........#...#...#
#.#...##.#.....#.#...#.......#..###....###.#..#..##.#...........
.........#.#.#.#.#.#...#...#.........#.....#...#.......#........
...#.#.#.#.#.#......#..........#.#.....#....##.#..###.##.#.#.#..
...#.#.#.#...#...#...#...#.....................#...........#...#
.#.#.....#.#.....###....#..#..##.#...#.#...#...#.####....#.#....
.#.........#.......#.....#.#.#...#.................#.........#..
.###..##...##....#...#.#.#.#...###...###.#.#......##.##.##..#..#
.#.....#.#...#...#...#.....#.#.........#...#.......#...#.......#
.#.#...#.....##....#...##....##....#...#..##...#.#.#...#.#.....#
...#.#.....#.....#.#...#.........#...........#..................
.....#.####......#....#....###.#.###..###....#.#..#.##.###...#..
.......#...........#...#.#.....#...#.....#.#...#...............#
..#..###.#...#.#.....#.#...###..............#..#.##.##...##..#.#
.#...#.............#.................#.#...#....................
.#.##..#..#..##....#.....#.#.........#.......#.#.#...##..#...#.#
.......#...#...#...#.......#.................#.....#...#........
..#.#..#.###........#.###..###.......###.#.......#.#.#.....#.#.#
.........#...#...........#.......#.....#.............#...#.....#
.#.##..#.#...#.....#.##..#.........#.#.#.#.#...#.#.#.#.##....#..
.......#...#.......#.....#.........#.......#....................
..#.##.#.#....###.##..#####...#.#.#....####..#..#...##....######
