16
................
.......#.###.#.#
S..........#....
#..#......#.#..#
...#...........#
...#.....#####.#
...#.#.........#
.#.#.....#...#..
.......#........
.......#....##.#
.#.#...........#
......##.#.#.#.#
.........#G#.#.#
.....#....#.....
...............#
##.######...##..
