32
...........................#...#
.#...##.#.###..#.#....##......#.
.#.#...................#........
...#..#.####...#.####........#..
...............#.....#.........#
.#.#..#....#..##...#...#.##....#
.#...........#.......#...#.#....
....#.#.#.#.....##..##.....#....
.#.#.........#...#.....#.#.....#
.......#..#..###.##..#.#.####...
..G#.#.#...#.....#.....#.....#..
.#.#.....#.#.#.......#..###....#
.....#...#...#.#.....#.......#..
.##.##.##......###.....#.#.#.#..
.............#...#..............
.......#..#..#.....#.#.#...#.###
...............#.........#.#....
....#.....#......#.##..##...##..
.#.#.#...#....................S.
.#.#.#........##.......#...#..##
.#...#.......#.............#...#
##.#.##.#....#.......#.#.#.#....
.....#.....................#.#..
.###...#...#..#....##..#...#....
...............#.#.......#...#.#
.#.#.#....##.....#.##..#...#.#.#
.............#.............#....
##..#....#.###.#..##.#.##..#.##.
.........#.......#..............
.#.#.#.#.##.....#.....##.#.....#
.......#.......................#
###.#.#....###.#.####..#......#.
