64
...#.....#.............#.....#...............#.....#.......#...#
.....#...#.###.###.#.###.#.#.#.#.####.##.###.###.###.###.###.#.#
.#...#...#...#.....#.#...#...#.#...........#...#.......#.....#.#
.##.##.###.#.#...#.#.#..#..#.#..#.##.#####.##....#######.###.#..
...#.....#.#.#.#.....#...#...#.#.....#...#.#.#...............#.#
##.#..##.#.#.#.#.##...##.#.###.#.#.###.#.#...#####.#..#.#..#.#.#
...#.........#.#.#.#.....#.......#.....#...#.........#.#...#.#.#
.###.###.#.#####...##.##...#..##.######..###.#.#.###.#...#.#...#
.#.....#.........#.....#.#.#...#.............#.#.#.....#.#...#.#
.#.###.#.##.....#....#...#.###.#######.###..#..###.#.#....###..#
.....#.......#.................#.....#...#...#.#...#.#.#.......#
.#...##.####.###.#.#...#.##.####.##..#.#.#####....##.########..#
.#.#.....#...#...#.#.............#...#.#.#...#.....#.#.......#.#
##.#.#####.###..##.####..#.###.##...##...#.#...#####.#.##..###.#
...#.......#.......#...#.#.....#.....#.#.....#...#...#...#...#.#
.#######.#.#.##.###..#.###..####.###.##.##.#.###.#.#####..##...#
.........#.#.#.............#.........#.......#...#.....#...#...#
######...#.###.###..########.###.#.#...#.####..#####...###.#####
.....#...#...#.#.#.#........S#...#.....#.......#.....#.#...#...#
.###.#.#####.#.#.#.#.#####.#.#...######..###...#.#######..##.###
.#.#.....#.#...#...#.#...#...#.......#...#...............#.#...#
.#.#...#.#...#####.#.#...#####.#######.###..##.######..#.#.#...#
.#.....#.#...#...#.#.......#...#.......#.........#...#...#.....#
.#####...#.#...#.#...#####.#.##..#.#.##..###.###.#...####.####.#
...#...#...#...#.#.....#...#.............#...#.#...#...#.......#
.#.#.###.#...###.#.##.##.######..#.###.###.#.#.####.##.#.#.#.#..
.#.#.....#.#...#.#.....#.........#...........#.....#...#.#.#...#
##.#.###.#.##..#...###...##.####.#.#.###.###.#..##.#.###.#..##.#
...#...#.......#.#...#.........#.#.......#.#.....#.#.....#.....#
.#####.#.#.#.###.###..##.######..#.#..##.#.#.#.#.#.###########..
.#.....#...#.#.#.....#...........#...........#.#................
.#.#..####...#.#.##..#.##...####.#.###.##..###.###.##..#.###.#.#
...#.#...#.#...#...........#.....#.#.............#.#...#.#...#..
.#..##.#....##...#.#..#..#.#.#.#.#...#....######.#.#.###.#.#...#
.........#...#.....#.........#.#.#...#.#.#.....#...#.......#...#
.#.#.#.#.###..##.###.##.##.#.#.###.#.#.#.#.###.####.#.#.##.#.#.#
.....#.#...#.........#...#.#.#.......#.#.#.#.#.............#.#.#
.#####.##..#...###.#.###.#.#.#..##..##...#.#.##..#####.###.#...#
.#.......#...#.#.......#.#.......#.....#.#.#.#.....#.........#.#
.#.#.##..###...#.#####.#.##.#.##.#.#.###...#.#.###.#.###########
...#.#...#...#.........#.#.........#.....................#.....#
.###....##.###.#.###.###.#.###.###.#.#.#..##..##...##..###..##..
.................#...#.........#.......#.....#...#...#.....#.#.#
####.#.#####.#.###.#.#.#....##...#####.#..##.#.#.#.#.#.#.###.#.#
.....#.............#...#.........#.........#...#.......#........
.######...######.######.#####..#.#.##.######.#.###.#####.#.##..#
...#...........#.........#.........#.......#.#.#...#.....#.#...#
.#..####..#..#.#.#.##.#..#.#####.###.#####.###.#.##..#####.#.##.
.#...#.....#.#...#.#...#.#.#.......#...#.#.....#.#.#.......#...#
.#.#.#.##..#.#####.#.##....###.....#.#.#..##.##..#.#...#.#.###.#
.#.#...#.#.....#.......#.#...#.#.#.#...#.....#...#.....#.#...#.#
.#.#####.#.###...#..##.#..##.#...#.#.######.##.##..###....##...#
.#.........#...#.......#...#.......#...#.......#.....#.....#.#.#
.####.##.#.#.#.#.#####.#.#.#.#.#.#.###.#.#########.#.#.#.#.###..
.......#.#...#.......#...............#.#...........#.....#.#...#
######.#.#....##.##.#......##.....##...####.###.##.##.####.#.#.#
.....#...#.#.....#.....#.#.....#...#.#.......#.....#..G....#.#.#
..##.##..#.####..#.#.#.#..#...##...#.###.###.#.#.#...#####....#.
...#...#...#.......#.......#.#...#.#...#...............#...#...#
##.#.#.#.#.#.....#####.###.#.#.....#.#.####.##.###.###.#######.#
...#...#.#.#.#.#...#.#.#...#.#...#.#.........#...#.....#...#...#
.###.#.#.#.#...###.#.#.#..#..##....#.###..#..#.#.###.###.#.#.#.#
...#.....#...#.......#.....#.............#.....#.........#...#.#
.##########.####.#########.########.#.######.####.#####.########
