64
...#.........#.................................................#
.#.#...#...#.###..#######....#.#...#.#..#..###.#.###.##..##..###
.....#.....#...............#...#...#.............#.......#......
######.###...#...#.##.#.....##.......#...#.#.#.#.#.###.#.#.###..
...........#.........#...................#.....#...........#....
...#..##.##.....#.##.##......##...###..#.#.#......#...##......##
.#...#.......#.....#.....#...#..................................
...#...#.#.#...###.###.#.#.#.#..#.##.#...........#.#.#.#.#.#...#
...#...................#.#...#.#.........#.....#...........#...#
......#...##.#....#..#.#.#........####.#.#.###...##.##.#.#...#.#
.............#.#...#.#.#...#...#...#.....#...............#......
...##...##.#.........#...#.#.#.#.#.#.#.#.##...#....#.##..#...#.#
.#.....#...................#.#.......#.......#...........#.....#
.##.###..#.##......#...####..#.#.###..#..###...##...#.#..#.#.#.#
...#.....#.........#.............#...#.....#...........#.......#
#....###....#.......#.#..#...###.#......##.#.##....#.#.#.#..#..#
.....#...................#.....#.#.#...#.#.#.........#...#......
.#.......####..#.##..##...#.##.###....##...#.#.#.###..##.#.....#
.#.........#.........#.......#.....#.#.........#.....#..........
...#...###.#....#..#.###...#.#...#....#.....##....#..#...##.....
...................#.#S..#.#...........#.#.................#...#
.#...#......#....###.......#..#..##....#........##.#.#.#.##....#
.#...#...........#...#.....#...#...........#.........#.#........
...#.#.###.###...#..##...#..#..#.####....##.......#....#..#.##.#
.........#...........#.......#.......#...............#..........
.#..####....##.....#.....#.#.#.###.#...........###.......#.#....
.....#...#.....................#.................#..............
...###.#.#.....##..###.....#.......##..#.........#.#.#.###...#.#
...#.......#...#.......#.#...#...#...............#.............#
...#.#.#..##.#.#...##.##.#......#..#.#..##...#.....###...#####.#
.........#...........#.....#.......#.#.......#...#.....#.......#
.#.##.#.....#.##.#####.#.#...#.#..#...#.#..#..##...#.#..#.####..
...........#...................#...#.....#.........#.........#.#
##.....#.#....#..##.#..####.##...#..###......#...#.####..###....
...#...#.............#...................#...#...............#..
.###.#...#..#..#..#.##.#.....#.#..####..##.#...####.##.....#.#..
...#.#.......#.#...........#...................#.......#...#...#
#..#.#.#...#.#....#....#.....#.#.#..##....##...#.#.###...#.#..##
.........................#.......#...#...................#......
.#...#.##..#.###.##........##.....#.....#..#.....#.#..##.#..##..
.....................................#..........................
...#...##.#....#.#...#...#.#.###..###.#..#.##.....##..........#.
.............#.............#...#.....................#.........#
##..###.##........##.....#.#.#.##.##...#...#....#.##.##..#...#..
.#.......#.....#...#...#.....#.......#.......#.............#...#
...#.#...###.#.#...###.....#.#...........#.#....#....#.......##.
...#.......#.#.........#.#.#...#...#...#.#...........#...#.....#
.#.#.#.....#....#......#....#......#..###..#.......#.##.##..#...
.......#...............#.#.................#...#.........#.....#
####.#..##.###.#.#.###.........##....#.#.#.....#....###....#....
...#.#.....................................#.#.#.......#.....#.#
...#.#.#...#...#.#.###......##.##.#.#.......#....###.#.###...#.#
.....#...........#.#.......................#...#.......#...#.#.#
...#.##...##.....#.###.#..####.#..#.#.#.......#.#.##.#..#......#
.........#...........#.............................#.......#....
.#.#...##..#.#...###...#.#.....#..#..#..#.#...###.....#....##..#
...#.............#.........#...#...........#.#.................#
...#.#...#..#.#..#.......#......###......#...#.##....#...#.#....
.#...............#.......#.............#................G.......
.#.##....#.#.....#.#.###..####.#.#.#..##..##...#....#..###.#.#..
.......#...............................#.....................#.#
.#...#..#....#...#...#.#.#.###.#.#.#.....#..##.####..#.#...#.#..
.......................#.......#.......#.#.....................#
#...##..#.###.#.##.##.#....##.##.#..#.#.....###...#.##.#.#####..
