8
.#S#...#
....##.#
.#......
.....#..
........
..##.#..
.....#G#
.##..#..
