64
...#.............#...........................#..................
.........#...#.#...#..##.#####.#.##.##.#.#.##.....##....##.##.##
.....#.#...#...#.#.#.#...............#...#.#.............#.....#
...###.#.##..#.#.#.#.#.####.##..#.#....#.#.#..#.#.####.#....#..#
...#.........#...#.....#...#.............#.............#...#...#
.#.###.##..###.##..###.#.#.#.###.#.##....#####.#.#.#.##..#...#.#
.#.#...........#.........#.......#.#.................#.....#...#
##.#.##.#...#..#.#.#.....#.#.###.....#.##.###.#......#.#.#...###
...#...#.#...#.#...#.....#...#...#.#.#...#.....#...........#...#
.####..#..#......#######.####..###...###.#.###.#..##.###.#.###..
.#.....#.#...#...#...#...#.....#...#.....#...#.#.....#...#.....#
...#.#.#.#.#.#.#.....#...#..#.##.#..#..#..##....##..#..###.###.#
.....#...#.#.....#.#...........#...........#...#.#...........#.#
.###...#...####..#.#..##..#.#...####...###.#...#.#.##..#.#.#.#.#
.........#.....#...#...#.....#.#.....#...#.#...............#...#
....####.###.#.#.#.###...#.#.#...###..##.#.#..#####..#..##.##..#
.#.....#.#...#...#G..#.....#...........#.............#...#.#....
.#####....##.#####.#.#.#.#.#####.....#.#.###.###.#####.###.#.#.#
.#.#...#.............#.#.#.#.....#.......#.....#.#...#.#...#...#
.#.#.#.##.####.#.#.#.#.#.#.#.#...#.#.###.#..###......#.#..##.#.#
...#.....#.....#.#...........#.....#...#.........#.#.........#..
###....#...#####......##.##..#.###.###.###.#.##.#..#######.#...#
.................#.............#.......#...............#...#...#
...########..#.#.#.#.#...###.#.###....##.#.######.##..##.#.###.#
.#.....#.....#.#...............#...#.............#...#...#......
.#...#....##.#..#....#.#.###.###....##.####.####...###.####..##.
.......#.#.....#.......#.......#.................#...#.....#...#
.#.#...#.#..##.##..##.####...#.#..#.#.####.#.##..#.#.###.#.##...
.....#.#...........#.....#.....#.#.........#...#.#...#.........#
####.#..##.#..##.#.#...#..##.#...#.###.#...#.#.#.#...#...###.#.#
.....#.#.....#...#.#.#.........#...#...#.#...#.....#.....#...#.#
...###.#.###...##....#.#.#.#...#.#.#.#.###.#...#..#..###.#.#.#..
.........#...#.#...#...#...#...#.....#...#.#.....#...#...#.#....
...#.##.##.#.#.#.###.###...#.....#.#.#.#...##....#.#.#.##....###
.....#...#.#...#.....#...#.....#.................#.......#.#.#.#
..#.##.##.......####.#.##....#...#####.##.#..#.#.##.####.#...#.#
.......#...............#.....#...#.......#.....#.#.............#
.#.##.##.###.###.###.###.###.#.#.#...##..#..####.#.#.#.#..####.#
.#.......#...#...#.......#...#.#...#.....#.#...#.#.#...#.#...#.#
.#.#.#.#...####..#.##.###....#.#...##.#..#.#.#.....#.###.....#.#
.....#...#.#.......#...#.........#.#.........#...#.........#...#
.##.....##....####...#.#.#.#.####..#...#########.#.########..##.
.#.#...#...#.....#...........#.......#...#.......#.....#...#...#
.#.#.#...###..##.#...#####.#.#....##.###.#..#.##.#.#.#.###.##..#
.....#.#.#.....#.........#.#.#.#...#...#.........#.#.........#.#
.#.#.#.#.##..#.#.#####.###...#..#....#.###.#..#.##.#...#.#.###.#
.#.#.....#...#.......#.....#.....#.#.......#.#.....#...#.......#
.#...#.#.#.####....#.#.#.#.#.##..#...###.#.#.#..###....#.###.#.#
.#...#...#.#...#...#...#...#.........#.....#...#.#.....#...#...#
.#...####..#...###.#.....##..#.###.##..#.#..####...#.#.###.#....
...#.............#.#.................#.#.#.........#.#.....#....
##...#.##.##.#.#.#.##.#.#.####...#...#...#..##.###.#.###.#...##.
.#.#.#.....#.......#.#.................#.#.......#...#.....#...#
...###.#...###.##....#.#.###...#.#.##.#..#.#.#####.#.#..#.##.#.#
.#.#.....#.......#...........................#.....#.#.#...#...#
.#.....###...###.#..####.#..#..#.#..#######..#.###.##......#.#.#
...#.......#.......#.....#.....#...#.....#.............#S#.....#
.#....#....#.#.##..#......#..#...###...#......####.#.##.##.#...#
.......#.....#...#.#.#.#.....#.#...#...#.#.#...#.#.#............
.###.#.#.###.###.###.#.#.#.###.###.#...#.#...#.#.#..##.####.#..#
.....#.........#...................#.....#...#...#...#.#.......#
#.##.######.##.#######..####.#.###.###.#..#.##....#....#.###.#.#
...............#.............#.........#.......................#
.#######..##.##.##.#######.##.#.##.#..###..##..###.#.##.##....#.
