32
.............#..................
...###.#.......##....#.....#..#.
.........#.......#....S..#.#...#
..#.#..#....#.#.....#..........#
.......#.......................#
.#.##..#.#...#....#..#.#.#..#..#
.................#.#.#...#.....#
.##..#.#.####.#......#..##..#...
.........#.....#.........#.#....
...#.###.#.#...#.#.###.#...#.#..
.......#...#...........#...#.#..
...#.#..#.#..#....#.#........#..
...#.#.....#.................#.#
...#.##..#...#.##..#..#.#.......
...#.#.............#.......#...#
.....#.#...#.####..####...##....
...#.#.....#.............#...#.#
.#.#.#...###....#.####.#.#.###.#
.......#.#.....#...........#....
.#.#.##..#..###..##.##.#.#....#.
.#...................#.....#...#
.###..#.##...###...###..#.##....
.....#.........................#
.#....#.......##.#.#.#.##....#.#
...#...............#.........#.#
.#.###.####..#.#...####..###...#
.....#.....#.....#.....#.#.....#
##...#.#...#.........#.#.#.#....
.........#.#.........#.......#.#
.#...###.....#.#.###.....#.#.#.#
......G.........................
...###....#.######...#..#.##.###
