16
.....#S......#.#
.#..##.#.#.#.#..
.#.......#.#....
.......#...#....
.#.#.......#.#.#
.#.#.....#.#.#..
...#...#...#...#
#.###..#.#.#.#..
...............#
.#.###...#.....#
................
...####..#.#.#.#
...#.....#.....#
...#...#...##..#
....G..#.......#
##.#...##.#.#.#.
