16
...#...#........
.#...#.#.#..#...
.#.........#...#
..#..##..#.#.##.
........S......#
...#.#.###.#.#..
.....#...#.#...#
.#...#.#.#...#.#
.#.#...#.......#
...#.##..#.#.#.#
.#.........#...#
.#...#.#........
...#...........#
....##.#..#..#.#
.#............G#
..#..###..#####.
