8
.......#
.#.#...#
G#.#....
...#...#
.#.#.#.#
..##.#.#
.....#S#
##.###.#
