64
...........#...............................#...........#.......#
.#.#.#...###.#.#...#.#.#####.....#####.#......#...#..#.#.##..#.#
.....#.#.......#.#.#...................#.....#...#...#..........
.#..##..##.#.#...#...###.......#.....###.#..##.....#..###.##.#.#
.#.................#.....#...........#...#...#...#...........#..
...#.###.#.#.......#.....#..##.#...##..#.#...###.##....#.....#..
...#...#.#.#.#.......#.....................#.........#.......#..
.##....#.#.#....#..##...###....#.##..##.#.##.#.#..##.#...#......
...#.......#.#.............#....................................
##.###.......#.#..#.###..#.#.##.........#.##...#.#...#...#.#.#.#
...#.......#.#.......#...........#...#.........#.#...#...#...#.#
.##..###...#.#.......#......##.....#.#..#..#...#.###...#.#.###.#
.#.......#.......#.............#.#.......#.........#.#...#...#..
.#.###...#.##.#.....#......#.#.#.#.###...##.#.#.#..#......##.#..
...#...........#...#...........#...............#...#.......#...#
....#..#..##...#.##....#.#..#..####..#..#..#.#...#...#..#...#...
.........#.........#.....................#...............#.....#
.#.....#.#.#..#.......####.#.#...#.###...#....##.....#.#........
.................#.#.....#...#...#.......#.#...#...#.........#..
#..#.#.#.#.#...#.#...#...#......#.#..#.#....#......###.#.#.#....
...........#.....#.....#...#...#...........#.......#.....#.....#
...##..###...###.####..#.#.###.#.#..#####.....#....#..#..#..#...
.....#...#...............#.......#.......#...#.........#...#...#
#.##.#.#...#.........#...##..#.....#.#.#.##..#.#........##..##..
.........#...........#.......#...#.....#.....#.#.........#......
.#.#...#.###...#...#.#.###.....#.......#.#..###..#....##.##..#.#
.#...#...#.......#.............#.#.......#...#...#.....#..S.....
....##.###.#.#...#.#..###.##.#.....#.....###.#.....###.#..#####.
.....#.......#...............#.#.#.#.#.......#.........#.......#
...#.#..####.#..#..#.........#.#.#.#.....####........#.#.#..#...
.#...#.......#.......#...............................#.......#..
.....#....#.##.#..##.....#...#.#.##.##.#.#.....##......#.#.#....
.#.#...........#.#...#.........#.....#.....................#.#..
.#.##.#.##.##..#.#.#.#...#....#.####.....#.#.#....#......#.#..##
...........#...#.....................#.........................#
.###.####..#.#....#.#..#.#.....#...#.#.......#.##..#...#..##...#
...#.....#...............#.........#...........................#
.#.....#.#.##.#.##.##..#.........#....#.#......#...#.......#.#.#
.#.....#...#...................#...#.....#...#.#.#.#.....#.#.#..
..##.#...#......#.##.#####..#.........##.#.#...#..#..#.###.#...#
.#...#.#.....#.#.....#.........#.#.....#.....#..................
....##.#..........#.....#..#....##.###.#..##..###...####.##..#..
.#.....#.............#.......#...#...#...........#...........#.#
.#######...##..##..#..#..#.#...#.....#.#.....##.......#..###.#..
.........#.....#.........#...........#...#.....#...#...#.....#.#
.#.#...###.##.#.....##...#..#.#.#....#.#...#..###.#..###.#####.#
.#.........................#.....#...#..........................
.#...##...##...##.#..###..##.#.#.#...#.##.#..#.###.....#.#...###
.#...........................#.............#.............#.....#
..##.##..#.##....#.....##.###..#.........#.##...##...#.#...#.#..
...#...........#.#.......................#.....#...#...#........
.#.###.#..##.#.#.#.#.#.....##.#.##.#...#...#..#..###.#......##..
.......#.............#.....#.......#...............#...#........
.#..#..#.#...##.........#..#.#.#.......###..#.###..#...#...#...#
.......#.......#.....#.............#...................#.....#.#
.#.#..##...##.....#....#.##.....#..##....#..#..###.##..#.#.##..#
.....#...#.....#.....#.......................#.#.#.#.#.#........
...###...#.......#..#.#.#..#.#.###.#.#.##....#.#.#.....#.##.##.#
.......#...#.#...............#.....#...#...................#...#
.#.#.#..##...#.#.#..###.#....#.#..##.#.#.#.#.#.###.##.###....#.#
.....#.....#............G..#...#...........#.......#............
.##.....#..#.#.#.#...#.#....#.#...#....###.#..#..#.#..###.####..
.............#...........#...........#.....#...................#
..##..#.###########....#..#..###...#.#....##.#.......###.##...#.
