16
.......#...#...#
.#...#.#.###....
.....#...#...#..
.#..#.##....##..
G..#.......#....
.....#.#..#....#
...#...........#
.#.#.#...##..#..
.#.....#........
.....#.###....#.
.#.......#.....#
.#.#.##....#...#
.....#..S#...#.#
.....#.##......#
................
#.###...####..##
