8
......G.
.#.#.#.#
.#.....#
.#...#..
.#S#....
....##..
.#.....#
########
