8
......G.
...#....
.#.#...#
.#..#..#
.#.....#
...#.#.#
.#..S..#
.#..###.
