32
..G........#...............#...#
.#.###.#.#.#.......#..##.....#.#
.......#.........#.........#.#.#
#.##.....#.#####.#.#...#.#.....#
.......#.........#.......#...#.#
....##.......#.#.##......##.##..
.#...#...........#.......#.....#
.#.#.#...#...##..#.......#..#...
.#.#.............#.........#...#
...######.##..#........#.###.###
.#.......#...........#.....#...#
.#..#.......##.#...#.....#.##...
.........#.#...#...#.....#.....#
.#..#..#.#.#..#..#...#..##...#..
.#.........#.....#...........#.#
.........#.....#....##.####..#.#
...#.#...................#...#.#
.###...#...#.#.##.....#......#.#
.....#.......................#.#
...#.#..##.#.####....#.#.#.#.#..
.......#...................#....
......#.#..#.......#.#.####..#..
...............#.........#......
....##...#...#.###.#####.#..#.#.
.......#.............#......S...
.#..#...##.#......#.##.##.##....
...............................#
...#.....#.#..#.##.#.....##..#.#
...#.#...............#...#.....#
#....#.##.#.#######..#.#.#.#....
................................
#.##..#....#.##.##.###.#..#..###
