32
.......#.....#.................#
..#....#...#...##.#.#.......#..#
.#...#...#.#...........#.#......
...#..##.#...###.#.#.#...#.....#
.#.#.......#.......#S....#...#.#
.#..#......#.#.#.#.....#....#..#
.......#...#.......#...........#
.#...#...#.#.#.....##....#.#...#
.#.........#...#.#.....#........
...#####...#..##.#.#.......#.#.#
.#...#.........#...#............
..#..#...##.##.#.#.#.##..#.###..
.#.............#.#..............
...###.#.###.#.##..#..##.##.##.#
.#...........#...#..............
..###..###...###..#....##...#..#
.............#.................#
...#...#..#....##.....#......#..
...#.....#.#...#.#.....#.....#.#
.........#.#.#.#.........#.#.#.#
...#.#...#.......#...#...#.#....
##.#.#.##...#..#...#.#####...#..
.......#...........#............
..#.##......####.#.#......#....#
.#.................#.#.....#...#
...##....#.....#.....#..#...##.#
.#.......................#.....#
.......#..#..#..###......###.#.#
.#G..........#.....#...#........
...#...#####.##..#.#.#.#.###..##
...#.............#...#..........
.##.......###.#...#.###..#..##.#
