32
.#.................#...........#
.......#.#.#..##.....#.#.###.#..
...#...........................#
.#.#..#.##.##..#..#####....#....
.#....S................#...#...#
...#.#.....#...#.#.#...#.###...#
.....#...#...#.......#.#.......#
.#.#.#.##......#.#.###.#........
.............#.#.....#.#.......#
...#...#.#..##.#...#...#..#.....
.................#..............
.###.##............#..#.##.#.#..
.......#...........#............
#....#.#..#.##.###.#.....#.....#
.#...#...#...............#.....#
.#.#..##.....####..#.#.###.#.#..
.....#...#.......#..............
.#.....###....##.####......###.#
...............#.....#..........
.#.#.#.##.##.....#.#.#.....#.#..
.#...........#.#.........#...#..
..#.###..#...#...#.###.....#....
...#...#.....#.#.....#.....#....
.#.#.....#.....#..#....#...#.#..
.......#.....#.......#.......#..
..##.....#...#..##.#...#..##....
.#.....#...#......G..#.........#
....##.#.#...#.........###.#.#..
.....#...........#...#.....#.#.#
...#.#..#.#..#.#....#..#.###...#
.......................#........
.#.....#.###.#.##..##..####.#.##
