8
......G.
.#...#.#
.....#.#
#..#....
S..#....
###..#..
........
...###..
