32
.............................#G#
.#.###.#.#...#.#.#...###..##....
.#.......#.......#.....#.......#
.#.#...#.#........##.#.......#.#
...#.#.........#...............#
...#.#.###...##.##.#####.#...#..
.#...................#.....#...#
....#..#....#..#..##...#...#....
.#.........#...#...........#....
...#..##...#.#.#.....##.#.......
......S......#.................#
..##...#...#...#.#..#.#..#.#...#
...#.....#...#...#.#............
.#.#..#..#.#.##.#..#..##.#.#.#.#
.........#.......#.............#
.#.#.#.....#.#...#.#.......#.#.#
.....#...#.....#................
.###.#.##.##...#...#.#...#.#....
.#...#.#........................
.#....#....#.....#.#..#.....#...
...#...........#.......#........
.#...#..#.......#.#..#..........
...#.....#.#...............#...#
#......#.#..#...#....#...#.#..#.
.#.....#.#.............#.....#.#
.#.####..#...##.....#.####......
.............#.....#.........#.#
.......##.#..#.#..##..#.........
...............#.......#.#.#....
.##.#..#..##..##..#.#..#.####...
.......#...............#........
.#.#..#.##..#.##.##.##..#....#.#
