16
.#.....#........
.#.##..##..#.#..
....S#.........#
.#.##.#...#.....
...........#.#..
...###...###.#.#
...#.......#....
.#.#.#####..#..#
.#.#.#...#.....#
.#...#.#...#.###
...#.....#...#G.
..##.....###.#.#
...#...#.......#
.#.#...#...#...#
.#.....#.....#.#
...##......###.#
