64
.#.........#.........#.............#...............#...........#
...#..#....#.#.#...#.#.#.###.#.....#...###.#.#.##..#..##.###....
...#...#.........#...................#.......#...#...#...#......
..##.....#.##....#...#.##.....#####..###.###.##...#..#.#.#.##...
.........#.......#.........#.#.....#.........#.#.......#.#.....#
.#...##....#.....#....##.....#....##.#..........#....#.#.....#.#
.....#.......#...#...#...#...#.........#.....#.#...........#..S#
.......#.###.###...#.#.....#.##.....##...##..#.#...#.##.#..###.#
.....#.#...............#...#...#.....#...................#......
.#.#.#.#.##..#.#.#.....#.#......##..##.#...#.....#.#...#.#...#..
.#.............#...........#.#.........#...............#...#...#
.#.#.#.#.##..###..###..#.#.....##....#.#..#...##.##.#....#.#...#
.#.#.......#...#.....#...........#.........#...#.....#...#...#..
.#..#.#.##...#.#.#.#...###..##.###.##......##..#.....#...#.####.
.......#.....#...........#......................................
....#..#.#....#.#.#..#.#....###.##.#....###......##.##.#.#..##..
.....#.....#.........................#.........#...............#
......###..#..#..#.###.#..##.#.#...#.....#.....#.####...#.#....#
...#.#...............#...................#.....#.#.........#....
.#.#....#..#.#.###.#...##..#.#...#.#.#...#.####..#...#.......#.#
...#.....#...#...............#...#.....#.............#...#.....#
.#.#.#.#........##.......#.#.#.###.#..##.....#.###.###.#.#...#.#
.#.#.......#.#...#.....#...........#...#.....#..................
...##....#.....#...##..#..##.#.........#.####..............#.#.#
.#.......#.......#...#...................#...#...........#.....#
..#.#.##.####.#............#.....#..##...#....##.#..#...##....#.
...#.................#.#.........#.#.....#.#...#................
##.#..##.####........#....#....#...#.###...##.#......#.#....#..#
...#...#.......#.....#.............#.......#.....#.....#.#.....#
..#....#..##.###.#..#..###...#.##......##..#.#.##...#......##.#.
.........................#.#.......#.........#...........#.....#
..#..#.#.#...#.......#.#...#..##...#...###.##....###.....#...#.#
...#.....#...#.....#.......#.#...#...#...#.....#...#.#.......#..
...###.#.##..#...#.......#.##....#.#......##.....#...#...##.##..
.#.................#.#.................#.............#.#.....#.#
....#..#......##.#.......###.#...#.#.#.#..##...#.....##..#.###..
.#...#...#.#...#.........#.................#.#...#...#...#.....#
.#.#.#...#.##....#..#...#..#.#..#..#..##.#.#.#.#.#.#.#..####.#..
...#.#.............#...................#.#...........#.......#..
..........##.#.#.....#...#.....####.##....###.##..##.......#.#..
.......#.....#.......#.#.....................#...........#.#....
..#.....##.....#.......#.###..#.##...#..##.#.#..#.#..#.#.......#
.....#.......#.....#...#.....................#.........#.#......
.......#####...###.#.###.#.#.#.....##...#....#.#.###.#.#.#.##...
...#.......#.#.....#.....#.....#.....#...........#.......#......
.......#...#...####....###...#.#.##..#...#.#..##.#..####...#....
...#.......#...#...#.#...#.....#...#...............#.....#.....#
.###..#..#.#.#...#.#.#.#.#.#.#..#..#...#....#....#.......#.###..
.....#.......#.....#.....#...#.....#...#.#.......#.........#...#
....#..#.#......#..#.#..#..#.#..#..#...#.#....#.....##.#...#....
.#.............#...#.#.........#.........#...........#.......#..
.#.....#....###....##.##..#...##.###...###.#.#.##..#.#.....###..
.......#.........#...........#...............#.#...#.#.#.....#.#
......##..##...#...#.....#.#...###..#.#.....#......#.#.#.....#..
...........#...#.......#.....#.#.......#...#...#.....#.....#....
....##..#..#.#...###...........#.#.#....##.#..#.#.##.#......#..#
.#.........#.#.#.....#.#...#.#...............#...#.........#...#
.#...#.#.....#...##..#.#.#....#..#.#..#....#...........##..#....
.#.#............G........#...#.#...........#...................#
..##......#........#####.......##..#.##.#..##.#...##.#..##...#..
.............#.#.#.......#.....#.....#...............#.........#
.............#.#.##.#....##.##.#.#.#.......#..#....#.#.#.###...#
.................#.................#.....#.........#.....#.....#
#.#.#..##.#..#.##.#..#..#..#.#.##.....##.###....#.####...#.#.###
