32
.......#...............#........
...#.#.#.....#.#....##...##....#
...#.......#...#.#...#..........
...#.....##.####.##....###.###..
.#.........#.....#.........#...#
.........#....##.#...##..#.#.###
.....#...#.#.#.........#...#....
.###...#...#...#.###....#.##.#.#
.........#.....#.....#.......#..
.....###.#.#.###.#.#....#..#.#..
.#.#...#.........#.....#...#....
..#..#.#...##.............###..#
...........#...#................
...#..#.##.#..##....#####.####.#
.....#.........#...#............
.#..##..#...#......#.....##..#.#
.......#.........#.#......S.....
#........#.#..##...#.#.#.....#.#
.....#...#...............#...#..
.#.#..####...###.......#.#...#..
.#.................#.....#.#....
.#...#..##.......###..#....###..
.#.....#...#.......#.#.#.......#
.#..........###..#.#.#.#.#....##
.....................#..........
...##...#.....##.#.#.#.#.#......
G..........#.....#...#.........#
..#......#.....#...#.#.#.#..##.#
.#.................#...#...#....
.#..##...#.......#...#.....#.#.#
.......#.............#.........#
#.#..####..##..#.##.....#..###.#
