64
.....#...........................#.....#.............#..........
..##.......###...#.......#.#.###.....#.#.#.....#...#.#.#..#.#.#.
.....#...#...#.........#.......#.....#...#...#...#.....#........
.#.#..#...##.....#.#.#.....##..#.....#.#.#.....#...#.#.....##..#
.......#...........#.#...................#...#.......#.........#
.#.......#...#..#....#..#.#......#..#........#..#..#.#..#..#.#..
.....#.#.....#....G..#.............#.........#...#.........#....
..#.##.......#.....##.##....####.###.##....##....#.#.###.###.#..
.......#.#...#.#.................#.......#...#.....#...........#
.#.#.##..#.#.#.###.#.#.#.#####...###.#.##....#.##..##..#...##...
.#.#...........................#...........#.....#.#...#.#......
...#..#..#....#..#...#..#..#..#.#...##.#.#.#....##...#.#....####
.#...#...#.#.....#...#...#.#.............#...#.....#.....#......
...##..#.#.#.#.#.###.###....####.#.###.#........#.#...####..#..#
.....#...#...#.....#.....#.#.........#.......#.....#............
.##.....###..####..#.#.#.#........##.#...##....#.#....###.####..
.......#...#.......#...#.#.#.....#.#...#.....#.#................
.###.##..#.#.#.....#.#.#.#...#.#...#.#.###.#.#.#.#..#..###.#.#..
.........#.#...#.#.............#.....#...#.......#..............
...#...#.#...#...#.....#.###...#...#......#.#..#.##..#.....#.#..
...............#...........#.#.#...#...#.....#.....#...#.......#
...#.#....#..#.#.#...##.##...#...#..##.#..#..#.....###.#.#...#.#
.#.....#...........#.....#.....#...#.................#.......#..
.#..####.##.##.#.#....##.##.####.#.......#####..##.#.#.#.#.#....
.#.........#...........#...........#.............#...#.....#....
.#...#..##...###.#.#.#.##....###..#.#..#.#.#.###.#..###........#
.........#...#...#.......................................#......
.#.###.##..#.......##..###.....#.....##......#####.#.#.#.#####.#
...............#.#...............#..............................
.##....#.#.##.#..#.###.#.##....#.....#.#....#...##.###.#.#.###.#
...#.#...#...#...#.#.#.#.....................#.#..........S.....
.#....####...##....#.#.#.#.#####.#.#..#.#..#...#...#..#....#...#
...........#.#.............#.....#.#.....#......................
.#.#..###......#..##.#.#..#..#.....###.#.#...#...##.....#..#....
.#...#.....#.........#.....#.#.......#...#...............#......
...#.....#.####....###..##...#.....#.###.#.#.#...###.#.#.#.#...#
.#...............#.........#.....#...................#.........#
....##.#..#.##..##...#.....#.....####.###.###......###....##...#
.............#.#...#.#.......#...................#.#...#.#......
...#....#....#....#....##..#.#..###..#.#.#.........#.###.#..#...
.....#...........#...........#.#.....#.....#...#.#.....#.......#
.......#...##....#....#..#.#.#.#...#.....#.#.#.#..###..#.#....#.
.....#.....#.......#...#...#.#.........#.#...#.........#.....#..
.###...#.#.......#.....##........#.#.#.#...#..##.....##..###...#
.#.............#.........#.#.#.....#.#...#.#...#.....#...#.#...#
.#..#..###.###.#...........#.#.#...#.#.......#......#..#.......#
.................#.............#...#...........#...#............
.....#.#.##.##.#.#....#......#.#..##..........##...#.#.##......#
.............#.#.....#.....#.........#.#.........#.#.#.........#
.###.......#.#.##......#.#..###.###.#....#..#...#....#......#...
.......#...#.........#.#.#.......#.....#.....#.#.........#.....#
.#...###..####.#...#...#..###....#.......#.#.##..#.#.#...###..#.
.........#.............#.......#.......#...#...#.......#........
#....###...###..#....#.....###...#.##...#........#.#....##.#...#
.....#...........#...#...................#...#.....#.#...#.....#
..##.#.##..#..##.##..#.##.###..#.#.###.....#...##..#...#.#...#.#
.....#...#.#.......#.........................#.......#.....#...#
.#...#.#.#.#.#...#.#.###.#.#.#...###...#...##.#..#..####.#...##.
.....#...#.........#.....#.#.....#.........#.....#.....#.......#
.#....#...####...#....##..##.#...#.#####.#...#...#.##..#.####..#
...#...#.#...#...#...............#...............#.#...#...#....
#..#...###.#...#....##...#..##.#.#.#...#...#.#.....#......##....
...........#.........#...............#.............#.........#.#
####....#.#.####.#..#....##.####......####....#.#..##.#####..#.#
