16
.#.......#.....#
.#.###...#.##...
...............#
.###.......#....
................
..#......#.##..#
............S...
...#.#.##....###
.....#.....#....
......##..####.#
.....#..........
.##....#.....#.#
.....#.....#...#
.#....#.###..#..
..G#............
##.#..#####.#..#
