64
.#.............................................#.............#..
......#.##..####....#..#.#.#.#.########..#...#.#...#..##.#...#.#
.................#...#.......#...................#..............
..##.##..#...##..#...##...#.........##.......#...#.#.#......##..
.#...#.........#.........#.................#...#...#...#.#...#.#
##.###.#.##..#.###..#.#..#..##.#.....#.#.#...#.#.#.##..........#
...#...#.#.....#.#.........#...#...#.#...#.......#.........#....
..##.#..#..##..#....###....#.#.#.#.....#.##..#.##.##.#.#.....#.#
.#.......#.......#.........#.#.....#.......#.#.............#...#
......##.......#.#.#....#....#...#.#.###.#.....#..#.#.#..#.##..#
.#.................#...#.....#...#..............................
.#.#.#..##...#...##..#.###...#.#.##..#..#.#...#........#.##...##
.#.....#.......#.....#.....#...#.........#.....#.#.....#........
.#.#.#....####.###.#..##...#.#...#.#.#.....#.#.....#...###.#.#..
...#.#.......#.#...#.....#.#.#.........#.....#.............#...#
.....##..#..#..#.#..#..#...#.#...#.###...#.#...##....#...#.#.#..
...#.........#...........#...............#...............#......
...#..#.##....#..###........#.##.#.#####....#.##.#.#.##.#..##..#
.......#.........#...#.#...........#.............#...#...#.#....
###.##...#...#......#..#.#.#.#.#..#..##.##.##......#...#.....#.#
.................#.#...........#.....#.........#.#...#.......#..
..##...##.#.#..#.#.....#....##.##..#.#...#..##.....#.#.#.##.#.#.
.#...#...#.....#...#.#...#...#...............#.....#.....#.....#
....#..#.#.......#...#..##....#...##....#.##..####...#..#..#....
.......#.#.........#.#.#.........#.....#...#.................#..
.###.....#...#.#.#.....#...#.#..##.#.#......#.##.#...#.#........
...........#.#.....#.#.......#...........#.........#...........#
#....#..........#..#..##...#...###.###...#.#.###.#...####....#..
...#...................#.....#...#...#...........#.........#....
..#..#.#..#..#...#.#...###.#.#.#.#.#...#...#.#..#..######..#.#..
...........................#.................#.................#
.#..#..#..#..#.#....####...######..#...#.......#.#....###.#.##..
.......#.......#.#.....#.................#.....#.....#.......#..
#.###...##....##.#...#.#.#..##.....#...#...###.###.###..#.##.#..
.........#.........#...#.........#..............................
.#.#..#..#.....#.###.##..#.................#.#.#..#...#...##.#.#
...#.....................#.#.#.........#.#.....#.......#...#.#..
..#....#.....#.##..#.#.#.#.#...#...###.#..#...#.......####...#.#
...................#.#.#.....#.#................................
#....###..#.###......#.#.#.#.#.###.#....#.#....###.###.......#..
.....#....S......#...#.......................#.#...#...#.#.....#
#..#.#...##.###....#.....##....#.##.#..##.#..#...#.#...#.#.#.#.#
.....#.#.......#.....#...#...#.........#.....#.#.#...#...#...#..
..#..#...#...#..#........#.###.#...#...#.#..#.#..###...#..#..##.
.....#.#.....#...#...................#.#.#.......#..............
...#.#.#.#.#.#.#.###.#.....##..##.#....#.#.#...#.#.......#.#....
.....#.#.#.#...#...#.#.....#.......................#.........#.#
..##...#...##....#.#.#.###.#.#.#.....###.#..#...#.##.###.......#
...#.#.......#.#.............#...#.........#...#.....#.........#
....##.#.#...#....##.###.#.#...###.#.#.....#.........#.##...##.#
.......#...#.............#.............#.#.....................#
.#.#.#.#....#....#...###.##....#...##.....###...######....#..###
...#.#.....#.........#.#.....#.....#...#.....#...#..............
.#.#.#...#....#....#.#..#.##..#..#.#......#..#.#.#.......##..#..
.......#...........#.#...........#.#.#...#.#.......#.#.#.......#
...##.####.##..#...#.#.#..##.....#.#.......#.###.#........#..#..
.........#...#.........#.#...#...........#.......#.#...#...#....
.##.##.#.#..##..#..#.#...#......#.####......##...#.#.##.##.#...#
.........#.....#.#.......#.#.#...........#.........#....G..#....
.##.#..#....####.#.#.....#.####.#...#..#.....#...#...#.#.#..#...
.......#...#.#...#.#...........................#.........#......
.#.##...##.....#...##.##.#.##..#.#.#..##.#.##....#...###......##
...............#.............................#...#.......#......
.##..#..#.####...####.##..#.##..#........##.##.#.####.#..##..#.#
