16
.......#........
..#.#........##.
...........#...#
.##..##.....##..
...#.......#....
#..#.###..#..#..
...#......S#.#..
.#.#..##...#.#..
...........#.#.#
.#.#..##.......#
...............#
.#...#.....#.#..
................
....########....
.#G.............
#...##...##.#...
