64
...........#.....#...........#.......................#.........#
.#######...#.#.#.#.#.###.##...#######.###.##.#####.#.#.##.####.#
.......#.#.#...#.#.#.#.#.....#.....#.....#...#...#...#.#.......#
######.#.###.#.#.###.#.#.####..###.#.###.#.###...###...#.#.###..
...............#.....#.#.#.....#...#.#.#.......#.......#.....#.#
...#.#########.###.###.#..####.#.###.#....#######..#..##.#.#...#
.#.#...#...........#...#.#.....#.#...#.#.#...............#.#...#
...#...#.###.#####.###.#.#.###.#.###.#.#...#.#.###..##.###...###
.........#...#.....#...#...#...#.....#...#.#.........#...#.....#
.####..###..##..#....#.#####.##.###.#..###.#.######..##..#.###..
...#...#.....#.....#.#.#.......#.....#.....#.#.......#...#.....#
#.#..###.###.#.###.#.##..#.###.#.###.#######.#..#....#.#.#.#...#
.....#...#.......#.#...#...#...#...#.........#.#.#...#.#.#.#.#.#
.#.#.#.#.#.#....##.#.#.#.#...#..##.#.#.##..#...#.#####.#.#.#...#
.#.....#.#.........#.#.#...#.#.#...#...#.....#.#.......#.....#.#
.#.###.#.###..#######..#.###.#....#..#.#.###.#.#...#.###.#.#.###
.....#.#...#.#.......#.....#.#.#.#.....#.#.#...#.#.#.....#.....#
...#.#.###.#.#..##.#.#.#.#.#.#.#...###.#.#.#####.#.....#.#.###.#
.#.#.......#.#.....#...#.....#.......#.#...#.......#...#.#.....#
.#.###...#.#####.#.###..####.#.#####.###.#.#.#####.#.###...###.#
...#...#.#.#.......#...#.....#.....#.......#.#...#...#...#...#.#
####.#.#.#.#.#######.#...#.####..#..#.##.#.#.###.##.##.#.#.###.#
.....#...........#...#.#.......#...........#.........#.#.......#
.####.####..###..#.###.#######..#.####.#######.#####.....#.#...#
...#.....#...#...#...#.....#.......#...#...............#...#...#
.#.#.###.###...###.#..##.#.#.#.####..#####.#.##.####.###.#.##.##
.#.......#...#.#.#.#...#S#.#...#...#...#...#.............#.....#
.#####.#.#.###...#.###.#.#.#...#....##.#.######..#..##.#..####.#
.....#.#.....#.#...#.......#.#...#.....#.......#...#...#.....#..
...#.#.###...#.##..#..######.#################..####.###.#.###..
.....#...#...#...#.#.......#.....#...........#.............#....
.##..#.#.#.###.#...##.##.#.#####..######.###...#..#####.##.#.#.#
.....#.#...........#...#.#.....#.#.....#.#...#.............#.#.#
##.#...###.#.#.###.#.#.#.#.###...#.###...#..####.#########...#.#
...#.#.#...#...#.....#.....#.#.......#...#.........#.#.....#...#
.#####.#.#.#.##..##..#..####.#######.####.######.#.....#.##..#.#
.....#...#.....#.....#...#...#.......#...........#.#...#.......#
####..####.###.#.#.#.#.#.#.#.#.###.###.###.###...#.#.#.#...##..#
...#...........#.#...#.#...#.......#.....#.....#...#...#...#...#
.#..######.#.#.#.##..#..############.###.#######.#####.###.#.#..
.........#.....#.#...#.......#.......#...............#...#.#.#.#
.#####...##..###.#######...#.#.#.#.#.#.###.##.#..#####.###.#.#.#
.#.....#.#.....#.......#...#...#...#.#...#...#.#.......#...#.#.#
.#.#.##..#.##..##.####...###.#.#.#...###.#.#.#.####.####.###.#.#
.#.......#.............#.#.........#...#.#...#.#.........#...#.#
.#####.##..#.#####.#.###.#.###.#.###.#.#.###.#.#.#.#########.#.#
.#.........#.....#.#.#...#.......#...#.#...#...#.....#.......#.#
.#.#########.###.#.#.#.#.####.##.#.###.###.#########.#####.###..
...#.......#...#.#...#.......#...#.......#.........#...#...#...#
.##....#.#.#.#.#####.#.##.##.#.###.###.###.#...###.#.#.#.##...##
...#...#.......#.......#.#...#...#.......#...#.....#.#.#.......#
##.######..###.#.##..###.#.#.##..###.###.####...######.#######.#
.#.......#.#.....#.......#.....#...#.#.....#...#.....#.....#...#
.#######.#...##..#..####.####..#.#..##..##.#......##.#####.###.#
...........#.......#.......#.....#...#...#.#.#.................#
...#.###.#.#######.#.#####.#..##.#.#.##....#.#.###.###.#.#.#.#.#
...#.#...#.#.......#...#.......#.#.#.#...#.............#.....#.#
.#####.#####.#.#####.#.#.....##..##..#.#######.#####...#######.#
...#.......#...#.......#.#.#...#...........#...#...#.#.#....G#.#
.#.#.#.#...##..#.###.##..#.###..##..##.....#..##...#.#.#...#.#.#
.#...#...#.#.......#...#...................#.#...#...#.........#
..####..##.#.####..###.#############.####..##.....#.##.#.##.###.
.......#.....#.......#...............................#.........#
######..##.##.####.##.#.##.######.##..######...##########.####..
