32
G..#.......#.#.....#.........#.#
.###.###.#.#.#.###.#...#.###.#.#
.#...#...#.#.....#.....#...#.#.#
.#..##.###.#.###.###.##.#..#.#.#
...#.#...#.....#...#.#.....#...#
.###..##.##.##.#.#.###.#######..
.#.....#.#.......#.....#.....#.#
.#..#..#...#..###..#######.#.#..
...#...#...#...#...#.......#....
.#..#.##.#...#...###...#.#...###
.#.......#.#.#.......#.....#...#
.#.#.#.###.#.....#####.#######.#
.#.#.....#.#...........#.......#
.#.#.#####.###.#.##....#..####.#
.#.#.........#.#...#...#.#.....#
.#..####.#####.###.###.#...#####
.#.....#.#.....#...#...........#
.#####.#.#.####..#.#.###.#.#.#.#
.#...#.#.#.....#.#.#.#.....#...#
.#.#...##..#.#.#...#.###.##..#.#
...#.#.#...#...#.#.#...#.....#.#
#####..#.###.#.#.#.##..#####.#..
.......#.........#.#...#.#...#.#
.##.##.#.#.###.#####..##.#.#.#.#
...#...#...#...#...#...#.#.#...#
.#...#######.###.#.###.#.#...#..
...............#.#.....#........
.#####.###.##.##.#.######.##.#.#
.....#.......#...#.#......S#.#.#
#.#..###.###.#..####.###.#.#...#
.......#.....#.........#...#...#
.#####.###.################..###
