16
.......#.......#
.####..#..#..#.#
.#.....#.#.....#
.#.....#...#...#
.............#..
.#.#..###..#.#..
...#.#S....#....
.#.#.#.#.##..#..
...#.#..........
#....###..#..#.#
...#.......#.#.#
..#..#.#.#...#.#
...#.#.#.....#.#
.#.#.#....##....
.#............G#
...#..###.#.#...
