32
.......#............G..#.......#
##.###.##...#########....#.####.
...#.#.....#...........#.#.#....
.#.#..##.##....#.###.###.#.#...#
.#.......#.......#...#...#...#.#
.###.#.###.##.####.##..#...#...#
...#.............#.......#...#.#
##.#####.#...#..####.######....#
...#...#.....#.........#.....#..
...#.#.###..##.#.#.###.#.###.#.#
.#.........#...#.#...#...#.....#
.#.####....#.###.#.#.####.##.#.#
...#...#...................#...#
..##.#.###.#####...#######.#.###
...#.....#.#.....#...#...#......
.##..###.#.#.##.##.#.#.###.#.#.#
.#...#...#...#.#.....#.......#..
.#.##..#.#####.#.#.#.###.#.###.#
.#...#.....#.....#...........#.#
..#..###.#.#.###.#.#.#..##.##...
...#....S#.#...#.....#.....#...#
#..#.#.##..#.#.#######.#..##.#.#
...#...#.#...#.#.....#...#...#..
.#####.#.#####.#.##..##.....##.#
.#...#.........#.....#.......#..
.#.###.#########.#.###.#.#.....#
.....#.#...#.....#.#...#...#....
.#.#.#.#.#..##.###.###.##..#.#..
.#.#.#.#.....#.#.#.....#.#.....#
.###.#...###.#....######.###.#.#
.....#.........#...............#
####.#########.####.#.##########
