8
........
#....#.#
.....#G.
...#.#..
S#......
.#.....#
........
.#......
