32
..S#...#...........#...........#
.#.......#......#.....##..##....
.#.....#...#...........#.......#
.#.#.#...#.#..##....#..##.##...#
.....#.........................#
.###..#......#.###.##..#...###.#
...............#.........#......
.#.#.#..######...##..#......###.
.#.....#.........#.#...........#
.#.#......#..##..#......##.#.#.#
.....#...#.........#.#.....#.#..
......##.#..#..#...#.#....##.#.#
.#.#...........#................
...##...#..#...#.###..##.#.#.#.#
.#...#.#.........#.........#...#
..#..........#.##..#.##..#.#....
.............................#..
##..##.#...###.#.#.....#...#.#.#
...............#...#...#...#.#.#
...#...###.#...#.##..#..#..#.#.#
...#...#...................#.#.#
.....#.#.#.###.##..###..#.##...#
.#.#.............#.....#.....#.#
.#.#...#...#...##......#..##.##.
.#.#.......#.#.#...#.#..........
.#...#.#...#...#...#..##...#.#.#
.....#.....#...#.....#.........#
.##.#...##.#...#.###.#.###.#.#..
.......#...#.....#...#.#.....#.#
..##......##.#.###.#.#...#.#....
..................G#...#...#....
#.#.##...#..#####..##.#.##...#.#
