64
.....#...................................#.....................#
.#...#.#.#.....##..##..#..#..#.#...#.###...#...#.#..####...#.#.#
...#...#...#...#.........#.........#...#.#.#.....#.#............
..###..#.#...###.#.....##.###..........#...#.....#.#..###....#..
.......#.........#...#...................#...#.................#
.#...#.#.#...#.....#...#.#.###.####..#...#..#........#........#.
.#.....#...#...........#.#.........#.......#.....#.........#....
...#...#.#..#...#.#.##....####.###.#.#..##.....#.....#.#.#..#..#
.........#...........#.......#...#...........#...........#......
..#.#.#..#...#.#...#...###.#.#..#..#.#.#..##.#..##..##.#.#.....#
.........#.......#.#.......#...#...........#...#.........#.....#
.#.#.#.###.....#...#...##.##...#.#.#.##.####...#...####....#....
.....#.......................#...............#.#.........#..S#..
.#....##..##.....#.#.##....#...###.#..#.####..#..#...#..#...#...
.#.#...........#.......#.#.#...#...#.......#.........#.........#
.#...#.##...##.#.##..#.#.#.##..#...#.#..####.....#..#....#.#.#..
.#...........#.......#...#...#.......#.......#.....#...#.......#
...#..#.##.#.#.#####....#.##.#...#......###.#..#.#....##.##.##.#
...........#.........#.#...........#.#.........#.......#.#...#.#
..#.##...#........#..#.#.###.#.#...#.####..#..##...#.#...#...#..
.#...#...#...#.#.#...#.#...#.....................#.....#.....#..
...#.###.....#.#.....#..#..##..#.....#...###.#..#..#.###..#....#
.#...#...................#.......#.......#.................#....
.#......#.......#....##..##.......###......#...#.#...#.#.......#
...#...#.#.............#...................#.........#...#.#...#
.##......####....###..##..#.#..#.#.#..#..###.##.##.####..#..#...
.....#...#...............#.....#.#...........#.................#
..##..#....#......##.....#.#..#....##..##....#.#.#.#.###.....##.
.........#.#.#.............#...#.........#.....#.........#.....#
....##.#.....###..#.......#.....##.....#...#.#.#...#.###...#....
.#.#.........#...........#...........#.......#.......#..........
...#..#....#.....#...#.#.#.##...#.#......#.#.###....##.#.#......
.....#...........#...........#.........#...#...................#
.###.#.###...#.....#.#.#..#..#.##....###...#.#.#.###...#...#.#.#
.............#...#...................................#..........
.#.#..#.##...#.##..##...##..##.#.....#.#.#.#.#..##.#.#.#...#.#.#
...#.........#.........................#...#...#...#...........#
.##..###.#.#...#.##..#..#....###.#.####.##...#....#..#.#..#...#.
.......#.#.......#.#.........#...#.#.......#...#...#.#...#.....#
##.#.....##..#.#.#...#......#..#.#...#.#..#..#.###...#.#........
...#...#.....#.#.....#.....................#.#...............#..
.###.#..##.#..##.#.###...#...........###...#.##...#.##..##.#....
...#.#...#...#...#.....#.....#.......#.....#.....#.......#......
#........#...#.#.#...#.#........#....#...#.##.....##.#.#...#....
...#.#.....#...........#.#.....#.....#.....#.........#...#...#..
.##..#.#.#.#.#.#.#...#.###...#...###..#.##.#....##...#.#...#...#
...............#...#.#.........#.....#.....#.#.#.......#.#.....#
...##.#......#.##......#..#.####.#.#.#.....#.#....##.##..#..###.
.........#.#.....#...#.........#.#.....#...........#.#...#......
.#...###.#.....#..#...###....#.#....###..#####...#.#...#...##..#
.........#.....#.............#.#.....#...........#.............#
.#.#..###.##.#.....#......#.#..#...#.#.###...#.....##.#.....##.#
.#.............#.................#.............#.#.............#
..#.#.#....####..#...#.#..#..##.#..#######...#.....###.#.#.###.#
.....#.........#.#...#...................#.......#.#.....#.....#
.#...#..#....##....#.....#.....#.##......#...#.#...#..#.##......
...........#.#...............#.#...#.#.#...#.#...#.#.#.......#.#
#....##..#.#.#.#.#.#.##..##..#...###...###.#..##.#.....#..#..#.#
.....................................#G....#.#.........#.......#
...##.###....#.#..##.##....#...#......##.#...#.........#.#.###..
.....#.......#.......#...#.................#.#..................
...##..#.#...##..#...#..#..#.#..#.#..#.......#.....#..#..#.....#
.......#.................#...............#...........#..........
.....#.###.#..#..#..#....#.#.#....#...##..#..##.#.####.#.#...##.
