64
.........#.............#........................................
...#..###..#####......#....#..##..##.#####.#..##.##...##.#......
.#.#.............#.....#...........#.#...#.#...#.#.#.....#......
.#.#.#.#.#.......#.##..#..#..#.#............#..#.#.#.....##....#
.....#.............#.....#.....#...#.....#.....#...#...#...#.#.#
.##.##.....#.#.##..#...#.#...#.#.#...#.#..#..#...#...##....#.#.#
.....#...#.....#.....#...#...#.....#.....................#...#..
##.#...#.#.#....##...#..#....#.#...#.#..##.##.....##.#...#.#...#
...................#.......#.#.......#...#.........#.....#.....#
.....###.###.#..#.#.##.##......####..###..##.......#.##.##.#....
...#.#.......#.....#...#.#...#.............#....................
.#.#.#..##...#.##..#.#.#...#..#.##.#.#.......#...##........#..##
.....#...#...#.................#.......#...#.........#.#........
.#..##.........##.####....##.........#..##...#..###.#.....##...#
.........#...#.....................#...#...#.....#.....#........
...#.#..####.....###.....##........#.#.....#...#............#..#
...........#...#.......#.......#.....#.............#.#.........#
..##.....#.#.##.##...#.#.#...#....#.#....#.....#.#.........#...#
.#...............#.............#.....#...#......................
.#...#...#.......#.....#.#...#.#.#.#.#.#.#.....#..#..#...###....
.......#.......#...#.#.......#.#.....#...........#.....#S.......
.#.###.....#.#.....#...##.........##..####.#..##...##..##..#####
.......#...#.....#.........#...............#.....#.......#.#...#
.....#.###.#.##..#.#.#.#.#.....#.#.####..#.##........###.#...#..
.#.#...#...#.....#.#...#.......#...#.......#.#.....#.....#...#..
#..#.###.....#...#...##..#.#.#.####..#.#.....##.##..#....###.#.#
.................#.#.......#...........#.#.............#........
..#..............#.#.#.###.#.........#.#....##....###....#.....#
.............................#.#...#.#.........#...............#
..#..###....#....#.#..#....#.#...##...##.#.#..#....#...###....#.
.......#.....#.................#...#.....................#.#....
###..#..###..#..#.##.######.....##...#.##.#....#..#.#..#.##....#
.......#.....#.....................#.#.......#...#.....#.....#.#
.................#.......#.......#......#.#...#.#.##.....#...#..
.#.#.....#...#.....#.....#...........#.#.......................#
#....#.#.###.#....#...##.#.....#...#...#.#..##....##.##....#..##
...#..G..#.....#.....#...#.....#...#.......#...#.#.............#
...#....##..##...#...####..#.#.#......##.#.......#.#....##.#..#.
...#.......#.....................#.#.................#.........#
.###.....#.....#.#.#...#.....###.#.#.###.#####.#......##.#.###.#
.......#.....#.......#.........#...#...............#.#...#.....#
##...#.#.#.#..##.#.#.#..#....#...#..#.##..#.#.##.##.##...##....#
.........#...........#...................#.............#.......#
.###...#.##.....##.#.....#...#..##...#.#.#...#..#....#..#..#...#
.............#.....#.....#...#.....#...#.#.#...........#........
.#.....#.#.###.#.#.#...#....#.##.#.#.#...#.###...#.......###....
.#...#.#.#.....#.#...#...............#.#.#...#...........#......
..##....#...#.#..###.#.#.#.......#.#...#..#..#.....#...##..####.
...........#.....................#.....#.....#.#.......#...#....
.#.......#.#...##......#....#.......##...#.#.#...####....#.#...#
.............#.........#.......#.....................#.#.....#..
.##.#..#....#..#.#.##..#.####..##..#...#.#.#.#.###.#..###....#..
.....#.......#.#...#.....#.......#.................#.#..........
##.....#.###.#.#####.#.##..#.####.....##....##.##....#.#..##...#
.......#.................#.#.#.....#.#.....#.......#.........#..
.#.##..#.#...#...#.#.#...#.#...##....#.###....#.##.##.##...#...#
.#...#...#.....#.......#.#...#.#...#.......#.#.....#.....#...#..
...#.#.#...#......#.#.##.#.##......#.#.....#.....#.....#.##..#.#
.......#.................#.....#.#.....#.#...#.#...#.#...#.#...#
...#.###...#...#..#.#.####...##..#.#..##.#.......#...#.#.#...#..
.........#.#.#...#.......#.#...........#.......#.#...#.#.#.....#
.#.#.###.#....#..#...####.....###..#.#.....#.....#.........#.#..
.#...........................#.......#.........................#
###.###...#####.#...#..#.#.#.###..#.##..####...####....#.##..#..
