16
.#.........#...#
.#.#.####....#..
.#......S..#...#
..##.#..#.####..
...#.....#.....#
...#.#.#.#......
.#.#.......#.#.#
.#.#.#.###.#...#
.#...#...#.#....
.#.###.#.#.###.#
...#.......#.#.#
.#.#.###.#.#...#
...#.........#..
.#..##....###..#
....G..#........
#..#####.#####.#
