16
............G..#
.#....####...#..
.#.#............
##.#.##....##...
...#.#.......#.#
...#...###.#....
.......#...#...#
.......#....#...
.#..S#...#.....#
.#.#.#...##.....
...#............
...#.#.#.###....
.#...#.#.......#
.#.#.###.....#.#
.........#.....#
###.#..#...#####
