8
......G.
.#.##.##
.#......
.###.#.#
..S#...#
...#.#..
.#...#.#
##.#####
