64
...................#.............#...............#...#..........
.#..####.#.##.##.#.#####.#.#..#...###.##.####..###.#.#.#..#..###
...#.....#.#.#...#.......#...#.........#...........#............
...#.#.#.#.....#######.###.#..########.#....##.#.###.#.###.#...#
.#.#.........#...............#.......#.......#.....#...........#
...#..#..#.......#.####.####.#.#.#.###.#.#.#.#.#.##..###.#.#.#.#
...#.....#...#...#.#.........#.#.#.....#...#.........#.......#..
.##..#.#.###.###.#.....#.#.###.#.#..###..##..##..#.##..#########
.#.#.#...#.#.#...#.#...........#.#.#.............#...#.#.......#
.#...####..#.#...#.###.#########.#.###.#.##.##.###.#.#.#.#.###.#
.#...#.................#.......#...................#...........#
....##.#.#####.#.#.####..#.#.#.#.###.#..###..#..##.##.###..#.#.#
.#.#.....#...#.#...#.....#.....#.#.........................#...#
.#..#..#.#.#.#.#..####..#.###..#.#########.#.#.#.###.#######.#.#
.#.....#...#...................#.....#...#.....#.#...#.#.....#.#
.####..###.#.######.#...###.#.####.#.#..##.#...#.#.###.#.###.#.#
.........#.#.....................#...#...........#.........#.#.#
.#..#..#.#.#.#.#.###.###.###.....#.#####.########.....####.#.#..
.#.#.....#.............#...#.#...#.#.........#...#...#.....#...#
.#.##..#...#.#.##.###.####.......#.#.#...#####.#.##.....#.....##
.#.....#...#.#.#.....#.....#...#.......#.#.....#.....#...#.#.#..
...##..###...#...#...#.#.##.##...#...#..##.###.#.#..####.#...#..
.......#.#...........#.............#.#...#.#.....#.....#...#.#.#
.####..#.##.##.....#....##...#...#.#.###...###.###..##.#.#.#...#
...#.............#.#.......#...........#...#...#...#.....#.#....
#....#####.#....##.#.#.#..#.########.#.#..##.#.#..##.###.#.#.#.#
.#...#.#.........#.#.#...#...................................#..
..##.#....###.##.#...##..#.#.##..#.###.####.#...##..####.#.#.#.#
.......#...#.......#...#.......#.......#.....#.............#....
.#####..##.#.###.#.##........###...#.#.#.#.#.#.#....#....#.###..
.#...#.........#.#.#.#.#.......#...#.#.#...#.#...#...#.#.....#..
...###.#.#.###.....#.#.#..##.#.#.#.#.#...#.#.#.#.#.###...#.#...#
.#.......#...#.#.#.#.#...#...#.....#.....#.#...#.#.#....S#.....#
..#####..#.#.....#...###...###.#.#.###...#...#.#.#.#.....#..##.#
.....#.#...#.#.................#.#.#...........#.#.#.#.#........
.#.#.#.####..####.##.#...#....##.#.#...#.###.#.#.......#.##.#..#
...#.#...............#...#.#.................#.#.......#.......#
####....#.#.###.###.##.#.#.########...##.#.###.#.#.#.#..##..####
.......#.........#.......#.#...#...#...#.#.......#...#.........#
.##.##...#.###.#.##..##....#.#.#.#...#.#...#...#.#.#..####..##.#
.#...#.#...#...#...........#.#.........#...#.......#.#.#...#...#
.##........#..###..#.#.#####.##..####.##.#.#...##....#...###.#.#
.#...#.#.#.#.#...#.....#...#.....#.......#.#.......#...........#
....#..#.#.#.###.#....##.#...##..###..#..#.#####.#.#.####.##..#.
.#.....#...#.........#...#.....#...#.............#.#...........#
.###.#.#...###..##...#.#.##..#.###.#.#.#..######.#.#.##.#.#..#.#
.......#.....#...#.#...#...#.#.#.................#.#.....#.....#
.###.#...###..##.#.#.##..#.....#.#.#.####.#####....#..##.#.#.#.#
.#.#.....#.....#.#.#.....#...#...#...#.........#.......#.......#
.#.#.#...#.###.#...#...#####.##.#..#.#.######....#######.#.#.#.#
...#.#.#.#.#...#.....#.....#.#.......#.........#.........#.....#
#....#.#.#.#.#...#...#####.#.#..######.###.#...#####.#...#.#...#
.#.#.......#...#.#.#.#...#.#.....#.....................#...#...#
.#.#.....#..####.#..##...#.###.#...###...#.#####.......#...#.###
.....#.....#.....#.................#...#...#...........#.#.#....
.#.#.#.####..##...##.####..#.###..#..#.#.....#.##.####.#.###.#.#
.........#...#.....#.........#...#...#.#.#.#.........#.#.......#
##..####.#..##.#.##......#.#.#.#.#.#.###.#...#.#.....#..######..
...#.........#...................#...#...#.#.......#.....#.....#
.###.#...#.#.#.######.##.###.#.#.#...#.#.#.#.###.##.#......#####
G....#.#.#...#.....#.............#...#.........#...#.....#.....#
..###..#.#.###.....#.###.....#.##..#.#####.#...###.#.#....##.#.#
.......#.............#.............#.............#.............#
..##...##..##..##.#.####.####.#.#.####.#.##.#####.##.#####..#.##
