16
...............#
.#.#.....#.....#
..S....#.....#.#
.....#.###.#.#.#
.#...#..........
.#.#.#.....#...#
.........#.#...#
.........#...#..
.............#..
.#.###.##.##....
.#.........#.#..
.#...##..#.#...#
.....#.....#....
..####..##...#.#
........G.......
....####.......#
