64
...#...........................#.......#.#.........#.......#....
.#.#.#.#.#..#.....##.#...#...#.#.##....#.#...#..##.#..#....###.#
...#.#.#...#.......#...#.......#...........#.#...........#...#.#
...........#.#.#....##...##..#.#.#.##...##...#.##.#.#...#..#.#..
...#.....#.#.#...#...........#.....................#.......#...#
..#..#.#...#.##...#.#.#.#....####.#..#.#.#....##...#....#..#.#..
...............#...........#....................................
.#.#..#..#.#.#.#..#..#..#.#....#####.#.#.#.##..#...#...#.#..#..#
...#...#...........#...#.......#.....#.#...#.....#...#.#...#....
.###.......#........####.#.###.##......#..#.###..#.##....#...#.#
.......#.#.......#.#.........................#...#.............#
...#...#.##..#..##....##..#.##.#.#..##.#####.....#.#...#...##..#
...........#.#.....#.......#...........#.....#..................
..##.#...#.#.....###..#..#.#####..##.##..#.....###..##.....##..#
.............#.....#.....#.#.........#.....#...................#
.#....##.#.#.##.#....#.#.....#.#.....#..##....#...##...##..#...#
.#...................#...#...#.....................#.........#..
...#.#..#....#...###.#....#..##..#..#...##..#..#.#####.#...#.#.#
.............#.......#.#.........#...................#.........#
.##..#..#....###.##.#..#.#...#.#...###.#.#####....##...#.#.#.#.#
.....#...#.#.........#.....#....S#.#.............#.....#.....#..
.#.#.#...#.#.#..#..#.....#...#.###.#.##..#..#..#...#...#.....#..
...#...#.....................#.......................#...#...#..
.#.#....#####.....##...#.###.#...#.#..#....#.##...####.#.#.###.#
.........#.......#.....#.......#.....#...#...#.........#.......#
###......######.##.###...#..#..####.....##.#.#..##..#....#.#.#..
.....#.........#.....#...#...............#.#.............#.#....
..####.#.....#.#......#..#.#..###....#...#...##..##............#
.........#.....#.....#.......#.......#.#...#.....#.....#...#.#.#
.#.....#.###.....#...........#.#...#...#....###......#.........#
.............#...............#.........#.........#..............
..##..###...#.....#..#.##..###.#.#.#...#.#...###.##............#
.#.....#...#...#.#...#.#.......#.........#.........#...#.......#
.#.#..##.###.........#...#.#.....#.....#.#..##.###.##....#####..
.........#.......#...#.................#.............#.........#
....####.#.#####...#.#...#.#..#..#.###...###.........###..#.#..#
.........#...........#...#...........#.#.................#.....#
##.##..##..#.....#.#.#....##.....#.....#.##.....###.....#...#..#
.................#.............#.....#.............#.......#...#
.#...#....###..#....##.#.#...#.#.....#.....#####...#....####.#..
.....#.#...........#.............#...............#.........#....
.......#.#.#####.#.#..##.##..#...###.###...#...#...#.##.##..##.#
...........#.#...#...........................#...#.............#
.###.#.#...#.#...#..##...#.#..#..#.#......###....#.#.#.##....###
.#...#.....#.....#...#.#...#.....#...#.#...................#....
#.......########.#.#.........###.#..#..#.#.#...###.##..#.#..##.#
...............#.........#.......#...........#.............#....
...#.#..##.#.#..#..#####...###...#.#..##.##..#####.#.#.#..##.#..
.#.....#.#...........#.....#.#.......#.............#.#.......#.#
.#####.#.#.#..#...##.#.###.......#.#...##...##....##...#.#.....#
.......#.#.#.......#.#.............#...#...........#.....#.#.#..
.###...#.#.##....#.#.#.###.#...#.#...#.#.#.......#.#.#..#.#..#..
...#.#.#.#...#.#...........#.....#.#...#.....................#..
..........##...##.#.#..#...#..##.###...#.....#.#...#..#..#..##.#
.......#.....#.........#.#...#.#.......#...........#...#...#...#
.#.###......#.##..##.#...#.##...#.....#...#..#...#.#...#.....#..
...........#.............#.....................#.....#.....#....
.###.........#...#.###...#.#..#.........##.#...#.#.#.....#...#..
....G..#.........#...#.......................#.......#.......#.#
.#.##..##..#...#.....#..###...##....##...###.#.###...#..#.......
.....#...#.........#.............#.......................#...#.#
..#...##.#....###.##..#..#.#..##.#...#...#..##.#.....###...#.#.#
...................................#.......#....................
.#..#.###...####....#....#.#.###.#...####.##.#.##..#..#..#...##.
