8
........
.#.#..##
.#....G#
.#####.#
........
.###.#.#
.#S..#.#
##.###.#
