32
...............#.....#...#......
.######...#.####.###...##.....##
...#...#.#.........#.#.#...#....
##...#.....##.#.##.#.....##.##.#
.#...#.#...#.....#.#.....#G..#.#
.#####.##.#...##...#.#..##.#...#
.......#.#...#.......#.#...#.#.#
.#####.#.#.....######..#...#.#.#
.....#...#.#.................#.#
.###...###.#.#..####.#.###...#.#
...#.#.#...#.....#.....#...#.#.#
####.#.#.#...##..#.#.#.#.###.#.#
.....#.#.#...#...#.....#.#...#..
..##...#.....#.#..#.#..#.....#..
.#.....#.#.#.#...#..............
.#...#.#.#.#.#.#...#......####..
....S..#.#.#.#.....#...#........
.#.#.#.#...#.###...#######...#..
.........#.....#.#.......#...#.#
##.#######...#.#.###.#####.###.#
.#.....#...........#.#.........#
.#..##.#.#####..#.##.#...#.####.
...#...#.#.....#................
.#...###.#.#.#.#.##......#..##..
.....#...#.#.....#...#.........#
..##.#.###..##.#.#...#.####..#..
.#.......#.........#.#.........#
.#.##.######.###.#.##....#.###..
.#.......................#.....#
.###..#....###.#.#.##.####.###.#
.........#.....................#
#..#.####.#.#...#.##..##.##.#.##
