8
......G#
.#.###.#
.#.#...#
##.#.#..
...#...#
..##...#
..S.....
###.##..
