16
.........#......
....###..#.###.#
.#...#.....#...#
.###.####..##..#
...#.#..G....#.#
.#.#.#.####...#.
...#.#.#...#...#
..##.......###.#
...#.........#.#
.#######.##.##..
.#...#...#.....#
##.#.#.###......
...#.#.....#...#
.###.#.#######.#
..S#...#.......#
#####.##.#######
