16
..............G#
.#...#...#..###.
.......#.#......
..##...##..#.#.#
.....#...#......
...#...#.#.....#
.#...#.....#...#
.#.##...#..#..##
.......#...#...#
.#........###...
.......#........
...#.#...#..##..
.....#.#.....#..
...###.....##...
..S......#.....#
##..#..##.####.#
