64
...#.......#...............#.....#.#.........#.......#.........#
##...###.#...#########.##....###...#.#.##.#....#.###.#..#.####.#
.....#.#...#...........#.#.#.#...#.#.#.....#.#.#.#.#.#.........#
.###.#.#..##.#..###.#.##...#.#.#.....#.##....#.#.#.#.#.#####...#
.#.....#.................#.#.#...........#.....#.#.#.#.#.....#.#
.#..###..#.##.####.....#.#.#.#.#...#.###.###.#.....#.###..##...#
...#.....#.......#.#...#...#...........#...#.#.#.#.......#...#.#
.##..#...######.##.###..#.##.#.##.####.###.###.#.#..####.#.#.#.#
.#...#.............#.......#...#.....#...#.#...#.#.........#.#.#
.#.###..##.#..##...#..####...#.###.#.#.#...#.##..###.#.#.#.#.#.#
.#...#..G................#...#...#...#.#.#.#...#...#...#.#...#.#
##.#.#.#......####.#..####.##.......##.#.#.#.#.##..#.#.#.###.#.#
.....#.............#.#...#.......#.............#.#.....#...#.#.#
.#..#..#...###...#..##.#.#.###.###.#.#...####.##.##.#####..#.#..
.#.......#.........#...#.........#.#.#...#...........#.....#....
.###.###...#.###.......#.##.####..##..#..#.#####.#.#.#.###.....#
...#.#.......#.#.....#.#.......#...#.....#...#...#...#.........#
.#.#.#.###..#..#.###.#.#.###.##.##.#...##.#..#.###..#..#.####...
.#.#.#.........#...#...#.........#...........#...#...#..........
.#.....#.#.##.##.....#.###.#####...##.###..#.###.##.#........##.
.......#.#...........#.#.............#.....#...#.#.............#
.#...#.#....#.#####..#.###...#.##..#.#....##.#...#..#..#.#.###.#
.........#...#.#.....#...#.#.........#.#.........#.......#.#...#
#..#.#...#...#.#...#..##.#.#....######.......#..##.#.#####.#.#.#
...#.#.#...#...................#.........#.#.#.#...........#....
.#.#.#...#.##..#.#.###.#.#..##.#.###...##....#.#..##.....#.#.#.#
.#...#.#...#...#.#...#.....#...#.......#...#.#...........#.....#
...#.###..###..#.###.#.###.#.#.#..####.#.###.#####....##.#.#.#.#
.#.#...#.#...#.#...#.....#...#...............#.....#.....#...#..
.#..##.#.#.#..##.#.#.##..#.#.###...#.###.#.#...###.#.#.###...#.#
.......#...#.....#...........#...#.#...#.......#.......#.....#.#
###..#.#.#.##..#.#..######.#.#...#..#...####.......##..#..##....
...#.#...#...#.#.#.#...#...#.#.#.#.#...#...#...#.#.....#...#...#
......##.#...#.#.#.#...#...#.#.#.#.###.#.....##..###.#.#.#..##.#
.....#.....#.........#...#...........#...#.....#.....#.......#.#
.###...#####.#######...#.##.##.#.#.#..##.#.###.#.#.#.###.#...#.#
...#.#.........#...#...#.#.........#.........#.#...#.#...#.#.#..
##.#.#.##.##.#..##.###.#.#.#...##....##..#.#.#.#.###.#.##....##.
.....#.......#...............#...#.........#...#.#.........#...#
.#.#.##.##.###.#.#.###..####.##..#..######.#.#...#..###.####.#.#
.#.#.........#.#.........#.....#.#.....#.......#...#............
.#.#..#.##.#...#.#.#...#.#.#...#.##......#.#.##..#...######.#..#
.........#...#.............#.........#.#.#.....#...........#....
..##.##.#.##.#.#.###.#...###.#.##.##.#..#..###........#..#.#.###
...#...........#...#.#...#.......#...#.....#.#.#.........#.....#
...#.##..#..####.....#..##.#..##.#.#.#.#.#.#.#.#.#.##..#.##.#..#
.#.........#.#...#.#.#.....#.....#.....#...#...#.......#.......#
...#.#..##.#...###.#.#.#.###.#.#.#####.#.###.#.#.#.##..#.#####.#
.#...#...#.......#.#...#.........#S....#...#.#.#.....#...#.....#
..##.#....#..#.#.#.##...##.#.....#####..##.#.#...###.#...#.###.#
...#.................#.....#.........#.....#.#.#...#.#.......#..
.#..#..#.#..#.####.#.######..#.##....#.#.#.....#...#............
.#.........................#.#.....#.#.............#...#...#....
..#..#..####.#.#.#.###....#...##.#...#.#...#.#.#####.#.###...#..
.........#...#.....#.....#...........#.#.....#.............#.#..
..##.#.#.#.###.....#.#..##.###.#.#.###.###.#.##..##...##...#.#.#
.......#.#.....#.#.....#.......#.#.....#...#.#...#.#.......#.#.#
.#####.###.###.#.#.#####.#####.###.#.###.#.#.#.#...#..####.#...#
.....#.........#.#.#.........#.....................#.#.......#..
.###..#......##.##.#.#..#..#...#####...#..#####...#..#.##.###..#
...#...#.#...............#.#.#...#.....................#.......#
..####.....###.#.#.###.#.#.#.#...#.##..#.###.##...#....#.#.##...
.......#.......#...........#...#.......................#.#.....#
.###.##....###.#.##.###..###.####..####.###.###..####.######.##.
