16
................
.#..##.#..####..
...........#..G#
...#.###.#.###..
.#.......#...#.#
....##...#......
...#...#...#....
....#..#...###.#
...#...#.#......
.....#...####...
...#...........#
.#.#...#..####..
..S.............
..#.##.#..##.#..
.....#..........
#.##.#...#...#.#
