8
.#S....#
.#####.#
...#....
.#.#.#..
.#.....#
..###..#
G.......
..##.#..
