8
......G#
..##.#.#
.....#..
.####...
.#S#.#.#
.#.#.#..
...#...#
#.###..#
