64
.......................................................#...#....
.#.###...#...#.##.#....##.......#....#.#.#.#...##.#....#.#.#....
...#.................#...........................#.....#.....#..
.#..........##....#.#..#.#.....#.....#...#.#.....#.#...#####....
.#.#.......#.......#...#.......#.........#.#....................
.#.#...##..#.#..........#..#.#.#..#.##..#....##.###..#####.....#
...........#.#...#.........#.#.................#.............#.#
...##..#...#...#####.#.#.....#...#.#...........#.#..##....##.#.#
...#...#.#...#.......#.....#.........................#.........#
...#..#....####.##.#.###..#.###.........#.##.#.#...#.#.....#...#
...#.#.................................#........................
.........###...###.....#.....##..............####....#...#..##..
.#.#.......#.#.....#...................#.................#......
......#..#.#.....#.......##.....###...##.#.....#.#.......###.#..
.....#...#.........#...#.#.......#...................#.....#....
.#.##..#....#.....#...##.#.#..##.#.....#......#.#.####..##...#.#
...........#S#.....#.....#...................................#.#
.##..#.#.#.....#....#..##...##....####.....###.#.#.#.....#.#.##.
.....#...#.#...#.#...#.......#...#.......#...#.....#.#...#.#...#
.#.##........###.....#####................#......###.#..........
.#.........................#...#...#.............#...#...#.#...#
.....#.#..##..##....###.#####..#....##...#.#.#.###.#.....#.#...#
...#.......#.....#.......#.......#...#.......#..................
......#..#...##..#...#......#.##...#..##.......#...#.#.#.##..#..
.....#...#.........#.......#.......#.........#...........#.....#
....#..#.#.#......##.#......#..#.....#.###.#.#.#...#.#.......#.#
.........#.........#...............#.#...........#.......#.#....
...#####...#.#.....#.###..#.####..#..#...#.#.###.#..##...#.#..##
.....#.......................#.#...#.......#.......#.#.....#....
#..#.......#.#.#.####..#...#.#.#.#..#....#.##.#..###.##.#.#..#..
.....#.......#.......#.....#...#.....#.......................#.#
.#.##..#.##..#.#.##......#.#..#..#.......#....##..##...#.....#..
...#...#.............#.#.#.........#.....#...........#...#.#....
...#...###.###.#.###...#...#.#.#....###..###...#...#...#.....#.#
...#.......#.............#...#...........#.....#.#.#.#.....#....
......#..#....#...##.#...#.#.###..#####....#..##...........#...#
.#.......#.............#.#...............#.....#...#.........#..
.#.....#...#...#.#..#........#.#.##.....##.#....#.#..#..#..#.#..
.#.........#.#.#.....#...........#.......#.#.............#......
...##..#.#.#.#.#.#......#.#..#.#.....#.##..#.###.#.###.....###.#
.#...#.#.......#.#...#.#.........#...................#.#........
.#...#...#.....#...#.#.....##...##.#.##.##.....###........#....#
.................#...#.......................#...#...#.........#
.#..##.#.#.####..###...###.#..##...#.#####...#.#...###..#.#..#.#
.......#.#...........#.......#.....#.#.....#.....#...#.......#.#
.##..#.#....###..#.#....#....#..#..##..####..#....##.#.##..#.#.#
.....#.....#.....#...#.....#...#.......#.#...#.............#....
...#.#.#.#...#.#.#..##.......#.....##.#....#.#.#...###.......#..
.......#.......................#.......#.#.....#.......#...#...#
.#.###.#.##..#####.....#.#..#..#..###..#..###..####.#..#...##...
.#.....#...........#.....#...#...........#......................
...##..#.##..#.......#...#.#....##...#.#.#.#.##....##.##.#.#.#.#
.#...#.........#.....#.....#.....#.......................#.#....
###..#######..#..#.......#.#...####..#....#..##.##...###...##.#.
...........#.......#.#...#.....#.....#..........................
.###.#.##..#.......#......##..##.#.....#...#...#..##...###.##..#
.........#.....#...#.......#.#...#...............#.....#...#....
..##....##.#.....##..#..##.#....###..##..#.#.#.....#...###.#.#.#
.....#.#.......#...............#...................#.#.........#
.###.#...##.#...###...####....#...##...#......###..#.#...#...#.#
.....#.............#...........#.#.#................G......#....
.#...#.#.#.#..#.##.###...#.#.....#.#.##..#..###.....###.#.#.#..#
.#...............#.....#...#...................................#
##.#....#.#.##...#..#.#...###.##...###.....#..#####.##....######
