8
..S#...#
...#.##.
.#.....#
.###.#.#
.....#.#
##...#.#
....G...
.#.#..#.
