8
......G#
##.###.#
...#....
.#.#..##
.#S#...#
.#.#....
...#...#
#.###.##
