64
.........#.#.............#.......#.................#...#.......#
.###.###...#.###.#.#...#....#..#.#.###.##....#.#.#...#.###.#...#
.........#.......#...#.#.....#...#.....#.#.#...#.....#...#.#...#
.#.#.....#.....#.#.###.#...#.#.#.###.....#.#..##.#.##..#.##.##.#
...#.....#.........#...#.....#...#.....#.#.......#.............#
.#.#.#..##.#.#.##.#...#.###.##.#.#...#.#.#.###.#.##..#.#######.#
.#...#.#.........#.........#.......#.......#...#.#...#...#.#...#
##.#.....#####.#.#..######.#.#.##...##.#.#...##....#.#.#.....##.
...#.#...#.....#...#...#.#...#.........#.#.........#...#.#.....#
..##...#.#.#####.###...#.##..#.#.#.#...#.###.##.##.#..##.#.##..#
.#...................................#.#.........#.....#........
.#########....#.##..#####......####.#...#.##.#.#.#######.###...#
.......#...#.............#.#.#.........#...#...#.......#...#...#
#...#..#...#.#.#...##.#.#..###.###.###.....#....#..#.#.#........
.....#.....#........G#...#.............#.#.#.......#.#.....#.#.#
.###.##....###..#.##.#.#..###.##..####.#.#.#...#.#.......#.#.#..
...................#...#.#...#.........#.#.#.#.....#.#.#.#.#....
.#####.#.....####....#.#...#.#.#.#....#..#...####.#..#.#.#.#####
.......#.......#...#.....#.#.#.#...#.#...#.#.....#...#..........
.#.##..###.###...#.###.#...#.........#.##..####....##.##.#.#...#
.#...#.......#.......#.#...#.........#.#.#...............#.....#
..#...######.###..##.#.###...#.###.###.....#.#.#.##....###.###..
.........#...#...#.#.......#...#...#...#.#...#...#...#...#...#..
####.#.#...#.#.###.#...###..#..#.###.###...#.....###..#..#....##
...................#...#.......#...............#.#.......#.#...#
.#....#..#####..#..#####..#####.##.#.###.#...###.#.#.....###.#..
.#...................#.#.........#.....#.#.#...#...#.#..........
..######.#.########....##.###..........#.#.###.#.###...#....##..
...#.............#.#...........#.........#...#.....#.#...#...#.#
.##...####...#.#.#.#...###...##..##.##...#.#.#..........###..#.#
...........#...#.......................#.......#.............#..
.#.#.##..#.#.#.#...###.#.########..#...#.#####..#.##.#.##..#.#.#
.#.......#...#.#.........#.....#.......#.#.................#...#
#..###.#.#.#....#.##.##..#.#.#.#.#.#.......##..##.#.####.#.###.#
.......#...................#.....#...#.#.#...........#...#.....#
..#.###..#.#.#.#..###..#.....#.##.#..#.#.#..##.#.#.#.##.#..####.
.#.....#...#.....#...#.#.....#.#...#...............#...........#
.#.#...###.###...#.#.#.#..#.##.#.#.#######.....#.###.###.#.##...
.#.........#.......#.#.#...#...#...............#.......#.......#
.#..#######..###.###.##....#.#.#...##.#.######.###.#.#.#.#.#.#..
.#.....#.....#...#.......#...#.....#.........#.....#.#.#.#...#.#
.#####.#..###..#..#...#..#####.#.#....##.#.#.....#.#.#.#....#..#
.#.....#.#.#...#...........#...#.#...#.....#.........#.#...#...#
...####....#.#.#.#...#..##.#.#.#.#..#..##.##...#.##.##..#..#....
.#.....#.#.......#.....#.......#.........#.........#...#...#.#..
.###.#...#.#..###..#####.##.#....#.####..#..##...##..##..#.#.#.#
.................#.......#.........#...#...#...#...#.#.#.....#.#
.#.#.......#.##.####.#...#.###..#..#.##..#...###.#.#.#.#.#.###.#
...#.#.#.....#.........#.........#.......#.#.......#.#...#...#.#
.##....#.##.##..##.##..#.#.##..#.#.###..##.#...##.##.#.##..#.#..
...#.#.#.......#.#.#...#.....#.#...........#.#.......#.....#.#.#
.#..##...#.#.##..#.#.#...#...#.#.#.#..##.###.##...####.##...##.#
.......#.....#.....#.#.#...#...#.....#...................#.....#
.....#...#.##.##.##..#.#..##.###.#.###..#..#..##..######.#.....#
.....#...#.........#.#.........#.#...............#.......#...#..
#..#.#.#########.#.#....#..#.#...#.#.#####.#####.#.#.##.###..#.#
.......#.........#.......#.............#.........#.#.......#.#.#
.###..##.#######.#..#.....##...###.#...#..#.##...#.##.####.#.#.#
.#.............#.#.....#...#.........#...#...#...#.......#.....#
...#...#.###...#...##.####.#######.#.##.#..#.##..#.#..###...##.#
...................#.....#...#.......#...........#.#.........#.#
.##.##...####..#.#.###.#.###...###.#.#.###..##.###.#.#.......#..
.......#.......#...........#.......#S........#.....#.......#...#
####...########..#####.####.####.#.####.###.#.#.#.##.#.#.####.##
