64
.......................#.................#.....#...............#
......#.#..##..#..#.#..#....##.##..#.....#...#.####........####.
.#...................#.................#...#.#.........#.#......
..####..###....#...#.#.#.#.#.#...#.#....####..#..#.....######..#
.......#...#.....#...............................#.#...#...#...#
....##.....#.#.##..##..#.#.....#.......##.###......#.##..#.#....
.......#...........#.....#.......#...#.......#G..........#......
#..##..#...###.#.#.#...#..###.##..........#....##.##.##....##...
.........#.......#.#.............#.#.#.....#....................
.#.#.#...#.#.....#.....##..#.#...#.....##...#.....#..###.#.#....
.........#.......#...#.#...#.................#.#................
.#.....#....##...#.#...#.#.#..#..##.##.#...##..#..#.#..#...#.#.#
.......#...#...#...#.......#.................#.#................
#....#..##..#.#....#.###...###..#.#..#...##..#..##..##.#.#.##.#.
...#.#.....#...#...#.....#.....#.............#.................#
.#.#...#.#...#...#########.##....#.##...##.......#.#.#.###.###..
...............#.......#.................#...........#..........
...#...#.#..#....#.#.#.###.#...#........##.....#.#.....#..#...##
...#.......#.#.#.....#.....#.#.............#.#.......#.....#.#..
.#.#.#.###.#.#.#..#...##..##..##..#..#.#.#.#.........##........#
...#.#.......#...#.......#.....#.........#...#.#...............#
...###.#.##..#.....#.#.###...#.#...#.#.#.#.#..##...#.##.#....#..
...................#.......#.....#.#...#.........#..............
.#####.#......#......#.#.#.#..#.#.#..#.....#.#...#.#.#...#.#.#.#
.................#.#...#...#.........#...............#...#.....#
.#..#.##..##.#.#..#..#.......###.#.....#.#.#....#.##...##.#.#..#
...#...#.............#...#.............#.............#.#........
.#.........#..##.......#.#.####.#.......###.##....#....#...#.##.
...#.#.............................#...........#.#..............
.#.#.#.......##.###...#.##......##.##...#........#...###....#..#
...........................#...#.........#.....#.#.........#...#
..##.....#.#.#..##.....#.#..#..#.#.##.#....###...#.#.#...#.#...#
.......#.......#.........#.....#.....#...#.#...#.......#.#...#.#
##.#.....#..##.#.####.##.###...#.#.....#.#.......###...#.##.....
.......#...#.....#...#.....#.....#.#.#.....................#.#.#
...#.#.#.#....#..#...#.........####..#.#..##....#..#.....#.....#
.....#.#...........#.........#.........#...#...#...#.#.#........
#.#....######.##....#.#........#.#..##...#....#..#.#....#.#.#..#
.................#.#.........#.#.......#.....#...#.#.........#..
...##..#..###........#.#.###.......##.#.....#...#........#...##.
...............#.............#...........#.....#.....#.#...#...#
....####..#.#........#...###.#.###.#.....###.#...#..#..#....#..#
.......#...................#...#...#...#.....................#.#
.#.##..###.###.....##............###.##..#.#.#...###.###........
.....#.......#...#.................#...#.......#...#.....#.#.#.#
.###.###.......#.##...#..###.....#.......##.#..#.....#.#...#...#
.........#.............#.........#.....#...........#...#........
.#..#....#.#...#.#..##.#....####...#.......#....#..#.#.#.....#.#
.#.....#.#.....#.#.....#...#...#.#...#...#...........#...#.#...#
.#.###.#...#..#..####.####.#.###...#.##..#.....#.###.#.#.....#.#
.......#...#.........................#...#.....#.......#.#...#.#
...#.####.#..#.....#..##.#.#...##.#......##....##.#...#......#.#
...................#...#.....#...............#.............#....
##.#.....###.....#...#...#.#.#...##....#...#..##..##.#.#.###.#..
.....#...............#.....#.........#...#.........#.....#.....#
..#..#...#####.##.####.#.#....#..#.###..#..#.#.....#.##....#.#.#
.......#.........#.......#...........#.....#.....#.......#.....#
##...#.....###.#.#......#.#..#...#.#...#...##......#.....#...###
.........#.#.......................#.....#.........#...#...#....
.###...#.#.....####....#..#.#...#...##.#.......##..##..#.#.##...
...........#.#.........#...#...#S#...#...#.....#...#.....#.....#
.#.##..#.#.#.#..##.....#...#...#.#.#.....#.###.#.#...#.#.#..#..#
.....#.....#.......................#...#.........#.............#
..#.#...###.##..##..###.#####....#.#.##.###.#.##......###.#.##..
