32
...#............................
...#..##.##....#.#########..##.#
.#.#...#.#.....#.........#.#..G#
#..#.###...#.#.#.##.#.#....#..#.
...#.....#...#.#.......#...#.#.#
.#.#.#.#.#.#.#.#.####..#.##..#.#
.#.#.#.#...#...#.#.....#.......#
.#.#...#####.#####.###..##.#####
.#...#.......#.....#.#...#.....#
.#..##.######.##.###.#.###.....#
.#...#...........#...#.#...#.#.#
.###..###..#.#####.#.#.#...#.#.#
...........#.#.....#...#.....#..
.##......###.#########.#######..
...#...#.....#.............#....
##.#..##.#####.#####.#####.#.#.#
.....#...#...........#...#.#...#
.#.#.#.....#####.####..###..#..#
...#...#......S......#...#...#.#
###..#.#.###.##.##...#.#.#.##...
...#.#...#.........#.#.#...#...#
...#.#####.#########.#.#####.#.#
.#...#...........#.............#
.##.#.######.#.###...#.#.#####.#
.#.........#.....#.#.....#.....#
.###.###.#.#####...####.#..###..
...#.....#.....#...........#.#.#
##...#.#.####..#######....##.#.#
.#...#.#.#...#.......#...#...#.#
.#####.###.#.#.#.###.#..##.#.#.#
...........#...........#.......#
#.#######.#.#.##.#..############
