32
.#.............................#
.#.##.#.####..##.##..###...#.#.#
.#.............#...#.....#...#.#
...#.........#.#...#.#.######..#
...#.#...#.......#...#...#...#.#
.#...#.#...###......####.#...#..
.#.....#.#.#...........#........
.....#.#..#..#.#..#..#.#.#.#..#.
.......#.........#...#.........#
##...###.#.#####.#.#...#.##.##..
...#.#...........#.#............
...#....###.##...#.###.###.##..#
...#.#.........#.....#.....#...#
.###...####.##.#.###.#.#.###..##
.............#.........#......S.
.#######.##.##.##....###..####..
.#...........#...#.......#......
.###.#...#.#.#..##.###.#.#...###
.#.....#...#.#.....#...#...#...#
.#.##..#.#.#...#.#...###.#.#.#.#
.........#.#...#...#.....#.#.#..
#..#.##..#####.#...#.#...#.##...
...#...#.......#...#.#...#...#.#
.#.#.#.#.#.#.#...#..#..#.###.#.#
.#....G......#...#.....#...#.#..
.#####.###.#.#..####.####.#..#.#
.#.......#.#.#...#...#.......#..
.#.#...#.###.###.#.###.#...###.#
.......#.#...#.#...#...#.......#
.....#.#...#.#.###.#.#####.#....
.....#.....#.....#.........#...#
.######.##.#...#.#####..#####..#
