64
.....#............G#...................#........................
.#.#.....#...#..##.#......#.......#.#..........#.#.#...#...##..#
...#.#.........#.#.#.............#...........#.#...#.....#.....#
.#.#..##.##.#..#.#..........##.#.......#.#.....#...###.#....####
.................#.#.........#.....#.......#.........#.#.....#..
......###..#..##.....##..#...###.....##..#.#......##.#.#.....#.#
...#.........#...........#.............#...........#.....#.....#
...#.##..#..##.....#...#.##..........#.###.#.......#.#.#.##.#.##
...#...........#.....#...........#...#...............#.........#
##...#...#.#.#..#..###.#.#.......##..#.##.....##.#.#........##.#
...#.#.....#.....#.....#...#...#...#.....#.#.....#...#.......#.#
.##..#..#.##.##.......#..##..#...#...###........##...#.#..#....#
.#.......................#...#...#.#.....#...#..................
.#...###.#.###.....###..#..#.#.#.#.....#.#.#......#####....#...#
...#.....#.....#...........#.......#.#.......#.#.............#..
.###.#.#.#...#..#..##.##...###..####...#.#.#.#.##.##.#.#..#....#
.......#.......#.........#...#.......#.....#.....#.............#
..#..#.#####.....#..#.###....###.....#.###.....#....###...#....#
.....#...#...#...........#.......#.#...........#...........#.#..
#......#...###.#.#.##.#....#.#.#.#..##....#..#.#.##...#..#...#..
...#...........#.#.#.........#.#.#.....#.#.#.............#......
.#.....##.###....#...#...#.#...#..#..#.#.#.#.......##.#......#..
.#...........#.#.............#.#.....#...........#.............#
.#.###.....#...#######.#.###...#.........#.#.#.##..###.##..#.#..
.....#...#.............#.......#.............#...#.........#.#..
.#.#.#.....#.##...#..#.#.......####....#.##....#..##.###.#####..
.....#...................#.............#...#.#.................#
.##.#..##.#.#.#....#..##...#.#.....#...#..#..#..#...#..#...#.##.
.................#.....#...........#.................#.#........
##...#.....#.#.#...#....##.#.###..###..##..#.#...#.#....##.....#
.......#.....#.....#.#...........#...........#...........#.#...#
.#...#.......#.#..#....#....##.......##...###..#.....#.#..#.....
.#.....#.#.........#...#.#.......#.#...................#...#.#..
..###.##..##.#.#....#....#.#......#..#..####.##....#######.....#
.....#.......#.......#.#.....#...........#...#.................#
.#.#....##.#####.........#.#..#.##...##..#.#..##.....##....#...#
.#.....#...#...........#.........#.....#...#.....#...#.....#.#.#
.#..##...#..#..#.#...###..#...##..#..###..#.###..#..#.#.##...#..
...#.............................#.............................#
#......#..##.#......#...#.####...#..#........#.#..##.#.#..##...#
.#.....#...........................#.......#.#...#.......#.....#
..#..#......###..#.........#..#.##...#####......##...#.#.#...##.
...#.....#.....#.#.......#.......#...#.....#...#.......#S.......
....#........#.#.###.##....#...#...#...##..#.#....#....###.#.#..
...#.........#.......#...................#.....#.#.......#.#.#..
.#...#.....#...##..#.#.......#.#.....##..........#.##.##...#.#.#
.....#.#.#.#.#...........#...#.....#.....#...........#...#.#...#
....#....#...#.....##.......#...#.##.#.##....#..#..#.....#.#.#.#
.....#.......................#.......#.............#.#.....#....
....##.#........#.#.##..##.#.##...###...#.###..###.#.##.........
.................#...#...#.........................#.......#....
.......####......#.#.#.#.#.##...#..####.##.#.#.#.##.#..#####...#
.#.....................#.#...................................#..
....##..##.#.#.#.#...##........#...#.#.....##..#.......#.......#
...................#...#...#.....................#...#.....#....
.#....#..##.######.#...#.#.....#.###....#..##.#.#....#.##....#.#
.#.#.................#.......#.....................#.........#..
..#....#.#....##.#...#.....#.#...#...#.....##..#.#.##....#.#....
.......#.................#.#...#.........#.....#.........#......
...##.##..#......#....#..#.##..#..#...##..##.###.##....#...#...#
.......#.#.....#.....#...........#...#.#.#...#.....#.........#.#
....###..#..##....##...###.#.##.##.#...#.#.#.#.#...##....#......
.....................#...............#.....#....................
#.#.#.#......#.#...##.#######...#.##...###.###..#....###......##
