64
.......................#.........#.............................#
.#.##..#.#...#.###.###.#.....#.#.#.#.#####...#####.###.....#.#..
.......#.....#.............#.......#.....#.........#.....#......
...#...##.#....#..#....#.#...#..#....#......##.#...##.#....#.#.#
.#..G#.....#...#.#...................#...............#...#.....#
.........#...#...#....####..##..##......##.#..#..#.....#.#.###..
.............#...........#.........#.#.....#...#................
...#.#...........#.#...#...#.#..##.#....##...###...#.#..######.#
.....#...#.....#...#...#.....#.....#...#.........#.#.#...#......
.##....##..#...#...#########.#.#.#....#..###.#.#.#...#...#...#.#
.........#.....#.#...............#.......#.............#.#.#...#
...#.###....##...#..#..#...##....#..#.#....#.#...#...#..#....#.#
.........#.....#...........#...........#...................#....
.#.....#.....#.#..#..#.....#.....#.#.#....##.#.#..#..........#.#
.#...#.#.....#.......#...#.#.#.................#.............#..
...#.#.......#...###...#.....#.#..#.###........####...#.##..##..
.#.........#.#.........#...#...#................................
#..###.#.#...#...........#.#..##.#.##...##.#......##.#.#.#......
...#...#...............#.#.......#.......................#.#...#
..##...#..#..#..#.#..###...#..#.#....#.####..#..##...###.....#..
.......#.................#.#.................#...........#...#.#
.#.#..##.#.#.#...#....##.#...#.#......##.#.#.##..#...#...##....#
...#.....#...#...#.#.............#.........#...#...#.#..........
#..#.....#....##..##.#...#....#....##......#...........#.#.#..#.
.......#.........................#.....#...#.............#.#...#
.#.....#...##............##.#..#.#.........###.#.....#...#..##..
.............#...........#...#.....#.........#.....#.#.#...#.#..
.##...###....#...#.......#.....#.##..###.###.#.......#...#.....#
.....#.....#...#...........#.#...#.#.......#.#.#.............#..
.#..##.#..##.......#..#....#.....#.....###....##..#..#.#.##....#
.#...............................#...#.....#.........#...#......
.#.#.....#.#...#######........#..#.###....#.#....###.#...#...##.
...........#.....#.....#...........#.........#...#.....#...#....
..##.#...#.####....#####...#.#.####....#.#.#...#....##.#..#....#
.#...............#.......#...........#...#.#...#..........S.....
...##..##........##..##..#.#.......#..#....#.#.#..#......#.#....
...#.........#.........................#.................#.....#
.##...##...#.##....#...##....#...#.#.#.#.#.#.#...##.###........#
.............#.......#.......#...#.#.....#...#.................#
...#..#......#.###.#....#..#.#.#..##...#..##....#..#.#..##.#.#..
.....#.....#.#...............#...............#.....#.#.......#.#
...#.#.....##..#.###.#...#...#...####.........##.###.#.#.##..#.#
...#...#...#...........#...#.........#.#...........#.#.#.......#
.#.###.#.....#.#.#.###...#.....###.#.#..###..#...#...#...####.##
.................#...#.#...........#.#...#.....#................
.#.....#...#.#.#...#.#...#.#.###.#.......#.##..##..#.#.......#.#
...#.#.....#...#.............#...........#...............#......
.....#.#.....#.......#.#...###..##.#.....#.#####...##...........
.#...#.#.................#...#...................#.............#
...........#.#...#...#.#.#.......#..#.###.#.#....####.####......
.........#.#.....#.#.#...#.#.................#.....#...........#
.#.........###...#...#..#....###......#....#.#.##..###.#..##...#
.............#...#...#...#.................#...#.#.............#
#.#.##...##..#.#.#...#...###.#..#.....#....####........###.#.#.#
.......#.....................#.......#.........................#
...#.........#.###.....###...#...#.#.....#.#..##.......#.#.###..
...............................#.............#...........#.....#
.##.####.....#.#.#..#....#.#.#.##..##.....#.#...#......#...#.#.#
...#.....#...#.........#.....#...#.......#...#.......#.....#.#.#
##...#.......#.#.....#...##...###..##..#....#....#####.#.###...#
.#...#.......#.#.......#...#.....#...................#.....#.#..
.###.#..##.###.#.#.......#.##.##...#....##.#....#..#.#..#..#...#
.......#.......................#...................#............
..###..#...##..##...#.#..#.##.........##.#..#..###.#...#....#.#.
