64
.................#....G................#........................
...#..####.#.#...#..#..#.#...####..........#.#...#..#..#...#.#.#
.....#.......#.#.#...#.....#...#.......#.........#.......#.#....
.###...#...........#.#.#..#.##...#.#.#.#..#.#.#.##...#.#.#..##.#
...........#...#.................#...................#.#...#....
.#.#......##...###..........###..##..#.#.#.#..#..##....#####....
...............#.......#...#.....#...#.......#.........#.......#
....#.########.###...#....#......#...#.#........##.#.#.#.#..##.#
...#...#.....#.......#.#.....#...............#.....#...#.....#.#
...#.#...###...#.....#.##..#...#.......#.#.#.....#.##..#.####...
.....#.....#.#...............#.........#.#...#.#.....#.#........
.#.#.#.#...#...#.#...###..#.#...#..#.#....##.#.#.##......#...#..
...........#.#.........#...............................#........
...#.#.#.#.#...#...#...#.#...#.#.....###....##.#.#.#..##...##..#
.........#.#.........#.......#.....#.....#.#...#.............#.#
##....###..###...#.####...........##..##.#.#..#.####............
.....#.........#.......#...................#...#.......#.....#..
.#...#...#.#...####.#..#...#######..####...###.....###...#.##...
.#...#.....#.....................#.............#................
.#.#...#.#....##...........#.#.#.#.#.#...#.#.#...#...#.....#.#.#
...#.....#...........#.....#...#.....#...........#...#.#........
....######.##.#..#......#..#..##.###......#.###.#...###..##....#
.#.........#...#.....#...................#...#...............#.#
...#.#.#.......#.###.#....##...###.#.#...#.#.#.###.............#
.......#...#...#.....#.........#.......#.......#...#.#.......#.#
....##.#.#.....#.#...#..##.#..##.###..##....####...#.#...#.#...#
.....#.#...........#.#...#...........#.....#.........#.....#...#
.#.#.#.#....########...#.###.....#####.......##.#.####.#........
.........#...................#...#.....#...#.........#...#......
.#.##..##..#.##...#.#..#.....#.#.....#.#####.#.##..#.##.##.#...#
.....#.#...#.....#.#.............#.......#...#.........#.....#..
.......#.................#.#.#.###...#.#...##....#...#...#.##...
.....#.......#...........#.....#...#.....#.............#........
....#..#.#.#.....#.#....##.#...........#..##.#....#..##......#..
.............#.....#.......#...............#.....#...#.....#...#
...#.#.###...#.#####.......##.####...####.#.####.#...........#.#
.....#.......#...................#.#...................#...#...#
..##.....#.#.#.###...#..#.#......#.#...#..##.#.##.#..##.......#.
.....#.......#...#...........#.#.........#...#.................#
.##..###.#.##..#...##..###.#....#..#.#.#.....#.##.#....#.##..#..
.............................#...#...#.....#...#...............#
......##..#..#.#.#...#..###..#.#.#...#.#...#..#......#..#.###.##
.#...........#.#.#...#.....#.........#.............#...........#
#..#.#.#.#...#...#..#.#..#...#.#.###.#..#.####..##...#.#.....#..
...#.....#.#...................#.........#.......#.#...........#
.#.......#.#.#...#.....#.####.##.###.#.#...#.###.#.###...###....
.#...............................#...#.................#........
.#..#..#...##..####..#...#......##......#..#.#.#.#.#..###..##...
.#.....#.....#.......#.#.#...#...#.....#...#.......#.#.....#...#
...#..#..#...#.##..#.....#..##.#.#.....#.#.#.#.##..#.#.#..##.#.#
.................................#.#.#...#.#...#................
....##...#.#####.#####.....#.#.....#.#.####..#.#.#.#...#.#.#####
.#...#.........#.#.........#...#.#..S................#..........
.###.###...#...#.#...#.#...#.#......##.....###.#.##..#.###.#....
.........#.......#.....#.#.....#.......#.......#.........#.....#
...#.#....#.#..###...#...#..####.###.#...##..#.#.#.#.#.#.......#
.#.......#.............#.#.#...........#.#...........#..........
.#...###...#........##...#...###...#......#..#.####....#.#.....#
.........................#...#.....#...#.#...............#...#.#
...#.#....##.#.#......##.#.###.#.#.#...#....#..#.#.######....#.#
...#.......#.......#.....................#...............#.#...#
....##..##...##..#....###.##...#.######.#....#...##..##....#...#
.....................#...............................#.....#....
#......#.##.#.###.#...####.....#####.#..###.###.....#.#.##.#.##.
