64
.....#...............#..........................................
.###.#.##..#.###.###.#.###.#.#.##.##.##.#..##..#.###.##..#.###.#
.#.........#.#...#...#...#...#...#...#...#.....#.....#...#.#...#
.#####.#.###.#..##.#####.#######.#####.#.######.####.#.#...#####
.#...#.#.......#.#.............#.......#.#.......#.....#.#.....#
.#.#...#.#.#####.#.#######.#.#.#.#.#.###.#.#####.#.##.#..#.###..
...#.#.#.........#.#...........#.#.......#.......#.....#...#...#
..##.#.#.###.#####...#.##..#.#.#..####.#.#.#######.#.###.##..#.#
...#...#.#...#...#...#...#.....#.#...#.#.#...............#...#.#
#......#.#.###.#.#.#.#.#.#.###...#.#.###...#.###.#.#.####..###..
.....#...#.....#.........#.#.....#.#.........#...#.#.....#.....#
.#.#..#.##.####.#.######.#.#####.#.#.##..#####.#.#.##.####.##.##
.#...#.......#.........#.......#.#...#...#.....#.#.............#
.#.###.#.##....#..####.#.#####.#.###.#.###.#####.#.##.####.#.#.#
.#.#...#.....#.#.......#...#.#.....#.#.#...#.#...#...........#.#
#..#.###.##..#.#.###.#...#.#.#..##.#.#.#.......######.####.#.#.#
...#.........#...........#.......#.#.....................#.....#
.########.####.###...##..#.#.###.#.#########.##.#######..###...#
.........#.....#...#...........#...............#...#...#.....#..
..######.#...###.###...#####.#..##.#.#####..##.....###.#.###.#.#
.#.#...#.#...#...#...#.....#.......#.......#.....#.#.......#...#
.#.#.#...###.#.#.#...###...#.#..##.#.#.##.########.#...#####.#.#
...#.#...#.....#...........#...#.#.#.......#.....#.....#.....#..
.#.#..#.#..###.#.#######.#.###.#.#...####..#.##..#######.####..#
.#.#.#...#.#...#...#.....#...#.#...........#.#.#.....#...#.....#
.#.#.#.#.#.#.#.#...#..######.#..####..##..#....##..#.#..##..####
...#.#.#...#.#...#.#...#.....#.........#.....#.....#...#.#...#.#
##.#.#.###.#.#####.###.#.###.....####...##...#.#.#..##...###.#.#
.....#.#.......#...#.#.#.#.......#...#...#...#.#.......#...#.#.#
.###.....#######.##..#.#.###.#####.#..##.######.##.###.#.#.#.#.#
.#...#...#...#...#.#...#...........#...#.........#.#.#.#.#.#.#.#
.#####.###.#...#.#.#.###.###..#####..#######.###.#.#.#..##.#.#.#
.......#.......#.....#.....#...............#.#.....#.....#.#...#
####.###.#######.#.#.#.######.#..#.#.###.#...########.##.#.###.#
.......#...#.....#...#...#.........#...#.............#...#.#G..#
.#.#.#..##.#######...#.###.###.##..#.#.#.#.###.#.##..###.#...###
.#.......#...........#...#...#.......#.......#.....#.........#.#
.#.#####..######...#...#.#.#.....#.##.#..#.#.#.###.###.###.#.#..
.......#.......#.#...#.#.#.#.#.#.......#...#...#...#...#...#.#.#
.#####.#.#######.#.#.#.#.###.#...#.#.....###.#.##....#####.#.#.#
.#.....#.#.............#.....#...#.#.#...#...#.#...#.......#.#.#
.#.....#.#.#.#####.#..########..##.#.#######.#.#.#.#.###...#.#.#
...#...#.#.#.........#...#.....#...#.#.......#...#.......#...#.#
#######..#.#..#..#.###.###.#..##.#.#..#..#.#.#####.#.#.#.#.....#
.......#.#...........#...#.#...#...#...#.#.........#...#.#...#.#
.#.###.#.#####.###...###.#.#.#.#.#.###...##.#..#.###.#.#.###.#.#
.#...#.#.........#...#...#.....#.......#.#.....#.#...#.....#...#
.#.#.#.###.#.##....#.#.##.##.#.#####.#.#...###..##.###.###..##.#
.......#...#.#.....#...#.....#.......#.#.#...#.#.....#.....#...#
.#.###...#.....#.#...#...##.######.#.#.#####.....###.#.#####.###
.....#...#.........#.#.#.#.............#.....#...#.#...#...#...#
.###.#####.#.###.#.......#######.####..#.########..#.###...#.#.#
.#...#.....#..S..#...#.#.....#.....#...#.#.........#.....#...#.#
.#.#.#.#.###.##..#####.#.#.#.#.##.##.#.#.#.###.#....#.#..#.#.#.#
...#.#.#.#.......#.....#...#...#.......#.#.#.....#...#.....#...#
...#.#.###.#..####..######.#####.####....###..##.#.#.#.#.##..#.#
.#.#.#.....................#...#.......#.#...#.....#.#.#.#...#..
.#..#.######.#.#.#.#...##....#.#.##.####.#..#..##.##...#.#...#.#
.#.#.....#...#.......#.#...#.#...#.......#...#...#.........#...#
#..#.###....########.#.#..#..#..##.########..#.###.#.######.####
.....#.....#.........#...#.#.#.#.............#.#...#...#.......#
.###.#.##..##.######.###.#.#.###.###.#.#.#.#.#.#.###.#.###.##...
.....#.....................#.............#...#.......#.........#
######.###.####.#.##.#####.###.###########.########.#####...##.#
