32
.........#.................#....
....#..#.#.#.#.......#####..#...
.......#.#.#.#.#.......#...#....
..#..#..##.#...#...#......##....
.#...#...........#.....#...#...#
...#.#..#.##.###...#...##...#..#
.#...........#.....#.......#....
...#.#.###.#.#.#.#...##..##..#..
...#.........#...........#..G..#
##...#..####.#...#.#.....#.....#
.............#.........#.......#
.#.#.....#.#...##.##.#.........#
.........#.............#...#...#
......##...##..#..###.##..#..##.
.......#...................#...#
.....#.#..#..#.##.......##..#..#
.......#...............#.......#
..#......#.#.#.#.......#...##.#.
...................#...#........
.#..#...#..###.#...#...#...###..
.#...................#.#........
..##.....###....###.#..#..##....
...#...#.#...#.....#.....#.....#
###......#...#.#.#.#.#....##.#..
.....#....S..........#.....#....
.##......#.........#...##....#..
.......#.......#.....#...#.....#
.#.#..#.#..#.##.#..#.###.#.##..#
.#...........#.................#
.#.#.#.##..##..#.##......#..##..
.........#.............#.......#
##.#..###..##.####.##..####..###
