16
.#.....#.....#S#
.....###.#.###.#
...#.#...#.....#
.##..#.#####.##.
.#.#...#.#.....#
.#.#.###...###.#
.#.......#...#..
.#.#...#.##..#.#
.#.#.#.#.....#.#
.###...##.###..#
.#...#.....#...#
.#..####.#.#.#.#
.#.#.........#.#
.#.#.###.##.##.#
G..#...#.......#
##########.#####
