16
..............G.
.....#.#.#.#..##
...............#
...#...##...##..
.#.#.........#..
.#...###...#.#..
.....#...#...#..
...#.......#.#.#
.#....S#.......#
.#.#...#...#.#..
.#...#..........
.....#.#.#..##..
...........#...#
.....#.#.#.#...#
...#.........#.#
.#..#.#...##...#
