32
.............#...............#.#
.#.###.#.#.#.#..#..#...#..##.#..
..................G#.......#...#
#.##...###.#...#.###.#..##..##..
.....#...#...#.....#...#...#.#..
.##..#.#.#.#.#...#.....#.###.#.#
.........#.#.....#.......#...#.#
.....#..#..##.##.....#.#.......#
.#...#.......#.......#.#.......#
.#.#...#.###.......###.#.#.##...
...#.........#...#.#...#.......#
....#.#..#...#...#.#.#..#..#.#..
.....#.............#.......#....
.#...#..........##.#..##.#...#..
.........#.#.#...........#......
.####......#...#.#####...#.###.#
.......#.#.#.#...#.....#.......#
.#..####...#....##...#...#..#..#
.........#.........#.......#...#
.#.#..####.....##.....##.....#..
.....#...#.#.......#.....#.#...#
..#....#.#...#####..#..#...#.#..
...#...#...........#.....#.....#
##.###.#.....#.#..#..#.##....#.#
....S......#.....#.#............
..#.#......#...#.......###...#..
.#.................#...#........
.#.##...##.###......##...#.....#
.......#.........#...#.#.....#.#
..#......#....##.#.#.#.#.##.....
.....#...#.......#.#.....#......
.#.#.##.##.##.###.####.####..#..
