8
.#......
.#.###..
.#.#S...
.......#
.....#.#
.#.#....
G......#
#...####
