16
.....#........G.
.#....##.###.#.#
...............#
.#####.###..##..
.....#.#........
..#.......#..#.#
...#S#...#......
.#...#.#.#...#..
.....#.........#
.#.....####.#..#
...............#
.#..##...#.##.#.
...#...#........
##.....#.##.#..#
................
..##...##...#.#.
