64
.#...........................................#...#...#.....#....
...##..##..#.#......##..#.##.........##.#..#...#...#.#...#..##.#
.....................#.....#...#.#.....#...#...#...#...#.#...#..
.#.#...#.#.#.###.#...##.#..#.##..##........###...#.#...#.....#..
.#.....................#.......#.......#...#...#.......#...#....
...#....##..##.######......#...###....#..#...#.#####..##.#.#....
.#...................#.....#...#...#...#.....#...#.......#.#....
.#.##...##.#.###.....#...#....##.#.....##.#.#..#.#.......#.....#
..G..#.....#.....#...#.#.#.....................#.....#.........#
.....#.###..##..##.#.#.....#...#.##.##.#.#.#.....#.#...#.#...#..
...#.................#.................#...#.......#.......#...#
##.#.##..##....#.###...##.##.#.#...........#..###..#.#.#.....#.#
.#...............#...#.........#.......#.........#.#.......#...#
....##.#.#...#...#..####.......#.#.###...#.#.....#.#.#...#......
...#...........................#.#.#...#.#.............#........
.......#..#..##.#####..##.##.#.#.#...###.....#.#.##.######..##.#
.......#.#...#.........#.............#...#.....#...............#
.#...#.....#...###.#..#..#..#.##...#...#.....##.....##....##.#..
.#...........#.#...................#...#...........#...........#
..##..##.#...#.#..###.##...#.#.#..#.#.#...##.#.#.#...#.#####..#.
...#.....#.#.....#.........#.#.#.....................#.#...#...#
.#.##.....#....###.#.....##..#..#..###....#..#.#.##..#.#.....#..
.......#.#...........................#.....#.........#.#.#...#.#
...#.#.#......##...#.#....####.#....##.#.#.#.....#.....#..#.#...
.......#.#...........#...#...............#...#...#.....#.....#..
.#.#.#.#...###....##.#..##.##.####.#..#.#....#.......#.#...#.#..
...........#...#.........#...................#.......#.#...#.#..
.#...#....##..#...#.##.##..#..#...#..####.......#.#..........#.#
.....#.#.........#.....#...#...#.....#.......#.#.......#........
.....#.#.#.###.##..#.#...#.#.#...##..#....#....#.#...###.#......
.#...#...............#...#.............#...............#...#.#.#
.........#....#....#..#.#.....#..#....#.....##.....##...##.###.#
.......................#.....#.........#.........#...#...#.....#
...###.#...##......#.........#.####.##...##.#.#...##..#..#.####.
.......#...#.#...#...#.....#.....................#...#S..#.....#
#.#..#.#...#.#..###..#..###.##.#..#........#.#...#.#.##.##.##...
.#...#.......#.................#.......#.......#...#.........#..
...###.##.##.#.#...##..#....####.....#...##..#.........#..#..#..
.....................#...........#...#.....#.....#.........#.#.#
.#....#.....##.###.#....#....##.##.#...##.....##..##.#..#..#....
.......#.......#.....#.....#.......#.......#.........#.........#
.#..####.#.#..##.......#.#..#..#.#..##..#....#.###.......##..#.#
.#.............#.........#.....#.........#.....#...#.........#.#
...#....#..###.....#..#..#..#....####.##.#.##..#.##.....#....#..
.........#.#...#.#.......#...#.....#.....#.#...#................
..##...#.#....#....#.....#...#..#.#....##.##..##.#.#.###.......#
.......#.........#...#...............#.......#.............#....
###.#......#...#.#.#...#...#.#.#...........#..#.....#..#.###.#.#
.#.....#.....#.#.........#...#...#...#...#.......#...........#..
.#.###.#..##.#.##..#.#...#.#.#..###.#......#.#...#.#.#...#.###.#
...#.#.....#.#.....#.#.#.......................#.....#...#......
..#......#.#.#.#...#...#...#.##.#.#.#.#..###.#.....#..#..#####.#
.#...........#.#.#.........................#...#.......#...#...#
.###.#.....#.....#.#.....#...#.#...#..#####..#.#.#.#.....#.#.##.
.#...#.#.........................#.#...............#...#.#.#...#
.#.###..#.....#........#.##.#.....##.......###...#.....#....#..#
.#.................#.......#.....#...#.......#..................
..######.#.....##.#..#......##.##..#..##...#..##....#.##....##..
.......#.#...#.#.....#...#.........................#...#........
##.......#.#...#.#..##......##....#....#....##.###...#.#..##.#..
.............#.........................#.#.....#.........#...#..
...#...#.....#.........#...#....###..#...#.......#.###..#..#....
.............................#.......#.......#.....#.......#....
.#..####.#######.#.#....#...######.#.#.#....##..##.#####.####.##
