8
.#....G.
.#..#...
........
.#...#..
..S#...#
.....#..
........
#..###.#
