8
S..#....
.....#.#
.#.#.#..
.#...#..
.......#
.#.#.#..
......G.
..##.#..
