8
....S#.#
.#..#..#
...#....
.#..#..#
.......#
.###.#.#
.....#G.
#..#.#..
