64
.....................................#.........................#
..###.....#...#....#.##....####.###.......##.#.#...#.##....#.#.#
.#...#.................#.#.......................#.........#...#
...#.......#.#.#.#...#.#.#...#####.#.#.##....#....####..###.....
.#...#.#.........#.#...#.#.............#...............#...#...#
...#.#.......#..#..#...#.................###.....#.##.#....###..
...#...#.......#.............#.#...........................#...#
.#...#.#.#.##....##..###.#.#.#.#.#...##..#...#...#.#...#.#....#.
.#.#...#.....#.....#.......#...........#...#...................#
...#.#....#....#.#...##.#......#.#.#.#...#.#.##.##.###.#.#.###..
.#.........#.....#.......#...........#.#.#...#...#.............#
.###.#.#..##.####.##.##..#.##..###....#...####.....#.##..#...#..
.....#...#...............#.....#...#...#.......#.....#...#.....#
...#.#.#...#.##..#.#.#.#.#.#.#.##.###..####..#########.....###.#
.......#...........#...........#.....#.......#.........#...#.#..
...#.#.......#.........#...#.#.#...#.#.....#.#.#..####.#.#.#...#
...#.#.....#...................#.#.............#.............#..
#.##.#..##.#...#...###.#.#..#....#.#..##.######............#...#
.......#...#.....#...........#.........#...........#...........#
.##......#.###.#.#.....####..##..##..#.#.#..###.##.#.###.#...#..
.#.......#...#.......#...............#.....#.......#.........#.#
.#.#...#.....#.#.###.##......#...#.#.....#.#.#.#.....##.####...#
...#.#.....#.#.........................#.#...#...............#..
.###...###.#.######...##.#...#.#.###.#.#.#.......#...#.#######..
...........#.....#...........#.....#.#.........#...#.#.........#
.##.####..#..#.....#....##..#...##..#.#.#..#...#.##..#..#.#.....
...............#.........#...............#.............#........
#.#.....#..#.##...#..###.#...#.....#...#.###...##..###.#.#.##...
...#.......#...#...#.....#.....#.................#.....#.......#
.#.#.###...#.#.#.#.#...#....#.#..#.#.#.##.#........#...#.#...#.#
.#...............#.............#.#...........#.............#...#
....##.#.#...#...#.....#.........#.....###.#.#.#.......#.#...##.
.....#.#.....#...#...........#.#...........#.....#.....#.......#
#.#..#.....#.##.##....##.#.......#.#.....###.##...#..#.#.#......
...........#.....#...#.......#.............#...........#........
.#..##...#..#..###....##.#..#.#..##.#.##...#.###..##.#.....#.#.#
.#...#...................#.#...............#.....#...#S.........
...#....#.#......#..##.#.........#...#.###..##.###.#.#.###.##...
.#...........#.............#...........#........................
...##.###..#...#..##..#.###....#...##........##.##...#.#..##....
.............#.....#.............#...........................#.#
..#...##..##....#..#.#.##..#.#.###.......#......##.#...#..#....#
...#.......#...#...#.#...#.............#.........#...........#.#
.........#.#.#...#...###.#.#..##...#...##...###..#.##....#......
.#.#.......#.#.#.....................#.................#.....#..
.#.#.#.....#.#...#.#.#...##...#..#...#.###.#....#.##.#.#.#.....#
.....#...#...........#...............#...#.............#........
#....#.#.#..##..#..#..#.#..#.#.......#.#.#.#.###..#........#.#.#
.........#.................................#...............#...#
.##..#.#..###..#.#.....#...##.##.#.#..####.###..#..#.#.#...##..#
...#...................#.#.#.................#...........#......
......#..###.....#..#......#..####..##.##.##.#...#.#.#.......#.#
.......................#.......#...........#.....#.......#......
.#.##......#...#...###...##.#..#..##.....#.#.##...#####....#.#.#
G....#...#...#.................#.........#.....#...........#...#
..##....##.#..........##.#..##.#......##.........###...####..#..
.....#.....#.......#.#...#.........#.......#.............#.....#
.#...###.....#.####..#.###...#.#.....##..###.#.......###........
...........#...#.....#.........................#...#...#.#.#....
.#.#.##..#...#.....#.###.#.#.#.....#..##......#..#.....#.#.#....
.............................#.#.........#.#.......#...........#
....#..##.#.#....####..#.#.....##.#.##.......#.....#..#.##..##..
.....................#...#.....................................#
#..####.###.###...#..#.#.##..###....#........#.##.##..##.....##.
