16
..............G.
..##.....#...#..
.#.....#.......#
.#...#.#.#.##...
.#S#.........#..
.###.#..##.#....
...#.....#......
..#...##....###.
.....#.#.......#
..#..#.......#..
.#..............
.##..#.....#.#..
...#.....#.#....
##.##..........#
.......#...#...#
...####.##.....#
