16
.........#.....#
.....#...#...#..
.#...........#.#
.......#...##..#
S........#...#..
.#.#..#.#......#
.....#.....#.#.#
.#.#.#..###..#.#
.#..........G..#
...#.#.#.......#
.....#.......#..
.#.###.##......#
.....#..........
..##...#...##..#
.........#.....#
..#.#..#.#..#.##
