64
...#...................#...............#...#....................
........#..#.....#.#...#.####....#.#.#.#.#....#..##..###.#.....#
...#.....#.......#...#.#...#.....#.................#.........#..
.#.#.#.....#...#.....#.....#.#.#.##...#.#.#.#....#.##..#..##....
.#.......#.......#.#.#.#.......#...............#.......#........
.#.#..##.#.......#.....#..##.#.#...###.#...###.#.##..##.....#..#
...#.......#.#.....#...#.....#.#.....#.......#.....#............
##......#..#.#..........#...#...##..##....#..#..##..#.######.#.#
...#.....#.#.......#.#.......#...........#.#.............#...#.#
.#..#........###......###...####.#.###.#....####..##.##..#...#..
.....#...#.......#...............#...#.........#...............#
...#.....#...##....##..#..#.##..#.##....#..##...##.###.##...##..
.#.........#...........................#...#.....#.......#...#..
.#....###..#.#.....#..#...####.#...........#...#.#.#...#..##....
...#.#.......#.......#.............#...............#.........#.#
.#...#.........#....##.#...#...#...#.#...####.##...#.#...###.#.#
...........#.....#...................#.....................#....
.##.##.##.........#..##....#.######..#.#...#...#####.###.#.#.#..
.......#.......#.........#.........#.....................#...#..
.....#....#..#.#####..##.#...#.....#.#.#.##..#..#####..#.###...#
.........#.....#...........#.......#.........#.........#.....#..
..###...##...#....#.#...##....##...###.##..#..#.....###.##...#..
.....#.....#.............#.................#.#...........#......
.#...#.#.##......##........#...#.#.#..#..#.#.#.#.#...##....#.##.
...#.#...............#.....#.............#.#.......#.........#.#
...###...#.#.####..#...........#...#...#.#.#...#.#.#..#.#.##....
..S....#.......#.......#.#.......#.....#.........#.............#
.#...#...#...#.#.#..#..#.##...#.......##....#...#........#..##..
.#.........#.#.#...#.......................#.....#...#.#...#...#
...........#....#........##..#.......#.##.....###......#.......#
...#.#...#.#.#...#...................#...............#.......#..
......#......#......#.#.##.#..##.#.#..##.#..#..#.##.##...#.#....
.....#...#...#.................#...#.............#.....#...#...#
##.....#.#..#..#.##..#.#..#......#.#..#.#####.##....#.#......#.#
.......#...........#.............#...#.#.........#.....#.....#.#
......##...##..#.###.....#..##...##.#..#......########....###...
.......................#.#.............#.#...............#.....#
.#..##.#...#..#..#.#.#.....#...#.#.#.#....#....#.#...##....##..#
...........#...#.....#.#.#...#.................#...#.#...#......
.#.####..#...#...........#.#...#...####....#.#.#.##.#...###.....
...#.................#.......#...#.....#.#.#...#.......#.....#..
...##..#.#......##.#.###....#..#.#.##..#.#...#...#.#.####.#..#..
.#...#.......#.....#...#.........#.#...#.......................#
.....##..#...#.#...###.#.##...#.##.#......#..#.#..#####.....#..#
...#.#.........#.#.......#...........#.......#...........#......
.....#..##..##.#.#...#.#..##.#.#..##.#...#......#..#..#....##.#.
...........#.........#.............#.........#.....#...........#
.....#.......#.#..##.#..#...#....#.##..#.#.#...#.....#.#...#..##
.....#.................#.............#.............#............
.#....###....#.#.....###..##.##.##.....#.#.#.#.....#.#.##.###...
...#.....#.#...#.#...#.................#...#.#.......#..........
....##.#.#.....#...#.##.##..######...##..#.#.....#.#....#.#.....
.#...#...#.............#...............#.....#.......#.........#
.####....#.##..##...##......#..#.##..#...#.###...#.....#.#.##..#
.#.....#...#.....#...........#...#...#.....#.#.........#.....#.#
.#.#####...#..##....##.#.###.....#.###.#..##.##.#.#..#...#...##.
.....#.......#.#...............#.......#.#..........G..#........
.###.#..##..#..##.##.##.##.#.#.#...#.#.#.###..###..##....###...#
.....#...#...............#...#...#...#.#.....#.......#..........
..#............#..##.....#.#........##..#..##..#.....###.#.#....
.....................#.........#.................#...#..........
.#...#......#..#.#.#.#...##.####..##.####.##.#.......#.#.##.#..#
...................#.............#.............#...#............
#.....##.#.#...#..##....#..#.#..#.##.##..#...#.#.##.#.#......##.
