32
...#.............#.....#........
.###..##....####.#.###.#.#.#.#..
..G..#...#.......#...#.......#.#
...###.#..##.#.#.#.#######.##..#
...#...#.....#.....#...........#
#.##.####..#.#.#.#.#..##..##.#.#
.....#.....#.....#.#.#..........
.#.#.#.#.#.#..##.###..##.##.##..
.....#.#...#.........#...#...#.#
..##.#.#.#.#.#..####.....#.#..#.
.#...#...#.....#.....#.#...#....
.#.#...#.#####.#.#####.#####...#
...#...#.....#..................
##.#.#.#####.#..####.###.#####..
.....#.....#.#.........#.....#.#
..###..##.##.#.#######.####..###
.#...#.........#...#.#.....#...#
...#.#.#.##....#...#.#..#..##..#
.#.#.......#...#.......#.......#
.#.#.#..##..##.#.#.#####..#.##.#
.........................#.....#
.#.#.#.#.#####.#...#.##.#..###.#
.......#.....#.................#
.#.#.#.##.##.#.###.#..######.##.
.#.#.#.........................#
##.#.#...#.#..##...#.#....###..#
...#.#.#...#...#......S#...#...#
.###.#.#######...##......#...#.#
...#.......#.....#...#.#.#.....#
.#.##.##.#.#.##....#...##..#.#.#
.#.......#.........#............
######.##.###.####...##..#######
