16
G....#.........#
.#...#..##.#...#
.......#.......#
.##.##.#..#.#..#
...............#
.......#.#....#.
.#.#.#.......#.#
.......#.###....
...#.#.#...#....
#..........#..##
...#..S#.......#
.#....#.##..##..
...........#...#
##.#...#.###...#
.......#........
.##.##.#.###..##
