64
...#.....................#.....................................#
.#.#...#........##.##....#...#.##.#.........##....#..#.#.###...#
...#.................#.#...........#...............#.#.....#..G#
.#......##.#.###.###.#....##...#.#...###..##...#.#.#.#..........
.....#...#.#.......#.......#...#...#...........#.#..............
.#.###...#.###.....##.#...............#..#.#...#.##.##.#...###.#
.#.............#.........#.....#.#.........#.......#.....#.....#
.#...##......#.#.......###..#......#.##..#...##.#..#..##..#..#..
...#.......#...#.#.........................#.......#...#.......#
.##..#.##...#.#..#.##......###...#...#.###...#...#...#...#...#.#
.....#.#.......#...#.............................#...#.#...#....
.##.#..#.#.##..#.#.#.....###.##....#..#...##..##.#......##.#....
.....#.#.#...#...#...#.....#.....#.......#.......#...#...#.....#
...#.#.###.#...#.....#.#.#..#..#....####.#..#####..#.#.#.###...#
...........#.....................#.....#.#.............#.#......
##.#.#.##.#..##..###..##..#..#...#.#.#.#.#......#.#..#...#.#...#
...#.#...#...........................#.......................#.#
.#.#.......##..##.##..#......#....#.....#..........#.#.#..#.....
.#.....#...#.......#...#...#.............#.......#.......#...#..
.#.#.#..#.....#.#....#....#..###.#...#.#.#..#..#...#.#####...#.#
...#.....#.........#.#.#.....#...#.#.#...#.#.......#...........#
......##.#..##.##.##...#.#.##..##....###...#..#..#.#.###....##..
.#.#...#.....#.#.....#...........#.#...#.#...............#......
.#....##...#...#...#.##....#####.#.##.....#..#..##.###...#.#.#.#
.....#...#.............#...#.......#.............#.....#...#...#
..####..###.#.#.#.####...###..##.#..####.#.#..##.###.#....#..#.#
.....#.................#...#.#.........#...#...#.......#........
...#.#.#...#.#...#.........#.#.#.#.#.....#.#.#..##..###..#......
.#.#.#...#.......#.......#...#.#.#.......#.............#........
#..#.##.##..####.#.###.#..#.#....#.#..........#.#...##..##.....#
...#...........#.......#.................#.#.........#...#......
.#.###.##...#....#####.....#.#...#.#####.#.......#...###.....#.#
.........................#.#...#.#...............#.........#....
.#.#.#.####...#.....##......##.#.#.#.#..##...#.#.#..##.#...#..#.
...#...#.....#.....#.........#...#.#.#.........#.....#.#...#...#
###..........##......##..#......#.#...##.....#.#.....#.#.#.#....
.................#.....#...#.......#.....#...#.........#.......#
.#.#.##...###.#.....#..#......#.##.....##....###....##..#.#..#.#
.....#.........#.#...................#...#.......#.#.....#.....#
..##.#.###.#..#..#.#.#....###..#.#...........#...#.....#...#.#..
.#....S#.............#...#.......#.......#...#.#...........#.#..
##.#........#.###.#............#.#...#...##....#..#........##...
.........................#.#...#.......#...#.#...#.............#
.###...#.......###.#.###.#.###.##.##.#..##.##......###.#...#.#.#
.......#.#.#...#...#.....#.........#.....#...#...#.....#........
.#####.....#.....#....##.#...##..........###..##...#.....#..##..
.#...#...#.#...........#...#.....#...............#...#.........#
...#.#.##....#.#........##.#......####.#.#..#..#.#.#.##..#..#..#
.#.#.#.....#...#.....#.#...#.#...............#...........#......
.#...#...#.#..#..#.#.#...........##.......##.#.##.##....#.#....#
.......#.#.........#.....#...#.........#.....#.#...............#
..##...#.#.#.#...#.#.#.#...#####.......####..#.###...###..#..##.
.#...#.....#.......#.....#...#...............#.....#.....#......
.#.#...#...#.#.#....#.#.#..#....#####..#.#.###...#.##.###...##.#
.#.....#.#...#.....#.....................#...................#..
.#.##.......##.#.#.#.#....#..#..##.....#...#...#...#.###...#.#.#
...#.....................#...............#...#.........#.#...#..
...#.#.##.##...#.##..#####.#...#.#...#...#..##.#..##...#.#.#...#
.#.........#...#.........#...........#.#........................
...#.##..........#.#.##....#.#.......###...##...........##.#...#
.#.....................#.......#...#.....#.......#...........#..
.#....#...##.#.#.#.#....##.#...#.###..#......#.........##...#..#
.....................#..........................................
...#.....##..#...##.#..###.###..#########.#..#..#...#..###.#....
