32
..............................G#
##.##..##..#.###.#.###.#.#.#.#.#
...#.....#.......#...#.#...#...#
.###..#.###..#.......#.####..#..
...........#.......#.......#....
#.###...#..#######.#.#..##.#.#.#
.....#...#.#.......#...#.#...#.#
.##........#.###########.#####.#
...#.....#.............#.....#.#
...#.##....###...###.###.###.#..
.#.#.........#...#...#...#...#.#
.#.....#.#.#.###...#.#.###..##.#
.#.#.#.....#...#...#.#.#.....#..
##.##..###.###.....#.#.#...#.#.#
...#.......#S..#.#.#.#.#.......#
..##...###########.#.#.#.#.#####
...#...#.........#...#.........#
.#.#.#.#.##..#.#.#.#.#.#.#..##.#
.#...#.#.#...#.#...#.#.#.#...#.#
##.#.#.#..##.#..#.##.#.#.#...#.#
.......#...............#...#.#.#
.#...#.#####.#####.#.##..#.#.##.
.#.....#.#...#.......#.....#...#
.###.#.#.#.#.###.#.#.#.##...##.#
.#.....#.#.#.....#...#.......#.#
.#.#####.#.#.##.#..#.#######.#.#
...#.....#.......#.......#......
.###.#.###.#.#.#.###.###.##.##..
...#.......#.#.#...#...#...#...#
.#...#..####.#.#.###.#.#.#.#.#..
.#...........#.......#..........
#######.###.##...#.#..###....###
