16
..........S.....
..#####.#..##...
...#.....#......
.....#.##.......
.#...#.....#...#
...###.....#....
...............#
...#..##.#.#.###
...........#...#
#......###.#.#.#
...#............
...######.###..#
.#...........#..
...#.##...#.....
........G......#
....#.#######...
