32
...........#...................#
#.#.....#......#.....##.#..##...
......G....#.............#.....#
..#.#.....##....#.#...##.##..#.#
.#.......#...#..................
...#.#.....#....#...#......##..#
.#.....#.#.........#...#.......#
.#.##..#....##...##..#.#..###..#
.....#...............#.......#.#
........##.#####.#.....#.#.#...#
.........#...#.......#.......#..
.#.#.#...#.#....##....##..#.#...
.......#.........#.....#.#.....#
.#.#.##.#.####...#.#.#.#........
.#.#...............#.#.........#
.#.#.#...#..##.#..##.##....#.#.#
.....#.......#.......#...#.....#
.#.#..######..##..#..#...###.#..
.....#.........#.....#.....#.#..
.......#...#.#...#..##.......#..
...#...#.#...............#.#.#..
#..#.###.#.....##.#.#..#.#.#....
...#.#...................#.#.#.#
.....#.#.#######.#..##...#.#..#.
...#...............#S...........
...#....#.#.##..##...#...#..##.#
.........#...#...#.#.#.....#....
..#........#.#.#...#..##.#.#.#..
.....#...#.........#...#.#.#....
...##......#.##..#..##..........
.#..............................
#.....##.#.#....####...#.#.#.###
