8
.......#
.#...#..
...#S..#
.###.#.#
.......#
.#.####.
G.......
####..#.
