32
...........................#...#
##########..#..###.#.###.#...#.#
.......#...#...#...#.....#......
.......#.##..#......##.###.#.#..
.#.....#.........#.............#
.###...#.#.#.#.###.####.##.#..##
.....#...#.#.#.....#G..#.......#
.....##....#...#...#.#.#.#......
...#.....#...#.#.......#.....#..
.#..#.##..##...#.#.#.#.#.....#.#
.......#.......#.#...#.#.#...#.#
##.......#..#..#.##.##.#....##.#
.......#.....#.#.....#.#........
..##.###.##..#.#.#.###.#.###.#.#
.#...#.......#...#.............#
.......#.#...#####.#..####.#.#..
.#...#.#...#.#...#.........#....
.###..##..##.....##.##.##..#.#.#
...#.....#...#.#.........#.#...#
.#...#.#.#...#.#..##.##....#.#.#
.....#.#.....#.....#...#.#.#.#.#
.###.....#....##....#..#.#.#...#
...#.#...#.....#...#...#.#...#.#
####..##.##..#.#.#...###.#.###.#
...............#...#.#.....#...#
...##...#####....###...#.#.#..##
.............#...#.............#
.##..#####.##..###.#..##..###..#
...#.#.....#.......#...#......S.
.#...#.#.#.#..###.##.#.##..#####
...........#.........#.........#
####.####.###.###.##.##.######.#
