32
.....#.......#.........#........
.....#.##.#..#.#.#.#.#.#.#.#.#.#
.#.#...#.....#.......#.#.#.....#
...#.#.#.#.###.###.#.#.##..###.#
.#...................#.....#...#
.#...#########.#.#...##...##.###
.#...........#.#...#.#...#.....#
.#.#.#..##.#.#.#.###.#.#.#####.#
.#.........#.#.#.......#........
.#....##...#.#..#.###..###.#.###
...#...#...#...#.......#...#....
.###.#.###.##....#####.#..#.##.#
...#.#.#G..#...#.#...#...#...#.#
##.#.###.#...#.#.#.#.##.##.###.#
...#...#.#...#...#.........#...#
.##..#.#.#..##.#.#.####..#....##
...#.#...#...#.........#...#.#.#
##.#.######..#.##.##...#.###.#.#
...#.........#.......#.........#
.#.#...#..####.#.###.#.#.#..##..
.#.#...#.#.....#.#.#...........#
.#.###...#..####...#...#.#####.#
.#.....#.#.....#...#.......#....
..#..###.#.##..#...##.####.#.##.
.#...........#.....#.....#......
...#.###.#.#...###.###.#..###..#
...........#.......#...#.......#
.#.#.#.#####.##..###.#.##.##.#.#
...#.#...............#....S#.#.#
.###..##...###.##...##...##.....
...#.....#.........#...#.....#..
##..#.##.#.##.#.#####.##.##.####
