16
........G..#....
.#...#.........#
.....#..........
...............#
...#...#...#.#.#
.#.#.#....#.....
...#.#...#...#.#
#..#.##........#
S..#.#.....#....
####...#.#.#...#
.......#........
.#.#.....#......
.......#.......#
.#.........##.##
...............#
#...#...###.####
