16
...........#....
..###.##.....#.#
......G#........
#..#.#.#.#.....#
................
.#.#....#..#.#.#
.#...........#.#
..#..#...#.###.#
...#.#...#.....#
.#....##....##.#
...#...#.......#
..#....##.##.###
...........#..S.
.#.####....#...#
.........#......
#...#####.......
