8
........
.#..#..#
...#G#.#
.#.....#
.#.....#
##.#.#..
S..#...#
.##.##..
