16
...............#
.....#...#####..
...............#
.###.....##....#
................
.#..#..#.##..#.#
..G....#.....#..
...##.#...##...#
.#.....#........
....#....#.#....
.....#...#.#....
.#.#........##..
..............S#
.#...#..##...#..
.#.........#...#
#.....##..#.#.##
