32
.........#.....................#
...#.#...#.#.######..#.#.###.#.#
...#.#.#...#.#S..#.#...#.#...#..
...#.#.####..###.#.###.###.#...#
...#.#.#.........#..............
.........#.#.#.#...#.###.#.#..#.
...#...#.......#.......#.#.#....
.#.##..#..###..#.##.##.....#.#..
...#.#.#...#.#.#.......#...#...#
.#.....#.#.....#.#####.##....#.#
...#.....#.....#...#.....#.....#
.#.#.###.#.###.##....###...#####
.........#.#...#...#.#.......#.#
.#...###.#.#.###.#.#.###.#.....#
.#...#.............#.......#....
.#...#.##..#####.#.##....#..#..#
.#...#.#.......#.#...........#.#
.#..##...#####...##..#..##..##..
...#.......#...#...............#
##.##..###...##.########...###.#
.......#.#.......#.........#....
.#.#.#.#.#...#.#.#..##.###.#.#..
...#.#.#.......#.#.#.....#..G...
.###.#...####.#..#...#.#.#.###.#
.....#...#.......#...#.#...#...#
...####..#.##.##....#..##.#..#.#
.......#.#.#.......#............
.#.####..#.##..#.######....###.#
...#.............#.......#.#....
.###.#..##..##...#...###..##....
...#...........#...#.........#..
##.###############..###..##..#..
