8
.......#
....##.#
..S#.#..
..##...#
.....#.#
...#.#.#
...#..G.
#####...
