8
G#......
...#.#..
.#...#.#
...###..
...#...#
.#.....#
..S..#..
######.#
