8
..G.....
.....#.#
.#...#.#
.#.#....
.#...#.#
.#.##..#
....S#..
##..#...
