8
......G.
...#.#..
.#.....#
.###...#
.#S..#.#
.##.#..#
.......#
########
