32
...............#................
...###.#...#...#..##.#....##.#..
.#.....#.#.......#..S#.........#
..#..#.#.#.#.###......##.....#..
.....#...........#.....#.#.....#
..#.#..#...#.#..#....#.#.#...#..
...#.....#...#.............#....
#..#.###.#...###.........#..#...
.........#.......#..............
.#####...#...#..#.........##.##.
.....................#.........#
...#......##.#.#.###.#..#.##.#.#
.#.........#.#.#................
.#####.#.......#.##.##...#.#....
.....#...#.............#.#.#....
.###..#..#.#.#.##..#.###...#.#..
.#...........#...#...........#..
.#.#.##.##...#...##.##...#...#.#
.......#.......................#
...#.....#..##.###.#.#...###.#.#
...#...#.............#...#......
.#.#.#..#.#####.....##.#..#.....
.#.......#.......#.....#.......#
.#.....#.#.#...#..#...#..#.#.#.#
...#...#...#.#.....#.#...#.#.#.#
...#...##....#.###.......#.#.#.#
...#.#.....#.......#.......#.#..
.#.#.#...#.....#.##....###.#.#..
.#.........#.........#.......#.#
.##.#####....#....####.#.###.#.#
.......................#......G.
##...##.#####....####...#.#...##
