8
....G#..
.#......
........
...#....
.......#
..##...#
......S.
...#.#.#
