32
.........................#.....#
.####..##....#.#.#.#.#.......#..
...#.....#.#.#...#...#.#...#...#
...#.#.....#.#####...#.#...#.#.#
.#.#.......#.#...#.........#...#
...#.##..#.#.#...#.#.#####..##.#
.#...#...#.#.....#.....#.....#.#
.#.###..#..##..#...###.#.##....#
.#.....#.....#...#...#.#...#.#.#
.#.#..##.####.#..#.#.#.###...#.#
.....#.............#...#.......#
######.###..##.#.##..#.#.#.###.#
.......#.....#...#...#.....#...#
.###.#.#.#########..#..#...#.#.#
...#...#.#S..#...#.....#...#...#
...#.#.#...#.#.#.....#...##..#.#
.#.......#.#.........#.....#...#
.#####.#...#####...###.###.##..#
.....#.#.........#..............
.###...#####.###.#..##.#.#.#...#
.#.....#...#.......#...#.....#.#
#..#####.#.#.#.........#.#.#####
...#.....#...#...#.#.#.#........
.###.##.##.#######....##.#####.#
.#...#...................#...#.#
.#.###...###.######.##.##..#.#..
.......#.#.............#...#....
...#.#.#.####.#####..###.##.##..
.#...#.#.....#.....#.....#......
.#..##.##.##.#.###.######...#..#
.............#...#..........G...
######.#.###.##.##.#.#.#.#.#.###
