32
G...............................
.#....#.#....#.#...#....##.##...
.......#...#...#.....#.........#
#......#.###..#...##.##.#.#..#..
...#.#.....#.....#.......#.....#
........##.###......##.#.#...#..
.....#...#...............#.....#
....#....#.####..#.##..#.#...#..
...#...#...#....................
.#.#.#.#.#.###.#..#..#...#.#....
.#.......#.#.........#.#...#....
.###.#.#.............#...#.#....
.............#.#.....#.......#.#
...#######.#...#.#.#.#.#...#.#..
...............#.....#S..#.#.#..
.#....######...#.#...###.......#
.................#.#.#.......#.#
#...#.##....#.##.#...#..#....#.#
.#.......#.....................#
...#.#.#.#.#...###.##..##....#.#
.#.....#.........#.#.......#.#..
........###..##........#..#.#...
...#.....#...........#.#.......#
.##..#.#...#####.#...#.#...#....
.#.......#.................#...#
...###.#...#.#....#.....##...#..
.#...........#.........#...#....
.#.......#.....#....###.........
.....#...#...#...#.......#......
...#.#....##.#.###...#..#.##...#
...#.#.........................#
..###.##..###.#..##.#.##.####.#.
