32
...#.........#...#.......#.....#
.###.#..##.#.#.#.#.#.#.#.#.#.#.#
.#.........#.#.#...#...#...#.#..
.#.######..#.#..#..#..##.##..#.#
.#...#.#...#.#...#...........#.#
.#.#...#.##..##..#####.#.###...#
...#.#.#.#...#...........#...#..
..##.#.#.###.#..#.####.#...###.#
.....#.#...#...#.....#...#.....#
.#####.###.###....##.#.########.
.........#...#.#...#.#.....#...#
..##.###.###.#.###...#.#.###...#
.#.........#.......#...#S..#.#.#
.#.#.#.#.#.#.#.###.#.#####...#.#
.#.#...#.#.#.......#.#...#.#.#.#
#..#.#.#.#.#.#####.#.#.#.#.#...#
...#...#.....#...#...#.#.#...#.#
.###..##...##..#.###.#....#..#.#
.#.#...#...#...#...#.#.#.......#
....##.#.###.#####.#.#.##.######
.#.....#.........#...#...#......
.###.#...#.##.##.###.###.###.#..
...#...#...#.....#.........#.#.#
...#..######..##...#######.#.#.#
.#.#.......#...#...#.....#...#.#
.#..##.###.###.####..#.##.####.#
.#...#...#.....#...........#...#
.###.....###.#.#.##.#.##.#.#..##
.....#.#...#...#.......#.#.#...#
.#.###.###.#########.#...##.##.#
....G..........................#
#####..###########.##..#########
