16
.......#.......#
..#.##...###.#.#
.#S#...#.#...#..
.#...###.#.###.#
...#...#...#.#.#
.#..##.#.###...#
.......#...#...#
.#####.#.#.#####
.#.........#...#
.#####.####..#.#
.#.....#........
.#.#.##...##.#..
.........#G....#
.###.##.##.....#
................
.#####.######.##
