32
.......#...#.......#.......#....
.###.#...#.#####.#.#.#.##..#...#
...#.#.#.#.#...#...#.#.#.....#..
.#.#.#.#.#.#.#.#.#.##..#.####..#
.#.#.#.#.#...#.#.#...........#..
##.#.#.#.####....###.##..###.#..
...#.#.#..S#...............#.#.#
.##..#.#####.#.#.#####..##.#.#..
.#...#.#...#.#.#.#...#.....#....
.#.###.#..##.#...#.#...#.#...##.
.#.....#...#.....#...#.....#.#.#
...#....##.#.###.#.#.#..##.#...#
.#.........#.....#.#...#...#...#
.#..######.###...#.#.##.##.##...
.#...#.....#...#...#.....#......
.#.#.#...###.#...#.##.##.#.#####
.....#.......#.#.#.......#.#...#
.###.#..##.#.#.#....######.#.#.#
.....#.#.....#...#...#...#...#.#
##.#...#.##..#.###...#.#.#.#.#.#
.#.#...#...#.....#...#.#.#.#.#.#
.#.#.#####...#####..##..##.#.#..
.#.....#.....#.....#.#.....#.#.#
.#.###.#######.#####.#.###.#.#..
.#...............#.....#...#...#
.#...#######..##.#.###.#.#.##..#
...#.....#...#.......#...#...#.#
..###.##.#.###.#.#.#.#.#..##.#..
.#.....#.............#.#...#....
........#.#..###.#.#.#.#...#....
...#.........#...#..G......#...#
#.#####...#############.######.#
