32
...............#....G...........
...#.......#...#..##..#.##.#...#
.....................#.......#.#
....#......#.#.......#.#...##...
.................#...#..........
###..#....##...#..#....#....#..#
...#...........#...#.....#......
.#.#.#...#...#........##.##....#
.............#...#.......#...#..
.#.#..#.##...........###....##..
.......#...#...........#.......#
.#.#.#.........#.#.##..####..#..
.............................#..
.#.......#...#.##.#..#.#.#.....#
.........#...........#...#.#...#
.#.#...#.##.#........#..........
.#...........#.....#............
...#.#.#..#......#..##.#####.#.#
.#....S........#.#.....#........
..#.....##.#...#.#.......#.#.##.
.....#.....#.........#.#...#...#
.....#..##.#.#.####.#..#.#.#.#.#
.....#.#.................#.#...#
...#.#..##.#.###.#.##.##.#....##
.#.#.......#...#...........#...#
.#.#........#.#...##.#..###.#..#
.#.......#.....#.........#...#.#
#...#.#.........####.....#......
.........#...........#.#.......#
.##..####..###.#.#..##.#.#.##...
.....#.....................#....
....#####.#.##....#..#.....#..#.
