64
...#.............#.........#...#.......................#.......#
.##..#.####.#.##.#.####..#.#.#.##.##.#######.#####.###.#.#####.#
.....#.........#.#.#.........#...........#...........#.........#
.###..#######..#.#...##.#.########.#.###.#.###.#.###...###.###.#
.......#.......#.#.#.........#.....#.#.....#.........#.#.#...#.#
##.#.#.#...#.##.##.####.##.#.#.#######.###.#.#.#.#.###...###.###
...#...#.#...#.....#...#...#...........#.....#...#.#.......#...#
.#.##..#...###.####..#.#.#######.#######.#####.#.#.#######.###.#
.......#...........#.#...#...#.......#.......#.......#...#...#.#
.#####.######.###..#.##.##.#.#.#####.#.#####.#.###.#.#.#.#.##..#
...#...#.....#...#...........#.....#.#...#.....#...#.#.#...#....
.#.#..##..##...#.#.#####.###...#...#.#.#.#.#...#.#...#.#.###.###
...#.#...#.....#.#.#...#...#.......#...#.#.......#...#.....#...#
.###.#.#.#.#####.#.#.#..##.#####.##.##.#.###.###.###.#.#######.#
.#...#.#.#.....#.#.#.#...#.#...#.#...#.......#.......#...#.....#
.#.###.#.####..#.###..##.###.#.###.#.#.###.#######.#.#.###.###.#
.............#.#.............#.....#...........#...#.......#....
#############..####.##.#####.###.#.###.#.###.#.#.#.####..###..##
.......#...........#.....#...#.....#.......#.#...#.#.....#.....#
.##.##.#.#######.#.#..####.#.#.##..#.###.#.#.####..#.#..##.###.#
.........#...........#.#...#.......#.#...#.#.......#.#...#...#.#
..##.###.#.###.###.#.#...###..######.#.#.#..##...###...#.#.#.#..
...#.#...........#.#.......#.............#...#.......#.#...#.#.#
##.#...#.##..#.#...###.###.###########.#####.###.##.####.###...#
...#.#.....#.....#.....#.#.........#.......#...#.............#.#
.#.#.##.##.#.#.#####.###.###...##.##.#####.###.#.#.##..#.#####.#
.#.#.....#.#.#...............#.#...#...........#.#...#.#........
.#.#####.#.#####.#.###.###.###.#.#.#.###.###.##.##.###.#.#######
.#.#...#.#.......#...#...#...#...#.#.#...#.#.......#.....#.....#
.#.#.###.####.#.####.###.#.#.#.##..#.#.#.#...#.#####.###.#.#....
.#...#...#.........#.#.....#.#.....#...#.#...#.......#.#.#.#...#
..##.#.#.#.##.####...#...#.#.#.#.#.#####.#.##.####.#.#.#.###.#.#
.#...#.#.#.#.....#.#.......#.#...........#...#.....#.#...#...#.#
.#.#.#.###.#.#.#....########.#.###.###....#.#...####.#.##...####
.#.#.#.....#.#.#.............#.#.#.....#.#.....#.#...#...#.....#
.#.#.#########.###.########..#...#.##.##.#..#.##.#.###.#..#.##.#
.#...#.............#.......#...#...#.....#...........#.#...#....
.###.###.#.#####.#.#.#####.###.#.###.##...###..#####...###.#.#.#
.........#.#.....#...#.....#.#.....#.......#...#.....#...#...#..
############.#.##..#.#.#.#.....#...######..#..##.###...#.#.#.#..
.............#.....#...#.#.....#.........#...#.#...#...#...#...#
..#####.####.#..#..#.###.#.#.####.##.###.###.#.#.#.#.#.#.###.#.#
...............#.#.......#.#.......#...#...#.......#...#.....#G#
.#####.#.#.....#.#.###.##..####.##.#####...###.#.#.#.#####..##.#
...#.......#.....#...#.#.#.#...........#.#...#...#.#.....#.#.#.#
.#.#.##.###########..#.#.#.#...#.###.#.#.###.#.###.#####.#.#.#.#
.........#...........#.#.#.#.#.......#...#.....#...#...#.#.#....
######.#...##.###.####.#...#.#######.##.#######..###.###.#.#.###
.....#.#.........#.....#.....#.#...#.......#.....#.....#.#.#...#
.###.#####.#..##....#..####..#.#...#.#####.#.####..###.#...#####
.#.#S#.......#...#.......#.....#.#...............#.#...#.#......
.#.###.#.#.#.#..##.#####..#.##...###########.#..##.#.#.#.#####.#
...#.....#.#...#.........#...............#.........#.#.#.#...#..
.#.#.###.#...#.#.###.#####.##..########..#.#.#.#.###.....#.#.#..
.#...#.......#.........#...#...........#.....#.......#.#...#...#
.####...##..########.#.#.#######.#####.#...#.##.####.#.#######.#
.#.......#...........#...#...#.........#...#.......#.#.#.......#
.#.###.###....##...#.#####.#....###.##.###.#.###.#.#.#.#.#######
...#.#.......#.....#.#...#.#.....#...........#...#.#.#...#.....#
.###.###.###..#.#.####.#.#.#####.#.##.#..##.#...##...#.#.#.###.#
.....#.#.....#.........#.....#.#.#.#.......#...#.......#...#.#.#
.#.#.#.#.####....#.#.#.#...#.#...##....###.#.#########.#..##.#.#
.......#...............#.......#.....#.....#.............#......
##..#############..###.####.##.######.##########.###...######..#
