64
................G......#.......#.....................#.........#
....##...#.#.....#.###..#..#.#.#.#.#...#..#.##..#..#.#.......#..
...#.#...#...#.............#.....#...#.............#.#.#.....#.#
.#.#.#.....##.....######..##...#.....###..######...#.#.#...#...#
.............#.#.............#...#...............#.........#....
.#.#....#......#.#...#.....##......#.....#.#..#........#...#....
...........#.#...............#.....#.....#.#...........#........
..##.#.###....##..######..##.........#.....##......#..#.....#..#
.#.........#.............#.....#.#.....#.................#......
.#.#....####.....#.##..#.#.............#...#.##...#.##.#.#...#..
.......#.....#...#.....#.........#...................#.....#....
.#...........#.#.#####.#..##..##.#.###.##..###.##..#.#.#..#....#
.........#.............#.#...............#...........#.......#..
.....#..###..#.###........#....#.###.###..#..#.....#...###.#....
.......#.....................#.........#.....#.#.#.#.......#....
........#....#.#...#.#..##.......#..#..#..##...#.#.#...###.#.#..
.#.#...........#.#...........#...#...........#.#.#.........#...#
...##.##...##........#...#...#.#.#.##....#...#.#.......#.##.##.#
.........#.....................#...#.............#.......#......
...#..#.##.#..#.####.###.......#...#..#.....#.....##.#.##....#..
...#...............#.#.....#.....#.............#...........#...#
.#.....####..#.#.#.......##.##.#.#...#...#.#...#.###...#.#.#...#
...#...........#.....................#.........#.#.............#
#..#.##.....##......##......###..#.#.#.###...#...#.....#.#.#.#.#
.....#.#.......#.......................#.#...#.....#...#...#....
.............#.#.#.#.#.#..#....#.#...#.......#.##....#.#.#......
.......................#.#.......#...#...#.....#...............#
.........#...##.##.#.#.#.#.#...##.##.#..##.........###.#....##.#
...............#...#...........#...........#...#...#...#.#.....#
.#.....#.#.........#......#..#...#....#..#.####......#.#.#..#...
.#...#.............#.#.....#.#...#...................#..........
.........#.#.#.#...#.####............##....#.####.#.#.##..####.#
...#...#.........#...............#.........#.....#..............
.#.#...#...#######.###.##.#..#.....#....##.....#.#.##...#....#.#
.....#.#.....#.........#.........#.#...........#...#.......#.#..
.###.#.#....##.#.#.....#.##.#..#.......##......#.......##..#...#
.......#.#.#...#.............#.#.#...#.........#.....#...#......
#..###.....#....#.##.#.###.#.#.#.....###..#....#.#.#.###...#.#.#
...........#...#...#...#.........#...................#.....#...#
.##.####...............#..##...#......#.....#..#.#.#...###.....#
.#...........#.......................#.....#.......#.#..........
.##..##.#.##.....##..#.#....#.##.#.#.#.##..#.....#........#....#
...............#.....#.#...#...............#...#................
.....#.#####.#.##..#.#..#..#.#.#.....#...#.#...#.#.#####...#.#..
.............#.#.............#.............#.#.........#.....#..
..##...##..##..#.###....#..##..#.#.##..#.....#.##..#.#.#...#...#
.......#.......#.#.............#.#.....#....S#.......#...#......
##.#.#.#.###..##...#..#..#.#...#.....##..#.#.#..#....#.....#....
.....#.#...#.....#.#...........#.......#...#.#...#.....#...#...#
.####....#....####...#.#.#...#...#..#...#....#.....#.#.#.#.##.#.
.............#.....#...#.........#...#...#.......#..............
.##..#.#.....#..###..#.........##....###.##...#.........###....#
.#...........#.......#.#.....#.....#.............#...#.......#.#
.#.#...........#...#.#.#.....##......#.###..##.#.#...#####.....#
.......#.....#...#.#.......#.....#.#...#.........#.#...........#
..#..#.####.....##.#...##..###..#........#....#...######..##.#..
.#.....#...#.....#...................#.#.#.#...#.......#.#.....#
.#...#.#...#...#...#.#.#.###....#..#.#.#...###.....##....#...#..
...............#...#...#.#...#.........#.......#................
.#...#.#.#..#............#...#.#.##....#.####..##.##.#.#.....#..
.............#.....#.....#.....#...#.....................#......
#..#.###.....#.#..#......#...#.........#.#.#....###......#.###.#
.........#.............#...................................#...#
...#..#.#.#.###..##...#.#.####.##....###...###.#....####.#.####.
