64
.........#...#.....#.....#...#...#.....#...................#...#
.##...##.#.#.#.#.....#.#.#.#.#.#.#.#.#.#.###.##.##.#########.#.#
.#...#.#.#.#.....#...#.#.#.....#.#.#.#.......#...............#.#
.#.###.#.#.#.#.#.#.###.##..###.#...#.########...##.#####..##.#..
...#...#.....#...#.#.#.....#...#S#.......#...#...#.#...#.....#.#
.#.#.#.###.#.#..##.#.#.#####.#..########.#.#...#...#...#####.#.#
.#...#.....#...#.........#.........#.......#...#.#.#.#...#...#..
.#.#.#####....#..###.#.#.#...####..#.#..#..###.#.#.#.###.#####.#
.....#.........#.#.....#...#.....#.#.#.......#.....#.#.........#
##.#.#.#..###..#...#.#.#.#.#.###...#.###.########..#...####..#..
...#...#.......#.#...#.#.#.....#.#.......#.........#.#.....#...#
.#.#...###.#.###.#.###.###.#.#.....#.##.##..####.#...#.###.###..
.#...#.....#...#.#.....#...#.....#.#.#.....#...#...#.....#...#.#
..####.####....#...#.###.###.#.#.#.###.#.#.#.#...#.#.#.#.###...#
.#.....#...#.#...#.#.#...#.....#.#.#.....#...#.......#...#......
...#.#.#.#.#.#####.#.#.##.####.#.#.#.#.#.....###.##..#.#.#.#...#
.#.#...#.#.........#.#.#...#...#.#.#.#...#.....#...........#...#
.#.#.###.###.#####...#.#.#.....#...#.#.#.##.##...##....###.#.#.#
...#.#...#.....#...#.....#...#.#.....#...#...#.#.....#.....#....
###....###.###.#.#########.##.##..##.###.#.#...###.##..###.###.#
.....#...#.............#...#.....#.....#.#.#.#.....#.......#...#
.####.##.#.######..#...#.###.#####.#.###.###.....#......##.#...#
.#.....#.......#...#.....#...#.....#...#...#...#.#...#.........#
...###.#.###.#...##.####.#.##########..###.#.....###.###.#.###.#
.#...#...#.......#.....#.#...#.......#...#...#.#.....#...#.#...#
.###.####..#.###.#.###.#####...#####.##..#.###..###.##.#####.#..
.....#.....#.#.....#.#...#...#.#.......#...#...#.............#.#
.###.#.###.#.#..##.#.###.#.###.###.###.##.#..#.#...#####.#####.#
...#...#...#.#.....#...#.#.#...#.....#...#...#.........#.#.....#
##.#..#..#.##..#...#.#.#.#...###.###.###...###.######..#.#.##.##
.#.#...#.#...#.#...#.#.....#.#...#.#.#.#...#...........#.#.#....
.#.#####.#.#...#.#.#######...##..#.#.#.#######.#####.#.#.#.#....
...#.......#.....#.....#...#.....#...#.........#.......#.#...#.#
.###..#.##...######.##.###.#.#####.#####.###...######.##.#.###.#
...#...........#.....#...........#.................#.....#.....#
##.#.###########.###.####.##...#.#.#.####..#######.#.###.#####.#
...#.#.....#...#.............#.#.#.........#...#.....#.#.......#
.#.....##.#..#...#.####.####...#.#.####..#.#...#.#.#...#.#####.#
...#.........#.#.........#...#.#.#.......#.#.#.......#........G#
.#.###.#.#####.###...#####.###.#.#.#..##...#.#.##..##..###.#..##
.#...#.#.....#.....#.....#.....#...#...#.#...#.....#.#...#.#...#
.#.#.#.###.....###...#.#.###.#.#.#.###...###.#.#..##.##..#.###.#
.#.............#.......#.....#.#.......#.....#.#...#.........#.#
.#..#.##.#.#.#.#.#######.#.#.###.#####.#######.###...##..#.#...#
.#.#...#...#.....#...#.......................#...#.#.#.....#.#..
.#.#...#.#.#.###.#...#.#....######.#.#...#.#.##..#.#.#.###.#.#.#
.#...#.......#...#.#.....#.........#.#.#...#.#...#.#.........#.#
...##.###.##...###.###.#.#..####.#.#...###.#.#.###.##.####.#.#.#
...#...#.....#.#.#.......#.#.....#...#.....#...#.........#...#.#
####...#.#.###.#....##.#.#.#.###...#.###.###.#.#.####.#.....#..#
.....#.#.#.........#.......#.....................#.#.....#.#...#
.#####.#.#.#.#######.#.#####.#.############...##.#...#.#.#...#.#
...#.#.....................................#.#...............#..
##.#..###..#.#.####.####.#.####...########.#.#####.###...#####..
...#...........#.........#.#...#.#...#.....#.....#.....#...#....
..##############.#.###.###...#.#.#.###.#.#.#####.###.#.#####.###
.........#.........#...#.#.#.#.....#...#.#...........#.......#.#
..####.#.#.#.#.###.#.##..#.#.#.###.#.###.#.####.##.#.#####.#.#.#
.....#.#.....#.....#.....#.#.....#.#.#...#.............#.......#
.###.#.###.#.#.#...###...#.#.#...#.#.#.#####.######..#.###..##.#
...#.#...#...#.#.#.#.....#...#.....#...#...#.....#...#.#.....#.#
...#..#..#.###.#.#...###.#.###.###...##..#.#####...##..#..##.#.#
.#.......#.......#.............#...#.....#.........#.....#.....#
#####.##############.#..####.############.##################.##.
