64
...........#.....#.........#.......#.....#...............#......
.####.##.#.#.#...##..###.#..#..#.#.#.###....##.#.#.#.#.#.#####.#
.............#.....#.........#.#.#...#...#.......#.#.#.........#
.###.#######.#.###....###.##...#.####..####..#.###.#.#.#######.#
...#.............#...#.....#...#...#.......#.#.....#.#...#.....#
##..##.#########.##..#.###.#.#.###.#..#..#...##..#.#####..##.#..
.#.....#.........#...#.#.#.#...#.....#...#.#...#.......#.#.....#
.#.#####.#########..##.#.#.###.#.#.#.#.###.#.#.#..##.#.#.#.###..
...#.....#.#.....#.#...#.....#...#.#.#.#.......#.#...#...#.....#
.#.#.#####.#.#...#.#...###.#.##.##.....#.##..#.#.#.#.##.#.##.#.#
...#.#...#...#...#.#.#.#...#...........#...#.....#...#.........#
####.....#.#####.#.#..##.#.#.#...##...##.#.#.##.##.#.#.#.#..##.#
.....#.#.#.#...#.........#.#.....#.......#.#.....#.#...#.#.#....
.##.##...#...#.###.##..#.#...#.##..#.#.###.##.##...#####.#....#.
.........#.#.......#.........#.....#....S........#.....#.....#.#
.#####...#..##.###.#.#.#.#.#.#######...#.#.#.........#....##.#.#
.....#.#.#.......#...#.#...#.......#.#.#.....#.#.#.#...#.#...#.#
..##.#....##.###.##..#..#.###.###..#.#..######.###...##..#.#...#
.#.#...#.......#.#.#.#.....#.....#...#.#.#...........#...#......
...#.#...#.###...#.#.####..#.##..##.##...#.#.######..#.#####.#.#
...#.#...#...#...#.#.#...#.....#.#.....#.#.#.........#.........#
##.#..##...#######.#.#..######...#..#..#.#.#.#...###.####.######
...#.#.........#.................#.#.....#.....#...#.#.........#
.###.###.#####.#.....###.#.###.#.#.####..#.##..#.#.###..##.###.#
...#.#...#...#.#.#.#.....#...#.#...#.....#...#.#.#...#...#...#.#
##.#.#.#...#.#.#.#.#####.###.###.###.###.###.#...###...#.###.#..
...#.#.#...#.....#.....#.............#.......#.#...........#.#.#
.###...####..###..##.##..#.#######...#####.#....##.#.#######.#.#
.............#.......#...#.......#.#.#.......#.#.............#.#
.#.###..##...#.###..##.##.#....#.#...#...###.#.#.#####.#..#.##.#
.#.#.#...#.#.#...#.....#.....#.......#.....#.#.#.......#...#...#
##.#.###...#.###.###.###.#####.####.##.###..##..#.########.###..
...#.......#.#.#.#...#...#.......#.....#.#...#...........#......
..##.#.#.#...#.#.#.#.#.###.#.#.#.#.##.##...#.##.###.##...###.###
.#...#...#.#...#...#...#...#.#.....#...................#...#...#
.#.#######.#.#.#.#.#####.#.###.###.#.#.##..#.###...#.#.###.###.#
.#.........#.....#...#...#.....#...#...#.#...#...#.........#...#
.#.#.####..#.#####...#.#.#.#.###.#..##.#.#.#.#.#.#..####...#.#.#
.#.......#.#.#.......#...#.#.....#.......#.....#...#...#.....#.#
.#.##..#.#.#...###.###..##.#.#.###.##.###..###.#.....#..###.##.#
.......#.#.#...#.......#...#.#.#...#.....#...#...#...#..........
###.##.#.#..##.#...###.#..##...#####.###.#.#...#..##..#########.
.....#.#.#.......#...#.#.#...#.......#...#.#.#.#.....#.........#
.###.###.#.#..###.#....#.#.#########.#.###.#..########.#.#.#.#.#
...#.....#...........#.#.#...#...#.....#.......#.......#...#.#.#
.....#.###.###.#######.#..##.#.#.#.###.#.####....#.#.#...#.#..##
.#...#...#...#.....#.......#.#...#.#...#...#...#.#.........#...#
####.#.#.#.#.#.....#######.#.###.....#.#.#.#.###.###.#.#.###.#.#
.......#...#.....#...#.....#.#...#.#.#.....#...#...#.#...#.....#
.#.######..#.##...##.#.###.#.#.#.#.#.####.####.#..##...###.#####
.......#.....#...#.#.#...#.....#.........#...#...#.......#.....#
.###.#.#.#####.##..#..##.##.####.#######.#.#.#.###.####..#.###.#
.......#...........#.#...#.#.............#.#.#.....#.....#.....#
.###.#.#.#.#######.#.#.###.#.#..###.#.#.##.#...#####.#.#.......#
...#.#.#.....#...#.#.#.....#...#.#.........#...#...#.#.#.....#.#
...#.....##.##.#.##..##...#.##...#..#..########...##.#.#.#.###..
.#.....#.#.....#.#.....#.#...#.#.....#.......#.......#...#.#....
..##.#.###.###.#.#.#####...#.#.###.#####.#.#.###.#####.#.#.#.##.
G....#.......#...#.......#...#...#.#...#.......#.........#.....#
#.##.#.#..#....###########...###.###...###..#..###..##.##.##.#.#
.....#.#.....#.......#.....#...#.....#...............#.#.....#.#
..###..#####.##.#......##.##.##.######.#..######.#.#.#.#.###.#.#
.....#.............#.......#.............#...............#.....#
#######.###.#################..#.##.#####.#..#######..##.#######
