16
...........#...#
.###.###.#......
.....#.#.#.#.#..
####...#.....#.#
.....#...#.#...#
.#...#.#.#.....#
.#...#.....#..G.
.######..#.#.#.#
.....#...#...#.#
.#.#...#######.#
.#...#...#......
##.##....#.##...
...#S..#.#...#.#
.#####...###...#
.............#.#
.########.#.####
