16
..........G.....
.#.#.#...#.#.#.#
................
...##.#..###...#
.......#.......#
..###..#...###..
.....#...#.....#
....##...###...#
S..............#
.#...#.#....##..
.#.........#...#
...###.#.#.#.#..
.#...#.........#
..#..#.........#
...............#
##.###.##.##.#.#
