32
.............#.....#...#........
........##.#.#....#..#.....#.#.#
.#.#....S......#.....#.#...#...#
..#.....##...#..##.##...##.#....
...........#...#.......#...#.#..
.#..#....#.#.#.####....#.##....#
.........#.#.............#...#.#
..#..#####.#.##..#...#..#...#..#
.........#...#.....#.......#....
........#..#.#..##..##....##.###
.#.....#.....#...#.......#.#....
..........#....#.#.#.#.##..###..
.#...#...#.............#........
..#..#.....#.#.#.###...#.#.#.##.
.........#.#.........#...#......
...####..#.....#..##...#...###.#
...........#.......#.#.#.#.#....
.......###.........#.###...##...
...#.......#.......#...#G#.....#
...#.#.......#.....#...#.#..#..#
.............#...#.............#
...#...###.#.#.#.#.#...#........
...#.......#.................#..
##...#.#...#....#.#...#......#.#
.......#.#...#.......#.....#...#
.....#.#.....#...#.....#.#......
...#.....#...#.....#.......#....
.#.#.#..#...........##.#........
.#...#.........#.....#.....#....
.##.####..###......#...##....#..
...................#...........#
.#.###.####.#..#...#.####.#.#...
