8
S..#...#
#..#.#.#
.#...#.#
.#####.#
...#..G.
.###.###
.......#
#.##.##.
