32
.....#..........................
...#.#.#...#.##..####.##.#.####.
....G..#.#.#...#.........#.....#
.#.#.#.#.#.#.#.####..#.#.##..#.#
.#.....#.#...#.........#...#.#.#
.####.##.#.#####.#.#.#.###.###.#
.#.....#.......#.....#.........#
.###...#.###...#.##..#...####..#
.......#...#...#.#...#.........#
###.##.#..##..#..#.#.#.######.##
.....#.#.........#.........#...#
.#.###.##..###.#.#.#######.#.#.#
.....#.#.....#.#...#...#.....#.#
..##.#..##.#.#.#.#.#.#.#.#.###.#
.....#...#.#.#.#.....#....S#...#
.#.#.###...#.#.###.#.#.##.##.##.
.....#...#.#.#.#...#...........#
..##.#.###...#.#.#.#.#...#.##..#
.#...#.......#.....#.#...#......
.#.######..###.#.#.#.###..###...
.#.....#...#.........#.#...#...#
.#.###.#.#.#.##..#.###..##.#.###
...#.#.#.#.#.#...#.....#.#...#.#
.#.....#...#.##.###.##.#....##.#
.#.#...#...#.#.....#...#.......#
.....#.#.#.#.#.#...#.#.#######.#
.........#.#...#.#...#.........#
...#..#.....####...#...#.#.#.#.#
.#...#...#...#.#.#.#.#.....#...#
.#####...###.#.#.##..###.#.#....
.......#...................#...#
#.##.##.##############..###..###
