16
...............#
.######.####.#.#
.........#.....#
.#..##.#.#.#.#.#
...#.......#.#.#
.#.#......##.#.#
.#...#S..#.....#
.#.#..##.#..##.#
...#...#...#...#
...#.#.#######.#
.#.#...#.......#
.#####.#.###.#.#
.#.....#.....#..
.#..####.#.###.#
...........#..G#
#######.########
