16
.........#......
.#.#.#.#...#...#
...#.#.#.......#
.##....##...####
...#.#...#.#..S#
.###.#.###.#..##
.....#.....#.#.#
.####..#.#.#.#.#
...........#...#
.#...#...#.#.#.#
...#.....#...#.#
.#####.##..###.#
.....#.....#....
.##...#.#..#.#..
..G#.........#.#
#####.#.###.####
