8
.......#
#.##.#..
..S.....
.#.###..
.#......
...##..#
...#..G#
#....##.
