64
.............#..................................................
.#...##..###......#.##..........#..#.#.##..#...#.#..##.....#.#.#
.#...#.......#...........#.....#.#.........#...........#.#......
...#......##.##.....##.#.#.#.#.#...#...#.##..........#.#.#.###..
.#.#.#.#.........#...............#.............#.........#......
...#...#....##.........##....##.......#....#.#..###..#.#.#...#..
..G........#...#.........#.#...................#.......#.#.#....
####..####.......##.#.#....###.........#...###......#..#.#...#.#
.........#.#...#.......#.#.......#.......#...........#..........
.##........##....##.#..#..##..#..#.####..#...#.......#...#.#.#.#
.............#.#.......#.......#.#...#.........#.....#.#.....#..
.#.#..#..###..#..#.....#...##........#.#.#..#..##..#.#.#...#.#..
.#.........#...#.#.........#...............................#.#.#
..#.#....#...#.#..##...#.#.###.#.....#...........#.#..##...#.#.#
.#.....#...#...............#.......#.........#.....#...........#
...###........#...##.#...#.#.........###.#........#....#.###...#
.........#...............#.........#.......#....................
##...##..#.###.......###..#..#...#..##..##...#.##....##.#....#.#
.......#.#...............#...........#.......#...#.......#.....#
.#..#..#.....#....#..#.#..##.#.#........##...#.#.#....#...#....#
.........#...................#.......#...............#.....#....
..####...#.##..#....#..#.#.##...#..#...#..#..#...##.#..##......#
.#.......#.......#.#...#.....#.........#...........#.......#...#
.#..##...##....##......#.#...###.#..##.#.#...#.#...##..#....#..#
.............#.............#.....#.......#.......#..............
..##..#..#.......#.##.#.#..#..#......#.#...##...##.###.#.#...###
.........#.............#...#...#.#.#.#...#......................
.#...#.#.#...#.#...###.#..#....#...#....#....#.###.#....#####..#
.....#...#.#...#...#.......................#.................#..
#####..##..###...###.#......#.##.....#...#.#.....#...####..#.#..
.........#.......#.......#.....#.#.....#.................#......
.#.#.##..#.#....##....#..#..##.#.#....#..#.#####.#.....#........
.#.....#.........#.............#...#.#...#.........#.......#.#.#
....##.#...#...#.#.....#..##.#.......#....##.#..#....#...#.#.#..
.........#.....#...#...#.....#.......#.#..S..#.........#........
.#...#...#...#..#....##..#.......#.###.#.#.#.##.#.#..#...#.#....
...#.#.#.....#.......#...#.................#.....#.........#....
.#.....####..#.........#.#..##.##....###.#.####..#...#....#..#..
...#.........#...........#.....#.....#.....#.......#...#........
...##..#.##.#.....#..###.##.##.#.###.#.##......#.#####.#.#..#...
...................#.#.#.......#.#...........#.........#.#.#....
.....###.######..#...........#.......###.#....##...##......####.
...............#.#.........#.#.....#...#...............#.......#
##.#.....#.##..#..#........#...#...#.....#...#.###.#.###.#.#....
.......#...#...#.................#...#...#...#.........#.....#..
.#.....#.##.......#...##..#.##.#..##....#..#.#.#...#.#......##.#
.#.......................#...#.............#.........#.#...#....
..##..#...###..#...###.#.#........###.##....#..#....#..###.#.#.#
.....#.........#...#.....#...............#.........#...#.....#.#
.#.#.##.#......##..#.#.#.#..#.......#.#.##....#.#........#.#...#
...#.#.............#...........#...................#.#..........
.#.#.#.#....##.##..##.##.....#.#.##..#.#.##..#..##...#...#.....#
...#.#.#.....#.....#...............#...#...............#.#......
.#...#...##....#.#.#...#.#....##........#..#.#..#..#.....#.#.#..
.....#.....#.#...#.......#.......#.........#.........#...#.#...#
....##.#.##..#.#.##....#.#####.#..##.###.#.#.....#.###...#.#.##.
...#.........#.......#.............#...#.........#.#...#.......#
.#.#..#..#..#..#.#....##..#.....##...........#....##........##..
.........#.#.......#...#.#...#...#.#.....#...#...#..............
.#.#.#.#......####.....#.#...#......#.#....#.....#......##...#.#
.......#.....#.........#.#.............#.....#..................
.#.#......#....#..#.#.##....##.##..#...#.#.#...............#....
...............#...................................#...#...#....
....###...##..###...##...#..##..##....#..#.##..#.###..##########
