64
.....................#.......................#...#...#.........#
.###########.###.#####.###.#.#..####.###.###.#.#.#.#.#######.#.#
.#.........#.........#.#.....#.#...#.#...#...#.#...#.........#.#
.####..#.#.#####.#.#.#.#...#...#...#...###...#.#####.#.#####.#.#
.......#.#.....#...#.....#.....#.....#.............#...#G..#....
##.###.#.#.#.#.###..#....###..##.#####.#.#.#.#.#.#.##..#.#.#.###
.#...#.#.#...#.......#.....#.#...#.....#.....#.......#...#.#...#
.#.#...###.#.#..####.#####..##.###.###.#.#..####.#####.#.#.##..#
...#.#.....#.#...#.......#...#.#.......#.......#.........#.#...#
.###.#.#.#.#...#.##.####.###.#.#.#.#.#####.#.#.#####.#####.#..##
.......#...#.#.#...#.........#...#.#.#.....#.#.#.......#........
.#.###.....#...##..#.##.##.###.#.#.#...####..#.#.#.#.###.####..#
.......#.#.#.....#.#.#...#.....#...#...............#.....#......
.#######.#..###.##.###.#.#...##..#.##.####.###.###...#.#.#.#####
...#.....#...#.....#...#...........#.....#...#...#...#.........#
##...###.###.#..####.###.##..###.#.#####.#.#.#.#..##.#..#.##.###
.#...#...#.#.#.....#.#.......#...........#.#.#.......#.........#
.#.#...###.#.##.##...##.##.#.####..#.###...#.#.#.#.#.###.##.##.#
...#.........#...#.........#.#...#...#.....#.#...#.#.#...#...#.#
.#.##.##.##.#..#.###.#######.#.#.#.#.#####.#.#####...#.#.###.#..
.#.#.....#.....#...#...........#.#...............#...........#.#
.##..#.##########..#.###.##..#...###.#.#########.##..#####.#.#.#
.#.........#.....#...#.............#.#...........#.....#.......#
.#.#####.#...###......##...###.###.....#.###.##..#..##.###.#.#..
.#.#.....#...#...#.#.....#...#...#.#.#.#.....#.....#.#.....#.#..
.#.#.###.#####.##..##..#.###.###.#.#...#.#######.###.###...#.#.#
...#.......#...#.....#.#.........#.#.#...........#...#.....#.#.#
..###...#..#.#.#.###.#...#########.#.#.#########.#.....#####.#.#
.....#.#...#.#.#.....#.....#...#.......#...#.....#.....#...#...#
###..###.##..#.#..##.#.###.#...########..#..##.##..#####.#.#.#.#
...#.#...#.#.#...#...#.......#.........#.....#.....#.....#.....#
.#.#...###.#.#.###.#.#.##.#....#.#####.#.###.###.#.###.##..#...#
.#.#.........#...#.#.#.#.....#.......#...#.......#...#...#...#..
.###...#.#.#.###.#.###.#.#.#.####..##.##...#####.###.###..####.#
.......#.#.#.....#...#.#.....#.................#.#.......#.#....
.#.#.#.#.#...###.#.#.#.#####...#.#########.#.#.#..#.####.#.#.###
.....#.#...#...#...............#.........#...#.....#.......#.#.#
.#.###.#.#.#.#.#.#.###.######.####.###.#..##.#.##..#.#.#...#.#.#
.#.......#...#...#...#.....#.......#...#.....#...#.#.....#.#...#
.#.###.#####.#.#...#.#######.#####..#..######.##.#.###.#.#.#...#
...........#.#...#.#.......#.#...#...#...............#...#.#...#
...###...#.#...#.#...##..#.#...#.##....###.######..#.#.#.#####.#
...#.....#.....#...#...#.#.....#.................#...#...#.....#
.###.#.####.#.##.#.#.#.....#.#..##.#.#....##..####.###.#.#...###
.....#.#...#...#.#.#.#.#.#...#...#.#.....#...#...#.#...#.....#.#
.#..##.#.#.....#.#.....#.###.###.#.##......#.#.#.#.#.##..#.#.#.#
.#.#...#.#...#...#.#.#...........#.#...#...#.#.#...#...#........
##.#.###.##..######..#..#...####.#.#.###..#....#######.##.####.#
.........#.....#.....#...#.#.#...#...#.....#.#.#.#...........#..
.#########.###...#.##.#..#.#.#.###.###.#.#.#.#...#.##..###.#.#.#
...#.....#...#.........#.#.#...#.......#.#.#...#.........#.#...#
##.#.###...####.##.#####.#.#.####..#...#.#.#.#.#.#.###...#.###.#
...#.#.#...#.....#.......#.#.........#...........#...#...#......
.###.#.#.#.#..##.###.#####..##..###########..#...###.#.#.###.#.#
.......#...#...#.#...#...#...#.#...............#...#...#.....#.#
..##.#.####.##...#.##..###.#.##....#...##..##.####.###.###.###.#
.......#.....#.#...#...#.........#.#...#.....#.....#.....#......
#.####...###...#..###..#...#######.#.###.###...#####.#.#...##.##
.......#...#.#.#.#...#.............#.....#.....#...#.#.#.#.....#
#..#.#..##.#.#.###...########.##.#.#######...#...#.#...#.#.#.#.#
...#.#.......#...#.#......S..#...#.....#...#.#...#...#...#.....#
..##########.##..#.###.#..##.#.#...#.....#.#.#.#..####...#.###.#
...............#.......#.....#.#.....#.....#.........#.........#
###.########.######.###.###.####.###.##.##...##..###.##.#####.##
