16
................
.###.#.#####.##.
...........#...#
.##.###....###..
.#.......#...#.#
.....###.###.#.#
...#.....#S..#..
.#.###.#####.#..
...#.#.....#.#.#
.#.#.###..#....#
.#.....#.#.....#
...###.#....##.#
.#.........#...#
..##..##.#.#.#..
..G..#...#.....#
#######.######..
