32
.#.....#S....#.................#
.#..#..#.##..#...#..##.###.....#
...........................#....
.#.#.#.#..####...#..#..###.#.###
.....#.#.#.............#...#....
.####....##........#.#.....#.#..
.......#.....#.......#.#........
..##....##...#...#.#.#.###..#..#
...........#.....#.............#
###....#.#.....#...#.##..#...#.#
.....#...#.............#...#....
....##..####.#.#.###.##..####..#
.#.......................#..G...
...##.##.###.#.#....#..#........
.......#.#.......#...#.....#...#
.###.#.............#....#....#..
.................#.#............
...##....#.#.#..##...#...#.#.##.
.#.......#.#.#..................
...#.#.##..#.......###.......#..
.#.#...........#...#.........#.#
.........##...#..#...#...#.#.#.#
.#.......#.....#.#.#.......#....
.#..##.#....#..#....###.#..#.#..
.#.#.#.......#.#...............#
...#..#.#.#..#...####.......##.#
...............#.............#.#
....##.......#.#.#..#......#.#.#
.........#.#...#.......#........
.#...#.#.#.#...###.....#.#.....#
...................#.....#......
...#..#.#######..##..###...#.##.
