8
........
...##...
.#..S..#
.......#
.#......
.#.#.#..
G......#
.###.###
