64
.............#...........................#......................
.#.#...#..##.###..#..#..#..#..#......#.....#.#.....###..##...#.#
.....#.....#.......#...#.........#.....#.....................#.#
.#..##.....###.#.#.#..#......#.#.......#.....#...#..#.....#..#.#
.........#.....#...#.....#.....#...........#.#.#.........#......
##.#.#.#.##..#.#.#.#...#..###..#..###..###.......###.#.....#...#
.............#.......#.#.#.......#.........#.........#...#.#...#
....#.#####..#.#.#.#...#.#.#...#...#..#....#.#.###...#......##.#
...............#.....#..........................................
.###...#.#.....#.#...#..#.....#........#..#..#.#..#.##.###...#..
.....#...........................#.#...#...#...#................
.........#..##....###..#.....##..#.#....#.....#....##.##.......#
.......#.#.....#.............#...........#.....#.............#.#
.#.#.#..#..#.#.#####.........#..###.#..#...#......#..#.###......
...............#.....#.....#.#.....#.........#...#.#.......#...#
.#..#..##.#..#....#..#..##...#.#.....###.#......##....#..#.##...
.#.....#...........#.#...#.......#.............#.....#...#.....#
...#.##..#.#.#.##.#....#.#####......##.##..#...#....##...###.#.#
.......#.#...#...............#...#.....#.........#.....#.....#.#
...###...#.....#.##..#.#...####....#.#.#.####.......##.#...#....
.#.....#...#...........#.#.......#...#.#.#...#...#...#..........
...#.##.#..#...#.#.###.#.....#..##...........###..##.#.###.#.#.#
...#.........#.#.......#...............#.#.........#.....#.....#
..#.##...#......####...#..#.......##.#.#.........#..###....##...
.......#...........#.#.............#...#.....#...#.....#.....#..
.#.##..#.#..#...#..#..#.#.####.##..#.....#..#..##..#...#..##.#.#
.........#.....#.#.......#.........#.....#.....#................
......#.###..#.#..#.#.#......#.#...###.....#####.##...##..##.#.#
.....#.......#.#.......#.....#.......#.........#................
.###......#..#.###.....#..#........#...###.#.#..##......#..#.#.#
.#.#...#.#...#.........#.......#.#.#.........#...#...........#.#
.#.#..##.#...#...#.#.....#.#.#...#..#.##...#.##..####..#.#...#.#
.#.......................#.#.....#...#S....#.....#.....#.#......
.#...#......##.#.##....#.#.##...####...#...#.##..#..#.##.#...#..
.......#.......................#.........................#.....#
..#..#.#.#.#.#.#....##.#...#...#.....#.....#...#..#..#..#.#..#.#
.....#...............#...#...............#......................
.#.#.##...##.##..........#..#####.###....#...#.#.#..#........#..
.................#...#.#.#.#.........#...#.#.............#...#.#
.##.##..###.#..#..#..#.#.#.#...##..#..#..#.#.#..#.#.#..#.##..#.#
.........#...........#...............#...#......................
.#.#.#.....#...###.#...##.#...#..#...#..#....#...#.##.##..#.##..
...#.....#.....#.....#...............#.#.......................#
.#.###.#.#.##..##..#....#....##.##.#...#.#.#..##...#......##.#..
...#...#...............#.............#.................#........
.#...##..#..#..#.#.#......#..##..##......#...#...#.#.#..#....#.#
.............#.........#.........#.........#.....#.#.#..........
..##.##..#.#.#.#.#..#..###.###..#....#.#.....##..#.#.###.#....#.
...............#.........#...#...#.....#.................#.....#
#..#.......##.....#...#..#..........####.#..###...#..#.##...##.#
.#.....#.....#...#...#...................#.....#...#.#.#.....#..
.#..##.#...#...#...#.#.#.#.#.#..#.#..#...#..#..###...#.#..#....#
.#...........#.................#...#.#.#.......#...#.....#......
.....#.#...#..#....#.###......###..#....##..#....###.#.##......#
.#...............#.......#.#...........#.......#.....#.....#...#
.#.#...###.#.#.#..#..####..##.###..#......###....#.##..#.###.#..
...#.....#.#.........#.....#.....#.................#............
..#..#.#.#.....#..#....#.#.###.#.#.###.#.#.#..##.#....#..#..##..
G..............#.....#...#.....#.#.........#.......#...........#
.....#.....#.###.#.#.....#.#.###.#...##....##....#.#..##.#.##...
.#.........#.....#...#.#.............#.........#.#..............
....##...###.##..##..#........#...#.#..#.#.#.#.............#.#.#
.............#.................................#...............#
##.#.#..#..#.##..###.##..#.####.##.##.#.##..###.#..###....#.#.##
