8
.#.....#
.#...##.
.#.....#
.#.###.#
.#.#..S.
.#.#.###
G......#
########
