64
...........#....................................................
.......#.......#.#.#.....#...#.##...#....#..#..#..##.#...#.###..
.....#...#.....#.#.....#.........#.#...........#.......#........
.#.#.#..##.###...#.#.#...#.#........###.#.#.##.#.##....#####.#.#
...........#.#...#.#.....#.#.....#.#............................
....####.......###...####.....#..#.......#...#.........###.#.###
.......#.......#...........#...#...#...#...#...#...#.#.#...#....
#..#...#.####....#.......#.###.#.#.#...######...##.....#..##.#..
.............#...................#.#.#.............#...#.......#
...###.##.##.#.#.#.#.##....#.#.#...#.#..#....##.#.##...##....#..
.#.......#...............#...#...#.#.....#.....#................
...#..####.#..##.#.###.#.##.#..#.#.#.........##..#...#.....##..#
.#.#...#.....#.............#...........#.....#...#..............
.#.###...#......###..#.###.........#...#..##....#..##.#..#..##.#
.....#...#.........#.....#..........S#.#.....#.#...........#....
.#.#.#.##..#...#.#...#...#...#.#.#.##...#..............#...#....
.........#.....................#.....#.....#.#.......#.#.#.....#
.....#.#...####.##.##....#.##.....##.#.#.#.#....#...#....#......
.....#.....#.........#...#.#...#.#.#...............#...#.#...#..
.##....#####.#...####..#.#.#.#...#.##...#.##.#...#.#..#....###.#
.#...#...#...#.#.#.....#...#.....#...................#...#.#...#
......#..#..##...#.....#..##..#..#...#.#.....##..........#.#...#
.....#.#...........#...#.........#.............#.........#.....#
.###....#.##....##.#.#......#....##...##.#.......#..####...#.#..
.................#.#.......#.......#.......#.#...#...........#.#
.#...#.....#..#.......#.........##.....#...#..##.#.......##..#..
...#.....#.#.....#...#.......#.......#.#.......#...#...#.....#..
..##.#..###..#..........#.##...#.#......####..#...#...##.#...#..
.....#.....#.........#.......#...............#.....#.#...#...#..
.#...#..##.#.....#.###...##........#.#.....#.....#.#.....##.##.#
.#.#.........#.#...#.............#...................#.........#
...#...#.#.#...#.#.#...#.#.#...##..#.#.....##....#.#.#...###..#.
...#.#.....#.........#.........#.......#.#.......#.#.#.........#
.##........#...#.#.....#...#.#.#...#...#....######.#.....#......
.......#.....#.....#.......#.............#.........#............
.#.#...#.##..#.....##.....##...##..##..#.......######....###....
.#.....#.#.....#.#...#.................#.............#.........#
.###.......#.#.#..#....#.#.#.....#####....#..###.#.#...#..##....
...#...#.......#.......#.#.#.#.#...........#...#.#.#.#.#.#.#....
##.#.#..#.#..#.###...#.#...#....#.#..#..##..##.#.#.#.###.#.#.#.#
...............#...#.....#.................#.....#.......#.....#
..##.#.#.......#....#.#....#.#..##.....#.##..#..##.##...##...#.#
.......#.....#...#.....#.......#...#.#.....#.#.......#.......#.#
#..##..#.###...#...###.#.#.#.###..#....#...#.#.#..##.#.......#.#
...#...#.#...#.#.....#...................#.....#.......#.#......
..#....#.#..#..#..#......#.#.#..###.##.#...#..#..###.#.#....#...
.......#.......#.#.......#.......#.....#...#.#...........#......
...#...#.#.#.##..#.#.#...#.###.....#####..#..#.#......#...#....#
...#.................#.#.....#.#.......#.........#.........#....
.#.#..##...#...#...#.#.#......#..###.#.#.##..#...#.#.##..#.#.#..
.........#.#.......#.....#.#.....#...#.......#.#.............#.#
.#..###.......#................#...#.#.#.....#......#.....##.#..
.....................#.#.....#.............#....................
.....#.##......#.....#.#...#.#..........#####..#.#.#.##.#....#..
...#...............#.................#.#.......#.#.........#....
.#.#....#..#..#..#.....###.....###.#.......###...#.#.#.#..#..#..
...#.....#.#.#.......#.............#.#.....#...#...#...#.......#
.#...#...#..........#.#..#.....#####.#..##.....##....#..##..###.
.........#.........#.............#...........#.......#...#.#....
...##..........#...#.........###...#...#.#.###...#.##.#..#.#....
G....#.........#...#.......#.......#.#...............#...#...#..
.#..#....#....##.#.....#.#.#....#..#......####..##...#.###.##...
.........#.......#.........#.#.....#.....#.........#...#.......#
#...###..##...###.......#.#.#.#..#.........##..#.##.#..#..##..#.
