32
................................
.......#.............#.#....####
...............#.....#.#.#......
.#...#...#..#..##.##...###.###..
...#S#.#.....#...........#.....#
.#...#.....#.....###...#.##..#..
.#...........................#.#
...###.......##..#.###...#...#..
.....#...#.....................#
.#.....#....##.#.##..###...#...#
.#.......#...#...........#...#.#
.............#.###..##.#.......#
.#.........#....................
.#...#.#....##.#.#...#.#........
.#.......#.....#.....#...#.....#
.....#.#...#.#...#.#.#.....#...#
.#.#...#...#.....#.......#......
....###..#.#.###...##..#.#...#.#
.............#...#.........#...#
.#.###.#.##..............#...#..
.....#.#.#.....#.......#....G#.#
.####..#...#.#.#.....##.#...##..
.#...#.......#.#.....#..........
.#....###.##.#...#..##.#.##.#..#
...#.............#..............
..#..#..####.......#.....#......
...#.............#.....#...#....
#.#..##..#...#.....#.#.........#
................................
.#.##..#....##...#.....#####.#..
.................#.............#
.#.##.###.##..##.##.#.#...##.##.
