64
.#.....#...................#.....#.#.....................#......
.#.###.#..##.#.......#..#....##..#....####...#.#.#....#...##...#
.#.#.........#...........#.#.....#...#.....#.....#.#.........#.#
.#...###.....#..#....#.#...##........#.#..#...#..#.#.....#.##...
...#.....#.#.#.......#.............................#.#.........#
.##....#.#..#..#.#.#.#.#...#.#.#.#.##..##..#..##..#...###.......
.....#...#...#.....#...#.....#.......#.....#...............#....
...#...#..##...#..####.#.#.###.#.#.....#.#...#.##..#..###..#....
...........#.................#...#.......#.#...............#.#.#
##.#...###.#....#..######...##...#...........#...............#..
.........#.#.............#...........#.......#.....#.....#...#.#
.##.##.#...#..##.#.#.#...#...#.#..##...#.#.##..#.#...#####.#....
.......#...#...#.....#.........................#.............#.#
......#....#......##...#.##....#..#####...#.......##..####...#.#
...............#.#.....#...#...........#........................
##..##.#..####.#...##.#.#..#...##...##.###..#.#..#.#.#.#...###..
.................#...............#...........#.....#.....#.#....
.##..#.......###.#.#.#.#.#.#..#....##.#.........#..#..##...#.###
.......#...#.............#...#...........................#.#....
##..#..#.##.#..#####.#.#...##..#.##......#.....#.##......#..#...
...#.#.........#.......#.#.......#.......#...........#.#.#.#...#
...#.#.#.....###...#...#.#.###.#.#####.....#.#.....#...#.#.#.#.#
...#...#.........#.#...#.#.....#.......#.......#.......#.......#
...###...##.....##..#..#.#.#.#.....#...#..##...#..#.#....####...
.................#.......#...........#.#...#.........#...#......
.#...#...........#...........#.##.##...#.#..#.....##.#.#...#.#.#
...#.............#.......#.#.............#.....#................
..#....#..##...#.....#.#.#.#...##...#......#....##.#.####....##.
.....#.......#.#.#.#.#.....#.......#.........#...#.........#....
...#...###.#.#.#.#...#.##...#....##..#...#.#...#.#.#.#.##..#.###
.#.#...#.....#.#...#.....#.....#...#.#.....#...........#...#...#
...#..##.##........#...#.#.#.###...#.#.............#.#.#.####...
.#.#.#.....#.............#...........#...................#...#..
.#.#...###..##.#.#.#.#...#...###.#.......#.##....#.#.#.#........
...#.....#.....#.#...#...#...................#...#.........#...#
.#......##...#...#.....#...###.#.#..##...#............#..#..####
.#.....#.....#.#.....#...#...#...........#.......#...#.#.#.#....
....##.#...###...#.#.....#...#.#.....#...#.#.#.##.##...#........
.#.....#...............#.#.....#.#...#.....#.........#...#...#.#
.#.#.#.....#.#.#.#.#.....#.#.........#.#.......#...#.#..##.#.#.#
.#.........#...................#...........#.#...#...#.........#
.#....#.##.#.#.###.#...#####..#..#...#.#.##...#..##..#####...#..
.....#.....#...#.....................#.......................#..
..#.....##.....#...#..#.#..###..........#...#......#.....##.##..
.....#.......#.................#...........#.........#..G.......
#..#......#..#...#......#....###.#.#.....###..#....#...##.###...
.......#...#...#.....#...#...........#.#.....#...#.#............
#..#...##.......##....#.....#.###.##..#..#...#.#.......#.#...#.#
.....................#...#.........#.....#.....#...#...#.#...#.#
.#.........#.###.#.#....#..#.#.#..#......###.#.####..#.#.....#.#
...........#.....#...#.#.#.....#.......#...........#.........#..
###......#...##.....##.#.#......##.###.#.#.###...#.#.##.#......#
.......#...#.......#...........#.......................#........
..#...........####.#...#.#..##.....##..###...#.#....#....#..##..
.#.....#.#.......#.#.#.......#.........#.....#...............#.#
....##......#.#...##...#..##..##..#..#...#.#......###...#..#.#..
..S..................#.....#.............#.....#.....#.........#
.#...#####.#......##....##.##...###.###..#..##.##......#.#.#...#
...................#.....#.............#.......#...............#
....##.....####...#..#.#...##.##..###..#.....##...#....#####..#.
.#.....#.#.....#...#.#...#...........#.#...#...#...#.#.....#...#
.###.....#.#...#.....#.......#..##.#.#.###.#.#...#.#.#.#.....#.#
.........#.......#.........#.....#...........#.....#.....#.....#
.##.#..#.#...#.##...#.##..#..#..#.#########...##.####....#.#.##.
