32
...................#............
#.#.#.#..#.#...#.##......#......
.............#...........#.....#
....#..#.##..#..##.#..##....##.#
...............#...............#
....#...##.##.......#..###.#....
.........#.....#.#..........G..#
..#...##.....#....#..#.##.......
.....#.........#.#...........#..
....#..###.#...#.#..#...##.##...
.....#...#.......#.............#
...#.#...#.....#.#.....#...#.#.#
...#.....#.............#...#....
#.....#...##..##.###.#.#.#..#...
.......#.......#................
###..#.........#.....####..###..
.....#.......#.....#...........#
.#.....#.....#.#.....#...#.#...#
...........#.#...#.#............
.##..###.###.#.#.......#..#.#..#
......S......#..................
.####...#..#####....##.#.....###
...#...#.......#.......#........
.#.#...#.#..##.#...#.##.##.#.#.#
...#.....#.#...............#...#
....#.#..#.#.###.....#...#.###..
.............#.#.......#.....#..
.#.....#.......##..###...#......
.............#.........#...#...#
##...#...#.###..#.#.#.##.#...#..
.......#...#...................#
#..#.##..##.###.#.#.....#####..#
