16
...............#
.###..##....##.#
.#.............#
.#.........#...#
................
#....#.#..#....#
................
.#..##....#...#.
..............S#
.#.#...#..#....#
...........#.#..
.#..#..##..#.#.#
G#...#...#.#.#.#
.##...#.....##..
.........#.....#
...#......#.#.#.
