32
...#...........................#
.....#.#.####.#####..##..##.#...
.#...#.#.#.........#...........#
.##.####...#.##.##.#########.#.#
...#.....#.#.......#...........#
##...#####.#.#.#.#.#.##..#.##.##
.......#.........#.....#.#......
.#.##..#.##..#.#...###.#.##.##.#
.............#.#...#...#.#.#S..#
.#.#.#.##.##.###.###...#.#..####
.............#...#.....#.#.....#
.##.##..####.#...#.#.#...##.##..
.......#.......#...#.....#......
...#####....####.###.#.#.#...#.#
.............#...#...#.........#
.#.#..##.###.#.###.######.#..###
.....#.......#...#.#.......#...#
.##....#.##..##....#.###..###..#
.........#...#.................#
...##.###..###..#..###..##.#####
.#.....#...#...#.#...#.#........
...#.###.##..###...#.#.#..##.#.#
.........#.....#...#...#...#.#.#
##.##..#.#..#....#..####...###..
...#...#...#.....#.......#......
.#.#.####.##.#...##..###.#.###..
.#...................#.........#
.####....##..#.#.#..##.....#.#.#
..G....#...#.#...#.............#
######.##..#.#.#.#####.#.#..#..#
.......................#.#.....#
##.#.###############.#.######.##
