64
...................#...#.....#...........#...........#.......#.#
#....#...#.#.#...#.#.#.......#.........#.#..#.#.#..#...#.#.#.#..
.....#.#...........#.#.....#...#...#...#.#.......#...#.#.#...#..
.........#...#...#...#.##.####...##.##...######......#.#...##...
.............#...........#.............#...........#.....#.....#
.#..#....#.#.#.......#.......####..#...#.#...#....####.#..#.....
.........#...#.....#.......#.#.......#.#...........#.......#...#
....#..#.....#.#...#####.#...#..####.#.#...#.###.........#.#.#.#
.................#...............#...#...........#.#.....#.....#
.#......#..#...#.#.#...##.....#.....#.#.#....#...#.#.#...#.....#
.#...#...#...#.....#...#.......#...#.......#...#.........#...#..
...#...#......##.............#.#.#.#...#.#.#...##..#.......#...#
.......#.............#...#...#...........#...#.........#.#......
.###...#.......###.#....##.##..#.........#...#.#.#..#.#.....##.#
.......#.#...#...#.........#...#...#.....#.#...#.....#..........
..#....#.#....#.....#.##.#...#....#..#.#.....#.##......#.#.#.#..
.........#.#.......#.....................#.#...#.......#.....#.#
..##...#...#..##...#...#.#.###.#...#####....#.##...#.#.#...##..#
.....#.#.....#...#...........#...........#.......#.#.........#.#
##...#.#.#.#...##..##...........#..#.....##....#.#..#..#.#...#..
.#...#.....#.......#...#.......#.......#.....#...............#..
.#.#.#......#....#.#.#.......###.#...#..##......###..#.#.#.#.#..
.........#...#.#.........#.#.....#.#.#.....#.#...#.....#........
.##...##.#......#.....##.#.##.##.#.#.##.##..##.#..#........###.#
...#.#.......#...........#.......#.......#.........#...#........
##.....#.#.#.#....###.##...##..#.#.##.##..#..##.##.#..#.#..##.#.
...#.....#.#.#.......#...#...........#...#.....................#
.##.##.#......##.#...#..####...##.#..#...###.#...####...#.#.#...
.........#.#.......#.......#.........#.........#.....#.#........
#....#...#.....#....####.....#..#......#.#.#.#.###...#.......#..
...#....G#.................#...#...#.#...............#..........
##.####..#.#...##.##.###.#.#.#...#.#....#..#.##..#..#..##....#..
.......#.#...............#.#.........#.#.....#.........#.#......
.#.#.......#.##.#..#.....#......##.#.#.#...#..#.....#..#.#.....#
.....#...#.................#.......#.........#.....#.....#.#....
.#...##.###..#.#####.....#......#..#.#.......#.#.###.#..........
.................#.........#.#.....#.....#.....#.............#..
...#....#.#.####.#...#..##....##.#.#..##.#.....#.#.....#.....#.#
.......#...........................#.....#...#...........#.#.#..
.....#..##.....#.##..#...#.#...#.#.#......#..#.#...#....##..#..#
...#.......#.......................#...............#.#.......#..
.#.#.#.###.#.#...#.###...#...#...#.##...#.#...###.#..#.#.###.#.#
.....#...#.#.....#.#.........#.#.............#.......#..........
.#.....#....####.#.#...#..##.#.#.#...#.....####.###...##.......#
.#...............#.............#.........................#.....#
..#.##......#..#.###..#......###.#....#..#.#..##.....##.#......#
.........#.#.#.............#.........#.........................#
...##.##...#.#.....#............#.##.#.#.#...#.........#........
.......#...#.#.#.......#...#.............#.#.........#.#...#.#..
..##.#...#...#.....#........#..#.##....#.#.#....#..#.........#..
.....#...#...#...#.....#.....#.....#.#.#.....#...........#...#..
.#......#.##.#.#...#.#.#.###.......#.#.#.#...#.#.#.#.#.#.##..#.#
...#.............#.#.........#...#...........#.....#...#.....#..
.#...##....##.##...##.###...#..#.###.###.##......#..#..#........
...#.............#.........#...#.................#.....#...#.#..
.##.........#.##...##.##.###.#.#...#....#.....##.#.###...###....
.#...............#.....#.#.#...........#...#...#.....#...#.....#
....#..#..##...#.###.....#.#.#........#..#.###.#...#.........#..
.....#...........#.........#.................#.#...#............
..##.#.#..#####..#.......#....##.#...#.....#...#.##..#...#####.#
.............#.....#...#.........#.................#.#...#...#.#
...#.....#.....###.....#.#.#...#.#.#.#.......##..#.#.......#...#
.#........................................S#.....#.........#....
...#.###...###....#.#.#.#.#...#..#..##.###..##.##.#.#.#.##.#..#.
