32
.....#..........................
.###.#.#.#...#....###.......##.#
...#...#.#.#.#.#.....#.......#.#
#....###.#.........#.#.#.#.....#
.....#...#.....#.#...#.........#
..#..........#.#...#....#.......
...........#...#.#.....#...#...#
.....#..##...#.#...###.#.##.#...
...#.........#.....#.......#...#
.............#.....#.#...#...###
.#...........#.#...#...#.#.....#
.#.#####..#.#....#.....###.#....
.....#...........#..S#..........
.##.....##...#.#.#..#..#......##
.#.....#.#...........#.#...#...#
.#.....#.#.#.##.##...#.###......
.....#...#.....#...#.......#.#.#
.#....##...##..#.####....###...#
.........#...#.#.....#...#......
...#.###.#...##..#..#..#..##....
.#.#.........#...#.....#.......#
...#.........#..#...#.#.#.#.##..
.#...#.....#...#.#..............
.#.#...#.###.##...#.#.....#.....
G............#..................
.#.#.....###......##.#..##.##..#
.#...#.........#...#.....#.....#
...###.##..#.##....#...#.......#
.#.......#.............#.......#
...#.##..###......####..##.##..#
...#............................
#..#......#.##..#..#.....##..###
