64
...........#...........................................#........
..#..#.#...#..###..####.#..#.#.#..#.#.###.##.#.#.###.#.#.#.###..
...........#...#.........#...#...#.........#.#.#.........#.....#
..##.###.#.###.#.#.......##.........##.....#......##.#.#..##...#
.....#...#...#.......#.....#.............#.....#.....#.#........
...##.....###....#...#.#...#..#....#.#...##.##.#..#....#..#..#..
...#...#.............#.#.#.#.............#.........#.#....G#.#..
.....#.#.#.#.#.###....##....#...#...#..#..#.#..#.#...#.##.......
...................#.......#...............................#....
.....#..####.#.#####....##.......#.#...#.#.#.....###..#....#..##
.#...#.......#.....#...#...#.#.......#.#...............#.#.....#
......#.######.###.#...#..#...##.......#.#...#.#...#.##..#.###..
.......#...#...................#.......#.........#.........#...#
...#.#.#.#.#..##...###.#.#.....#.....#.##..#.##..#.....#.....#.#
...#.#...#.....#...........#...#.................#.........#...#
.#.#..##.#.###.#..##...#.#.#.#.###...#...##.#..#.......#.#......
.....#.................#.#.......#.........#.................#.#
........#......##....#.##..#.##.....#.#.##.#.......##..##.####..
...#.........#.....#.......#...#.......#...#.#.........#.......#
.#...###...#.##..##..#.....#.#..##...#.......##...#..##..###....
...#.....#.....#...#.........#.#.....#...#...............#...#.#
.#####.......#.###.....#..#.#....#...###.........#.....#.......#
.....#.............#.......#.....#...#.#...#...#................
###....####....#.....#...###..##...#.#.###.#..#.##...##..#.#....
.....#.#...#...........#.....#.........................#.#...#.#
...#.#...#.......#...#.........###.####.##.#...#.#.###.....#....
.....................#.....#.................#.........#...#...#
.#.#.#.......#.#.....#.#....##.##..#.##.#....#.#.......####..#.#
.#...#.....#.....#.......................#...#.................#
.#.#...#.#.........#....#..####.##...##.....##.##.#....#.#.###.#
.....#.............#...#...#.......#.........#.......#.........#
..#..#.##....#.#...#..##.#.#.#...#....##.......#...#.#..#..#....
...#.....#.....#.#.......#...#...............................#..
..#....#...####...##..###.####.#....##...#.#.#..###..#..........
.................#.......#.........#...#...#.#...............#.#
.....###.....#..##....##...#..#....#...##......#...#...#.#...#.#
...#.#.#.............#.....#...#.....................#.........#
..##.#.#...#.........#######.#.#.#..#.##..###...###..#...###.#.#
...#.....#.#...#.................#.............#...#.#..........
.#...###.#...#.........#.#....#...####...#.#...#.....#.#..##.#..
...#.......#...........................#...........#.#...#......
.#.###..#..#.#.....#.###.###.#..#.#...#..#####.##....#.###.##...
...........#...........#.....#...........#.#.........#.......#..
.#..#......#.....####.#.#.##...#..#....#.#.#...#..#..#.#..##....
.....#.#.#.................#.#.#.....#.........#.......#.#......
.#.....#.#..##...#..#......##..#...##.#....#.#...#.##.###..#...#
...#...............#.#...............#.#.#.......#...#.......#.#
.#.##.....##.#...#...##..#.#..##.#.#.#.#.#.#.#...#...#.....###..
...............#...........#.............#.......#.....#.#......
.#.#.#.###.##.##...#.#...#.#.##..#..#.##...#.#.#...###...##..#.#
.......#.......#...........#.......#.......#.......#...........#
..#..#.....#...#..##....##.#.#.##..#..##.#..##...#...#.#.#.#.#.#
.................#.......#...........#.........#.....#.....#...#
.#.#.....#.#.....#.#####.#.#...#....##.#..##.#.###..............
...#...#...#...#.#...........................#.#................
...#....###.##...#...#..##...#.###...#..#..###.....#.#..#..#....
.#.#.....#.............#...#.............#...................#.#
...#.#.....#.#.....##....#.#...#...##....#...#...#.#.#.#.##....#
.#...............#.........#.#...................#.........#.#..
...###...#.##..##....#.......#.#.##.....#...##.##..#.#.#.#.....#
.......#.....#.#.....................#.................#.#.#.#.#
.#...........#.#.###...##........#....#..#.#.##..##..#.#.....#..
.............#.....#............S#...#...................#.....#
#####..#..#.#.###..#.....#.#.#..#.#.#..###..#.###..###......##.#
