8
G......#
...#....
...#...#
...#.#.#
.....#.#
....##.#
...#S...
###.##.#
