64
...............#.......#.....#...#.........................#...#
.####.###......#.#.#.#.##..#.#...#.#.#.#...#...#.#..##..##...#.#
.#.....#...#...................#.........#.........#...#.#.....#
..#.##.#.....##.##.#.##.#########..#.#..##....##...#.###.#.###.#
.#.......#...#.....#...................#.........#...#.#.......#
...##....###.#.#########...#..#...##.###..##...###..#..#...#.##.
.#...#...#...#...#...................#.......#...#.#...#.......#
.###...#...#.##..###.#.#.##..#..##......##...###...#..##.##.##.#
.#...#.#...#...#.....#.#...........#.....#...#.....#.#...#...#.#
.#.#.#.#.###.#..##...###.#.#####..##.#####.#.#..##.#...#.#.#.#.#
...#...#...#.........#...#.#.......#...#...........#.#...#.#.#.#
.#.#...#.#..##.##.#..#.###.#...#.#.#.#.#.#####.#####.###...#.#.#
.#...#...#...........#.#.........#...#.#.......#.......#.....#.#
.#.#.#######.#..#..#.#....##...#....#.#..#.#.#...##..#..###....#
.#.#.......#.#.#.......#.#...#.....#.......#.....#...#.#.....#..
.#..##.#.#...#.#.##.#..#.#.###.##.##.##..###.###...##....#####.#
.#...#.#.#...#.#.#.#...#...#...#...#.#.#.#.....#...........#...#
...#.#.#.#.#.#...#...#.#...#.###.#.#.#.#.#.##..#######.###..#..#
.#.......#.#..G#.....#...#...#...#.......#...............#.#...#
.###...###.#.##......#.###..##...#.#..###.##..##..####.#...#.#..
.................#.#.#.....#...#...#.#...............#.#.#...#.#
###.##.#.####.##.#...#.#####...#...#.#...#.###.##.##...#.#.#....
...#.................#...#.......#.................#...#...#.#.#
.....#.#...#.#...##..##..###.#...#.#...#.#####.###.######..#...#
.....#...........#...#.#.....#.....#.#.#.......#.#.#.........#..
.######....###.#.#.#.#..##.#.#....#......#.#..##.#.#.#...#.#...#
.#.....#.#.....#...#.....#.....#.........#.#.#.....#.......#...#
..##.#....##.#.#.#.#..####..##....####..#..#...#....##.#.#.###.#
...........#.#...#.#.......#...#.........#.#...#.............#.#
#...##.#.#.#.#...#.#.#...###.#.....###.#.#.#...#.##.##.###...#.#
.#.........#.....#.....#.....#.....#...#...#.#.#...#.......#.#..
.#.#.....###.#.#..##.#.....###.#..##.#.#.#.#.....#.###...##..###
.......#.........#.#.#.#.....#.#.#...#...#...#.#.#.....#...#...#
.###.#.#.#######.#......##...#.#.#.#..##.#.#...#.#####.##..#.#.#
...#...#...#...#...#.#.......#...#.....#.....#.#...#...#.#...#..
.#.#...#...#.#.....#.###.#.##.##.##..###.###.#.#####.#.#.#..##..
.........#...#...#.#.#...#...#.#.....#.......#.....#...#.......#
..#.#####..#.###...#.#.#...#.#..#.##.#.#####.#####.#.#..#...#..#
.....#.........#.#.#.#.#.....#.............#.....#...#.#...#....
.#####.###.#...#.###.#.#...#.#.#.#.##.####...##..#.#.#.#....#.##
.#.....#.........#.....#.....#...#...#...#.....#.#.#.#...#.....#
....##...#.#..##...##..#####.....###.#.#..##.#.#.#.#########...#
.#...#.............#.....#...#.#...........................#....
###..###.##..#####..##.###.#.#.#.....#.##..#.#####.#####...#.#.#
.......#...#...............#.......#.#.....#.#.........#.#.#.#.#
.#..##.#.#....######.#.....#..##.#.#...##.#....#.###.#.#.#.###.#
.#.....#...#...#.#...#.#.#.......#.#.....#.....#.......#.......#
.....#.###..##.....##.##...###.#.#.#.#.#.##.#..#.#.#.#.##.######
.#...........#...#.......#.....#.......#.#...#.#.....#.........#
.#.#.#.#.#.#.#.#.##...####.#.#....#.##.#.#.#.#.###.###..####.#.#
.#.#.#...#.#.#...............#.#.......#.......................#
.#.#...###.#####.#..##.#.#..##.#.#.##.#..#..########.#######.##.
...#.......#...#...#...#.......#.....#...#.#S..#.....#...#...#.#
.#.###.#.###...###....####...#######.#.###.###...#####.....#.#.#
.#...#...#...#.#...#.......#.........#.........#.......#...#.#.#
.###.#...#.##..#.#####.#####.##..#.#..####.#...#.#..##.###.#....
.......#.#...#.......#.............#...#...#.......#...#.#...#..
.#..#..#####..####...#.#####.#.#.#####.#...#..######.###.#.##..#
.#.#.......#...#...#.............#.....#.#.....................#
##...###.....#.#.#....#.####.#####.##...#######..#.##..#.###..##
.....#...#.#.........#...........#...............#.....#.......#
..##.#.#.#.#.###.##....###.#.#.##########..#...#...#.###..####..
.........#...........#.....#...................#...............#
#....###.########.###.#.#####..#######.#########.#######.####.##
