16
...............#
.#####.#..#.####
.....#.#.#.....#
.....#.#.#.###.#
...#.#.....#S..#
..##....####.#.#
...#.......#....
.###..####...##.
.#...#...#.....#
.#.#.....#####..
...#...#.....#.#
.#....#..###....
.#G#.....#...#.#
...#.#...#.#...#
...........#....
###########.####
