16
...............#
....##.####..#..
.#.....#...#....
.#######.###.##.
...#.........#.#
.#.#####.#.#...#
...#.....#...#.#
.###.###.#.....#
.....#.#...#....
.###.#.##..#..##
.........#...#S#
##.#.###.#.#...#
.#.#...#.#...#..
.#..#..#...###.#
..G......#.....#
####.###########
