8
.......#
..##.#.#
G..#....
####....
.....#.#
.####..#
......S#
#.##.#..
