64
.....#.....#.........#...........#...#.....#....S#.....#........
.###.###.###.###.#.#...#.###.#...#...###.#.#.#####.#.###.###.#.#
.........#...#...#.....#.......#.......#.#.#...#.........#.#.#.#
...#####.#.###.#######.#.#..##..#####..#.#####.#.#.##....#.#.#.#
...#.........#...............#.......#.#.....#.#.#...#.....#...#
.....###.#.#.###.##..##..##.#..#...##..#.#.#.#.#.###.####.##...#
.......#.................#.....#.........#.#.#.......#.....#.#.#
...####..###.#####.#####...###.#.#.####.##.###.#.###.#.##....###
.#.......#.........#...#.#...#.#.#.......#.#...#...#.#.#.#.#....
..##########.#.#####.#.#.###.#.#.#######.#.#.####..#.#.#...###.#
.#.......#...#.......#.......#.....#.....#.#...#...#.#.........#
.#.#.#.#.#.###.#######...#.#.#..##.#.#.#.#.##..#.###.#.#.###...#
.#...#.#.#...#.............#.#.....#.#...#...#.#.....#.#.....#.#
.#.###.......##...#..####.#..######...#.#..#.#...#.##...#####..#
...#...#...#...#...#.#.............#.#.....#.#.....#...#.......#
####.###.#####.###...#.#..#####.##.#.#.#.#.#.#.#.#....####.#.#.#
...........#.....#.#.#.#.#...#...#.......#.#.....#...#...#.#.#.#
.#.#..####.#...##....#.#.#.#.#.#.#######.###.#.#.###.#.#.....#.#
.#...#...#.#...#...#.....#.#...........#...#.................#.#
.###.#.#.#.#...#.###.##.##.##.#.######.###.#.###.#.###.#######.#
.#.....#.#.....#.....#.....#...........#...#...#.#.#...#.......#
.#.####...#.##..#.##.#.#.#.#.##.######.#..######.#...###.#######
.#.....#...............................#.#...#...#.#.....#...#.#
##.###..###....#.#..#####..#.#.#.##.####.#.#.#.#.#.####.##.#.#..
.......#.......#...#...#...#.#.#...........#...#.#.........#...#
.###..##.#####...#.#.#.#.##..###.##.##..########.#.#.#########.#
.#...#...#...#...#...#...#.#...#...#.#.......#...#.#...#........
.###.#..####.#.###.#..####.###..##.#.#.#######.###.#.#.#.##..###
...#...#...........#.......#.#...#.#.#.....#...#...#.#.#.......#
.#.#...#.###.###...##.####.#.#...#.#.##.##.....#.###.#.##.####.#
.#.#...#.....#...#.............#.....#.........#.....#.......#..
##.#.####..#.#.#....##....###..#.###...#####.####.#..#.#..#..##.
...#.....#.#...#.......#.......#...................#.#.#...#...#
.###.##....###.#.#####.####..#####.##.##.#.#.#.###.#....##.###.#
.#.....#.#.....#.....#.....#.#...........#...#...#.#.#...#.#...#
.##..###.#.#.##.##.#.#.#.#.#...#.#.#.##.####.##...##.#.#...#.#.#
.#...#.............#...#.#.....#...............#.....#.#.#.#.#.#
...###.#.#.###.###.#####.#.##..#...#.########..#####.#.#.#...#.#
.#...........#.#...#.....#...#...#...#.......#.#.......#.#.#...#
..######.#####.#.###.##.####.....###.#.###.###.#..####..##.#.#.#
.......#.#.....#...............#.#.#.....#.....#.#.....#...#.#.#
.##.##.#.#.#######.#.#.#.#.####..#..####.#..####.#.###.#.#.#...#
.#...#.#.#.....#.#...#...................#.....#.#.#.......#.#.#
...#.#.#.#.###...####.#.##...#..##..####.#.#.#.#.#.#..####.#.#..
.#.#...#...#...#...........#.#.....#.....#...#...#.#.........#..
##.#.##.#..#.#####.#.###.#.#.###...#.###...####.##..##.#.##.###.
...#.......#.#...#.#...#.................#.............#...#...#
.#######.###.......###.########.##.#####..####...######.##.#.#.#
.......#...#...#.........#...............#...#.#.........#...#.#
.##.##.#########.#######.#.#.####..#.#####...#..##..##.#.#####.#
...#.#.......#.................#...#.....#.........#.....#...#..
##.#.##.#...##.##..###.#.#####..####.###.###.###.###.###.#.###.#
...#.....#.....#.#...#.#.#...#...#.......#...#...#...#.....#...#
.#####.#.####.##.#.....#.#.#.###.#.#.#.#.#.#.#..#..#.#######.#.#
.................#.#...#...........#.#.#...#.#.#...#.......#.#.#
####.##..#.#.###.#.###.###.###.#####.##.#.##.##..######.##.#.#.#
.........#.#.#.#.............#.#G..........#.....#.......#.#...#
.#.###.#...#.#...##.####.#####...#.#####.#.#.#.###.#...###.#...#
.#.#.....#.#.#.....#...#.........#...#.#.#.#.#.#.#...#.#...#.#.#
.#...####.#..#####.#.##.####.#.##.##.#.#.#.#.#.#.#.#.###..##....
...#.......#.....#.#.......#...........#...#.........#...#...#.#
.#.####.##..###..#..####...##.##.#.###.#.#.###.#.###.#.#####...#
.#...............#.......#.............#...........#.........#.#
####.#.###.#######.##...#.########.##.#######.#.###.##.#.##.###.
