64
...#.......#.......................#.........................#.#
#..#.#.###.#.##..##..#.########.##...#...##.##..#####.######.#.#
...#.#.....#.#.#.....#...#...#...............#.......#.........#
..##...#.#...#.####.###..#.#.#.#.###.#.#####....###.##.#########
G....#.#.....#.......#.....#...#.........#...#...........#.....#
..####.#..###......###..##.#.###.#.#.#...#.#.###.###.#####..##..
.#...#...#.........#...#.........#.#.....#.#.#.............#....
.#.#.#####.#.##..###.####.###..#####.#####.##...######...##..#..
.#.#...#.....#...#.#...#.............#...#.#...#.........#.#.#.#
.#.###.####..#.###.###.#.########...##...#.#.###.#..#..#...#..##
.#...#.......#.....#.........#.....#...#...#.....#...#.....#...#
.#.#.###.####..#####.#.#####..##.##..#########.##..#.####..#...#
.#.#.....#.....#.....#.....#.#...#...#.......#...#.#.....#...#..
.#.#.#.#.######..######..#.#.#...#.#.#.#####.###.....##..#.#.#.#
.....#.#.........#.....#...#...#.#.#.#.....#...#.#.#.....#.#...#
.#...#######.#.###.##..#..##.###...#######.###...#..###..#..##.#
.#.#.#.....#.#.....#...#...#.............#.......#.......#.#...#
...#.#.###.#.#.###...##.##.#.#.#.##..#.##.##.####..#####.#...###
...#...#.#.....#.............#.....#.........#.....#.#...#.#....
.#.#####.##.##.#....####.#.#.#.#...###########.####..#.##..#####
...#...#.....#...#.....#.#...#.#.#...#.........#.....#.#.#.....#
####.#...#...###.#####.#.#####.#.#.#...#.###.###.###.#.#.##.##.#
.....#.#.#.....#.......#.#...........#.....#.#...#.......#.#....
.###.#.###.#.#######.#.#.#.###...###.##.#..#.#...#.#.###.#...#.#
...#.#...#.#...#.............#...#...#.............#.#...#.#.#.#
##.#.###.#.###.#.##########...##....##.##..####..#..##.###.#..##
.......#.....#.#.#.....#.........#.#.......#...#.#.........#...#
.#.###.##.##.#.#.#.###.#.#######.#.###..####.#...######.###.##..
.#...#...#.....#.#...#...........#.#...#.....#.#...#...#.....#..
.#..####.###.###.###.###.#.#######.#.###.#..##..####.#.#.###.#.#
.........#...#...#.#...#.....#.....#.......#...#.....#...#.#...#
.###.#.##..#...##..###.#.#####.#...#.###.#.#.#.#.####.##.#..###.
.#.#.....#.#...#.#...#.............#.......#.#S..#...#.........#
...#####.#.##.#..#.#.###########.#..#.##.#.#.##.##.#.#.#.#.###.#
...#.......#.....#.#...#.......#.#.......#...#.....#...#.......#
#..#...#...##..#.#.#.#...#####...#.####..#.#.#.#######.##.##...#
.#.#.........#.#...#.#...#.......#.........#.#.#.......#.....#.#
.#.###.#.#.#.#..#.##.#..##...#####.###.###.#.#...##.##.#.#.###.#
.....#.#.#...#...#...#.#...#.......#.#.#...#.............#.#....
.###.#.#.#.#.##..#..##.#.#.##.##..##...#.############.##...#.###
.....#...#.#.#...#...#...............#...#.................#....
.#.#.#.###.#.#..####.#.###.###...#...#####..##.#..####.#..###..#
.#...#.#...#.#.....#.#...#.......#...#...#.....#.....#...#.....#
.##.##.#.###...##..#.###.##.#.##.#.#.#.#.###.#.#####.###.#.#####
.#.......#.#...#...........#...#.#.#.....#.#.#.....#.#.#.#...#.#
....##..##.....#.#.#.#...#.#.#.#...#####...#.##.##.....#...#.#.#
.......#.....#.#.#...#...#.....#.............#...#.#.#.#...#.#.#
####..##.#######.#..#..#.#####.#.#.#.#..##.#.#.#.#.#....##.#...#
...#.....#.......#.....#.........#...#...#.#.#.#.#.#.#...#.#.#.#
...#..####...#.###..####.#######.#.#.#.#..##.###...#.#.#...#.#..
...........#...#...#...#.#.......#...#.#.........#.#...#.#...#.#
.#.#.##.#.######.###.....#.###########.###########.#.###.###.#.#
.....#.........#.......#.#...#.............#.........#.#.#.....#
.###.#.####..######.##.#.###.##..###.#..##.#.#.#####...#.#.###.#
.#...#.#...#.....#.....#...#...........#.#...#.....#.........#.#
.#.###.#.#.###..##..#####..##########.#..###.#.###...###.###.#.#
.#.....#.#...#...........#...#.........#...#.........#.......#.#
.###.#..#...#.####.###.#.#.#...#.#.#####.#.###.#.##.#...####...#
.#...#...#.....#.......#...#...#.#...........#.#.......#...#...#
.##.####.###.#.#####.#####.#####.#.#...#####.#.########.##.##.##
.......#.....#.#...#...#...#.#...#.#.....#...#.....#.......#...#
...#.#.#######.#.#.###.#..##.#...#.#.#.#...###...#.#.##..#.#.#.#
.#...#...........#.....#.............#...#.......#...#.......#.#
#.#.#####.##.######.#..####.#.###.##.##.###.##.#.#####.#.#.#####
