16
.........#S.....
##.......#.#....
.....#...#.....#
........#..##..#
.#.......#......
...#...#.#.#...#
.#..............
.#..##.##.###...
.#.......#......
.....###...#....
.........#.#....
...#.#.#...#.###
...#G#.....#....
..#..#.#...###..
.......#........
##...#.....##.##
