8
..S#....
.#...#.#
.#......
.#..#...
.#.....#
...#....
....G#..
.#.#...#
