16
.........#.....#
.##...#..###.#..
..G#.........#..
...#.#...#......
...........#...#
.....##..#.#.#..
................
...###...#..##.#
.......#.......#
.#...#.....#.#.#
.#.....#....S#.#
.....#..##..##.#
...............#
##..####....#...
................
.####..###...#.#
