16
...#............
#..#..##.#...#..
...#.#.#.....#..
.......###.#.##.
...........#...#
...##....#..##.#
.........#.#....
...#..##...#.###
S#...#.....#...#
.#.#.....#...#..
.........#....G#
.#...#...#.#.#..
.#.......#...#..
.#.#...#.......#
.....#.........#
.##.#.#.##.#..#.
