16
...............#
.##..###.#.##.##
.#...#.....#S...
.#####.#.#.###.#
.#.....#.......#
.#.#######.###.#
.#...#...#......
..##.#.#.#.##..#
...#.#.........#
.###.#####..##.#
...#.#..........
##.#.#.#####.###
..G#...#.....#.#
.#######.....#.#
...............#
#########.##.##.
