64
.........#...#.....#.........#..................................
..#....#...#.#.....#.#.#..##....#..##.##..#..###..#.##.#.....###
.#.......................#...................#...........#.....#
.#..#..###......###..#.....#.#.#.#.............###...##..#.###.#
...........#...#.........#...............#.....#.............#.#
.....#......#......###.#.###.#..#..#..#....#.#....##.#.#..##....
.....#.#.........#...#...#.#...#.......#........................
#......#...#.#.#.#.#.#.....#.#.#.....#...###.#.#....##..##....##
.........#.#.......#...........#.....#.#.......#...............#
.##..###.....#...#...##.##.#........##.#.###.#.##.#.....####.#..
.#.......#...#.......#.....#.......#...#...........#...#...#....
....#....##..#..##.#..#.##...#####...#..#..#.#.#.#..#..#.#..#...
.#...............#...........#.........#.......#.#.......#...#.#
.#..###..#.#.......##..#...#...#...........#.#.#......##..#..#..
.........#...........#.......#.#.....#.....#...#...#.#..........
.#.##.##.......#.#.#.....#......#....##..#.#.#.............#.#.#
.............#...................#.........#.#...#.............#
.#.#.#.#.........#.###.#....#.##.....##..#.....#...#####...###..
.#.....#...#.#...#.....#...........#...........#.....#...#......
...##..#...#......#..#..###...#..#...#.##..##...#..#.#...#.#.#..
G..#...#.......#.#...#.......#...............#.....#...#.#.....#
.#.......#...##....#.#..###.....#..#...##..#.#..#..#..##.#.##..#
.#.........#.#...#...#.....#...#.#...#.......#.....#.....#......
...#.#.#..#....#.#.#.#.#...##..#.#.###.##..#.....#....##...#...#
.....#...#.....#...#.................#.......................#.#
.#.#.#.#.#.#.....#.##.#..##.....#.#..#....##...#.....#.#.#.#.#.#
.....#...#.#.......#.......#.......#...........#.......#........
.#..#......#.###.#.#..##.#.#.#.###...###.#.#.#.#.#..#.....###...
...........#.#.#.#...........#...........#.#.........#...#......
.#.........#...#.#.##....#.##..#..##...#..##..##.#.#...#.#.#.#.#
.............#...#...#.....#...#.....#.............#.#.......#.#
...#.####...##.....#..#.#.#..#.#....##..#.#..#..##...###.#...#..
...#...#.........#.#.#.......#.#.#...#.............#...#.#...#..
.###.#.....#.#.....#.#.#.###.........#.#####.##...##.#.#.......#
.....#...........#.....#.....#.......#.........#.....#.#.....#.#
.#.#.......#.#.....##........#.#.#.#...#.#.###.#.##.#..###.#..#.
.#.#.#.......#.....#.....#.#.........#.....#...#...............#
.#..##.#..##.#...#....##.#.###....#..#.#.##..#.#...#..#.....#...
.#.....#.#...#...............................#...#..............
.##.####...#.##.#.##.#...###.#....##.....#.###.#...#.#...#...#..
.......#.........#...#.#.#...................#...#....S..#.....#
.........#....##.#.#.#.#.#.#..#.........###.....##.#.#.........#
...............#...#.#...........#.....#.....#.......#...#...#.#
.#..##.#.##.##..##.#.#.####..#.#.#.......#.#.....#.......#...#..
...#.............#.............#.....#...#.....#...#...#........
...........#.#.....##.##.##.#...###..#####.....#.#....#..#.#....
...#...#.#...#...............................................#.#
.#...#.....#.......#.......#####.#.....#....#..#.#..#..#.....#..
...#.#...#...............#.......................#..............
.#...........#.###...###...#.#.....#####.....#..........##...##.
...#...#.#.........#.#...#...#.#.........#......................
.........#.##.####....####.#..##..#.##...#.##....####..#.....#..
.....#.#.........#...............#.....#...#...................#
.......#....##...#.#...........#.#.....#.##...###....#.###.#.#.#
...#.....#.................#...#.......#...........#...........#
#..#..#....#...#..#..#.##....#...###..#..#.##..#.#.......#.#.#..
...#.........#...........#...#.......#.....#...#...#.....#......
...#.........###.##..#.#..#.#......#.#.#.....#####..##.......#.#
.........#.........#.....#...........#.......#...........#.....#
..#..###....##.....#######...#...##..#....##..#..#.#.##......#..
...#.........#.............#.......#...#.............#.....#....
.#.#.#.##....#.####..#######...#.#.#.#...#...#...#.##.#..#......
.#...................#.................#........................
.#.#.###..##.....#...#..#.##..#.#.#.#..#..#####.#.#..#.....#...#
