16
.....#..G......#
##.#.#...#..#...
...#.....#.#...#
.###...#.#.#..##
.........#.....#
...#.#.##..###.#
.......#.#......
.#######.#.##..#
.............#.#
#####.##.##.#..#
.........#.....#
.#.###..#...####
.#.........#S...
...####.##.###.#
.#.............#
####.###..#####.
