8
G......#
.#.###.#
.#.#....
...#....
.#....S#
.#.#.##.
.......#
#..#####
