32
....................G#.........#
.###.#.###.#...#.#.###.#.#..####
...#.........#...#.....#.#.#...#
...#.#.#...#..#.##.#.#.#...#.#.#
...#.......#.....#.#.....#.#.#.#
##...#.#.###.#...#.......#.#.#.#
.#.......#.......#.#...#.#.#...#
.#...#.###.###...#.##....#.#....
...#.#.....#.....#.....#.#.#.#.#
..##........##.#.###.#.#..##...#
...#...#.........#...#.......#..
##.#.#..####..#..#.#....#.#....#
.#.............#.#.#...#.#...#.#
.###..##..##.#.#.#.#.#.........#
.....#...#.......#.#.#...#.#...#
.#####.##...###.##..#.#..#..##.#
.....#.....#.......#...........#
#..###.#.###...###.#.#######.###
...#...#.............#...#.#...#
###..#...###.###.##....#.#..#..#
.....#.#...#.....#.....#.....#..
..##...#.#.###.#.#.##..####..#.#
.....#...#S#.....#.........#...#
.#.#.#..####......##...#.#....#.
.....#.#...#...#.....#...#.#....
##.#.#...#.##...####.#..##.###.#
...#.#...#...#.#...#.#.#.#.....#
.#..#.#..#.....#.#.##..#..##.#..
.....#...........#.....#.....#..
.#.#...#.#.###...###.#...##..#.#
...#...#...#...........#.......#
....#########.#####.###.###.##.#
