16
...........#...#
.###.#####.#.#.#
...#.......#....
##.#.......###..
.#.#...#........
.#.#.#.###.###.#
.......#......S#
.#.#.#...#.#.###
...............#
.###.##.##.#...#
.......#...#...#
.#####.#.###.#.#
....G........#.#
##......##..##.#
.....#.........#
....#######.##.#
