16
.......#G.......
.###....###....#
...#...#...#...#
...#.#.........#
...#...........#
...#...##..##..#
.#.......#...#..
.#.#.#.#.#.#....
.#.......#...#.#
.#.##..#...#....
.#.......#.#...#
#..##.#....#.#..
.......#...#.#..
...#...#.##.....
S#...#.......#..
#.#..#.#.###..##
