16
.............#S#
#..#######.....#
.............#.#
.###.###..#.#..#
...#.......#...#
.#.#####.#.#.###
.#.....#.#.....#
.#.##..#...###..
.....#.....#...#
.#.#.#.#.#...###
G..........#.#..
.#....####.#.#..
...............#
.#.#.#####.###..
.........#.....#
..############.#
