8
S#.....#
.#.#....
.#...#.#
.#####.#
.....#.#
####.#.#
......G#
########
