16
.......#...#G...
.###..#....#.#.#
...#...........#
.#.#..#.##.###.#
...#............
.#.#.#.#.##.#..#
.#.........#....
.....#..##...##.
...#.#...#.....#
...#.###.#......
.....#S.........
##.#.#.....###..
.......#.#.....#
..##...#.#...#..
.........#......
#..####..###.#..
