16
........S.......
..##.....#.#...#
.#.....#........
#..#....##.....#
.............#..
...###....#.....
.#...........#.#
.......#...#.#.#
.#.#.#.#........
........##...#..
...#...........#
##.#......#..#.#
...#.....#...#.#
.##..#...#.....#
..G....#...#...#
.#.#######..####
