8
....G..#
.#.#...#
.....#.#
...##...
.......#
...#....
S..#....
........
