32
.#.....................#........
...#..##.##..#.##.#.......###...
.......#.......#......S#...#...#
...#.#..##...###.###..##...#.#.#
...............#.........#......
...###......#...######.#...#...#
.........#.....#.......#.....#..
##.#...#.###...#.####.#.##.###..
...#.........................#.#
...#.#...#...#.#.#....##.#...#.#
...........#...#.........#...#..
.#.##.#......#.#.......#...###..
.......#.#.#.#.#.....#..........
..#..#.#.......#...#.#..##..##..
...#.#.#.#.........#...#.#......
##.....#...###.......###.#.#..#.
.....#.....................#.#.#
.....#........##.#.#.....#......
.#G..#.....#.#.........#.......#
.#.#.#...#.#.#...#.#...#.#.#...#
.....#.......#.......#.#.......#
.#..##....#....#.......#..####.#
.#.........#.........#.#.#.....#
.#.#.#..#....#.#.#..##....####.#
...#.#...#...#.........#.#.....#
..####......#..#.#...###.#.##.##
.........#.....#.........#.....#
.#.#...#...###.###.##..#.#..#..#
.#.#.......................#...#
...#.##...##.#.....#...#.#.#...#
.#.....#.......#.........#...#..
#......######...##.#..#.######.#
