64
.........#...........#.......#.......................#.....#...#
.#.#####.#...##......#...#.#.#..####.....#.#...#.##....#.#...#.#
.#.......#....S..#.........#...#.#.........#.............#.....#
...#####...#.###.#.#.###....##.#.#..#.....#....#.##.##.###.#.#..
...#.....................#.........#.................#.....#.#.#
.#.#.##..#......##.###.#..#...........###..#.#...#...#.#.#.#...#
.#.....#.........#.........................#.......#...#.#.....#
.........##.#.#..####...##.#.#.....#.#.#.#.#.##..#..#....##..#.#
...#...................#...#.#.....#...........#.......#...#....
...#....#..##......#...#..#..#.#.#...#.#.#.....####.##.#.#...##.
...#.........#.#...#.....#...#...#...#...........#.......#.#....
...#.#...#......##.###..##...###..####...##.####..#..#.##..#.#.#
.#...................#.....#.......#...#...#.....#..............
.##.###...###....#.###..#...#.#......#.#.#....#....###.###.###.#
...................#...#.........#.#.....#...#...#.#.........#.#
.#..#...##...#........##.....##......#.....#.#.#.#.#.#...#.#.#..
.#.....#.............#.......................#.....#.#.......#..
.#####...........#.###.###..#..#......#....#...#.....#.#.#..#...
.......#.......#.#.#.#...#...#.#.........#.............#........
##.#.#.###.#.##..#...#.##..#..#......##......#.##..#...##..#....
...#...................#...................#.......#...........#
.#.#.##..#..#..##.#..........#.#.#...#.#..#...#..#.......#.#.#..
...........#...........#.......................#...............#
...#######.#.#...##......###.......##.###...#........#...#.....#
.........#.........#.#.#.....#.#.#.............#.........#......
..#####..#.....##....#..##...#...#..##......##.#.#####.###......
...........#...............#.#...#.....#.......#.#.........#...#
#..#...#........##.#..........#..##....#.###.#.#.#..#..###.#...#
...#...#.....#.#...#.....#.#...#...............#...#.......#....
.....#.###.#.#.#.#....#.#....#...##.#.#....##..#.##....#.#.....#
...............#.....#...#.#.#...........#...#.......#.........#
..#......###.#.###.#.....#...#..####...#.#.......#...#..#..#....
.........#...............#.#.#.....#...#.....#..................
#......#.###.....#.##....#.........#.#.#.#....#..#.....##.......
.......................#.....#.......#.#.............#.#.......#
.#.##...##.....##.#.#..#####...#.....#..##...###.#...#.#....##.#
...........#...........#...........#...#...#....................
.###...#...##..#.#.#.##..#.#.###.#..##...#.#.#.........#.....#..
.#...#...#...#.#.#.........#.....#...#.#...#.........#.....#....
.#..##.#.#.#...#.........#.##..#.#.....#.#.#.#....##.....#.##..#
.....#...#...#.....................#...#........G..#...#........
....#....#...#.###......#.###....#.#.....#.#.....#.###...##.##..
.....#.............#...#.......#.#.....#.......#.......#...#....
..##.........#.#.........#.#.....#.#.#.#.##..#...#####.#.#.#.#.#
...#...#.#.#.....#.#...#.#.....#.#.#...........#.#.........#....
.#.#...#...#.####..###.#...#####.#....##..#......#.......#...#..
.........#.....#.......#.....#.................#.#.#...#.....#.#
.....#.....#.....#######..#.....##...##...#.##.##..###.#.#...#..
...#.#...........#.#...........#.....#.......#.....#...........#
.###..##.#..####.#...#.#...#..#..#.......###...#.#.#.#.#..####.#
.........#.............#...#.#...#.#.#...#...........#.#.......#
..#......#.#..##.##........#.......#...#....#.##.##.#....#...#..
.....#.........#...#.#.#...#.#.......#.#.#.............#...#...#
.#.###.##..###...#.....#.#.#.#.###..........#.##...#...#.#.#....
...#.........#...#.#.#...#...#...........#...............#.....#
..###..#.#...#.#.....#.###.....#.....#.#.#..##.......#...####..#
...........#.....#.......#.....#...#...#.......#...#...#.......#
..#.....##.#....#....#.........#...#####..##...##...#....#.####.
...#.....#...........#.....................#...#...#.....#......
.#..#....#.#.#...##....#...####..##..#...#.###.#.....#.#..#.....
.#.............#.#...#.#...#.........#.....#...#.#...........#.#
..#....#.#....#..#.###.##.##.##.##...#..##.#.##..#.###......##.#
.............................#...........#.......#..............
..####...#.##..#...##.##...###.##..#..#..#.##...###..########.##
