32
...............#.........#.....#
.#.####..#.#...#.#####.#.#.###.#
.#.....#.#.....#.#.....#.#...#.#
.#####..##.#.###...#.#.....###.#
.#...#.......#...#...#.#.#.#....
##.#.#######.#.#...###.#.#.#.#.#
...#.............#.#...#.#.#.#.#
.###.#####.#.#...#..#.##.#.#.###
.....#...#.#.#...#.....#.......#
#....#..##.#...#.###.#.#######.#
.....#.....#.#.............#...#
.###.....###.#.###..#.####....##
.#...............#.......#.#...#
...############..#####.#.#####.#
...#...#.......#.......#...#....
##.#.#.#.#####.#..###..#...#.#.#
.....#G....#.....#.........#...#
.###...##.##.###...#.#####.##...
...#.......#.#...#.#...#........
.#.....#.#.....###.##..#.#..##.#
.#.......#.#.#.......#.#...#....
.#####.#.#.#.###.#####...##..#..
.#.........#.#...#.....#.....#..
.#.###...#.#...##..###.#.###...#
.....#.......#.#.......#.......#
.###.#########...###.#.#..###.##
.#.#.....#.....#.......#.......#
.#.#####.##..###.#.#...###.#.#..
.......#...#...#.#.......#S#...#
######.###.#.#.#.##.##.#.###...#
.........#.............#.....#.#
###########..##.###.############
