32
.#.................#.......#....
.#.#...#.#.#.#.#.#.#.##.##.#.#..
...#.#...#.....#.....#...#.#...#
...#..####...###.##.#..#.#.#....
...#...#...#.....#.....#.#...#.#
..#..#...###.#.###...###..#..#.#
.....#...............#.......#..
.#.#.#.##..#.#..####.#.#.#.#.#.#
...#...#.....#.............#...#
##..##.##..#.###.#.#.#####.#.#..
...#...#...#.#...#...#.....#G#..
.#.#.###.###.#.#####.#.#.##.#..#
.................#...#.#.....#.#
.#...#.#.##.#..#.#.#.#...#.#.#..
.#.#.#...............#.#...#.#.#
.#...###.##...##.#.....#.##..#.#
...#.......#.....#.#.#...#.#.#.#
.###.###.#.######..#.#.#.#.#.#.#
.............#.....#...#.#...#.#
.#.#.#.#####...###...###.#.#.#..
.....................#...#.#...#
####.###.#######.#.##..##..#...#
.......#.........#.#...#...#....
.#.###.####.##.#.#...#.##..#..#.
.#.#......S....#.#...#.....#....
.#.#.#....#..#.#.#....##..#..#.#
.............#.#...#...#.....#.#
.##.#.#.#.####.#.#.#...##..#.#.#
.#.............#...#...#...#...#
.#.#.#.#.###.#..#.#..###.###.#.#
.............#.......#.........#
##..#####.#######..##..#########
