64
.....#.......#.........#...#.....#...........#.................#
...#.........#..##..#..#.#.#.##..#.#....##...#.#.#.#.#.#.#.##...
...................#...........#...#.#.........#...#.........#..
.....####..#.#...#.....#.#.###.........#..####..#....#.....##..#
.....#.............#...#...#...#.......#.......#...#.....#.....#
.....#.#.#............#......###...#.#.##.#...#..#...#...#...#..
...................#...#.#...#...#...#.......#.......#.....#...#
...#.###.#..#..#.###.....#.##................#.###..##..##.#....
.......................#.#.......#.#.....#.................#.#..
..#..#.#.#...#.#....#..#.#...#......#..#.#.#.##...##.#.###.#.#.#
.........#...#.......#.#.#.......#.......#.#.#.......#...#......
.#.#..#.....#..#.###.#.#.#..##.#.#.#.##....#.#..#....#.#..##.#..
.#.#.....#...#.........#.#...#...#.#.#...#...................#..
..#..#.##..#.##.#.#.#....#.#.#...........###.#.#.#...#......##..
...#.......#...............#.......................#.....#.....#
.#...#..#........##.#..##.##...#.##.#.##...###...##..#.......#.#
.#...........#S................#.............#.#.#.......#......
...#...#.#....##...#...#.....#.....#.#.....#.#.#...##.####.#.##.
.#...#...#.#.............#...#...#.#.#.....#...#.#.#............
.....#..##....##.#.#.#.#.#.....#..##.#.#.##......#.#..#.........
.#.........#.......#.....#...#.#.......#.....#...#.#.#...#......
.#.#.###.#..##.#.#...#.#.....#...#.#....#..#.###.....#...#..#...
.......................#.#...#...#.........#.........#..........
.#...#.###....##.......#.#.#...#...#..#..#.....#.......#.###.#..
.....#.#...#.....#...#.....#.........#...#.........#.#.....#...#
..##......#...#....###...#.#.#.##..###...#.#..#...#....#.#.....#
.......#.........#.........#.......#.....#.....#...............#
...#..#......#...###....####..##......####.#.....#.###.##..###..
.#.......#.#...#.#.....#.....#.........#.............#..........
.#.....#...#...#....#.##.#.####..#..##...#.....#...#.#.###...###
.......#.....#.#.......#...#.................#...#..............
...#..#.###.#......###.#...........#.##..#.#.#.#.###.#.#.#.....#
...#.......................#.....#.........#.............#......
.#.........#.#...#.#.#####.##.#..#.###.....#...#....###..#.....#
.#.#...#...#.......#............................................
...#.#.####.##..##.##...#.####.####.#..###.###...#....##.......#
.......#...........#.....#.....#...#...........#...........#...#
.###...##.##.##......#.#.#....##......##.#.#.....#...#..####.#.#
.......#.........#...#...#.#.....#.#.....#.#...#...............#
##.###.#..#...#...#.##.#.....##.##..#..#...#..#...#.##.........#
...#...#.#...........#...........#.........................#...#
...#.#...#..#..#####.#....#..###......####.#.#.##..###.....#.#..
.#.#.#...............#...#.......#...................#.......#.#
...#.#.#.....##.#.#...##.###...#.#...#....#..##....#....###..#.#
.#.....#...#.........#.....#...........#.......#...#............
..#..#.#..##.#.#..##.#.......##......#.........#.#.###..#.##.#..
.............#.#.....#...#.......................#...........#..
.#...##..#.#.#..#......#...#.#.#...#...###.#.#..#..##..##.##.#..
.#...#.......#.....#...#.......#.#.........#.........#.....#....
.#.#.....###.##.##.#...###..##.#.#...##.......##.#.#.#.#........
.......#...........#...........................................#
.##..###...#.....##.####..#.#..........#.#......##.####..#......
.#.....................#.....#.#.........#.......#...........#.#
...#...#.##..#....#.##....##...##....#.#...#...#.###.....##..#..
.....#.....#.#.#...........#...#.....#.#...#.........#.#........
.###..#......#.#.........#...###..##.#.....#..##.#.##..#...#...#
.........................#.#..........G..#.#.....#.#.........#..
...#.#.#.###.#.#.#.#...###.......#...#.#.#....#....#.##...#.##.#
...#...#.#.....#.#.........#.........#.....#...#...#...........#
...#..............##.#.#.#.#...#..#.##....#........##.####.#.#.#
...#.....#.........#.#...........#.........#.#.....#.......#....
.#.#..###..#...#.....#..##.###...#....#..#..##.....#.#...#..#..#
...........#.......................#.....#.....................#
##...###..##.#.#.########.#####.#..###..#####..#.##..#..#.###..#
