16
...#...........#
.#..##..######.#
.#.....#.......#
.#.#.#...#.###..
...#...#.#..S#.#
##..####.##.##..
.#.......#...#..
.###.#.##..###..
...#...#...#...#
..###....#....##
.........#.#...#
#..###.###.###.#
...#............
.#...#.###.#.##.
....G#.........#
##.###.##.#..###
