64
.............................#..................................
...#..#..#...#.##..#.#.##.......#......#.#.#..##.#..####...#...#
.......#.#.#.........#.........#.........#.....#...#...........#
##.##..#.#...#..#....#....#.#.##....#....##.#.....##.#..#....#..
...#.................#.......................#.#.............#..
..##...#.#...#...#.#...#.#.#.##....#....####.#.#....###..#.#...#
...#.#.............#.........#.......#.......#...........#...#.#
.#.....#..#........#...#...#..#.#..........#..###.##..#...#..#.#
...........#.........#...#.#.....#.#.................#.........#
#..#.....###.#....#....#....##.#.##..#.....#...#.##....##..##..#
..S..#...........#.....#.......#.#...#.#...#...................#
..##...#.#..##.....###.#.....#.....#...##.....##.#...###........
.....#.......#.........#.....#.#...#............................
.###.#..#..#...#.#.##....###.#.##.#..#.#.......###...#.###.#...#
.#.....#...................#.............#.....#.......#...#....
.#..###..#..#.##.#...##......##..#...#.#.......#.#........#.##..
.........#...#...........#...................#.............#...#
.#.#.#.#...#.#......##.#...#...#...#.......#..#..###..#.#....#.#
.....#...........................................#.#.#.....#....
.....#..............##.#..##.#.#.#.#.###.#.#.......#...##..##..#
.#.....#.#.....#.#.....#.....#.#...#.........#...#...#..........
.#.#...#....####...###....#.####....#...##.#.....#.###...#......
...#.............................#.....#.#...................#.#
.#.#.#...#....#.##.#.....#.##...##.##.##.#.##..#.##..#.#.#...#..
.....#...#.........#...........#.....#...#...#.....#...#.......#
...#.#.#.#.#.......#...#.#.#...#.#...#.....#....##.#...#.#....#.
.......#...#...........#.....#.#.............#.#.#...#.......#..
...###...###.#.#..##.#.#.#...#...##.......##.#.#.....#.###...#..
.#.....#.....#.........#.#...........................#.........#
..##.##....##....#.....#...##.##...........#.##..#...#.#...###.#
.......#...............#.#.....#.#.......#.......#.#...........#
#.###....#.#..###..#.#.#.#.......#.#.##.##.#.#.....#.#..###.....
.......#...........#...............#.......#...#...#.......#....
.#.#.###.....#....##..#.....##...#...#...#..##...#...#...#.###..
.........#.....#.....#.............#...#.................#.....#
.#...##....##....#.#.....##.#....#..##.....#.###.#.....##...#...
.......#.......#.#...#.................#.........#.#.#.......#.#
...#...###.#..##.....#...#.....#....####.###.....#.#.#..........
.....#...#.#.............#...#...............#.......#.....#...#
.####.##...#.##.##..##.#.#.#...#.#.#.#...##.#......##..###..###.
...#.....#...........#...#.....#...........................#...#
#..#.....#.#.#...##..#..###.###....#...#...............#....##.#
.#...#.#.#.#...........#...........#...........#.....#.#.......#
.#...#.#.....#.#..#..#....###.##.#.#......####.#.#####.###.##.##
.#.#.........#.....#...............#.............#...#...#.....#
......#..###....##.....#...#......#..#.#.#.#.....#.#.##..#.#....
...#...#.........#.#.#.................#.#.........#...#.....#.#
..#.##.#.#...#..#.......#.###..###...#......##.#......##...#....
...................#.....................#.........#.#.....#...#
...###.#.............#.#.##.####.#.#...#....#...#..#.#.#.#...#.#
...#...#.#.....#.#...#.......#.......#.......#.......#...#...#.#
#....#.#.....###....##.#..##...####..#.###.#......###.#.....#...
...#.......#.................#.................#...............#
.......###.#...#...#.#####...#...#.....#...#...#.#.#.#.##.#..#..
.#.........#.....................#.#..........G........#........
.#......#..#.#.#.#..#.#..#...#.#.......#.###.#.#####.#.#....#...
...#.....#.........#...#.....#.#.......#.......#................
##..#.##.....#.#.###.#.........#.##.####.####..#....##..#.#.#...
...#...#...#.........#.#...........#...#.....................#.#
.#.#.#.#.....#.#.#...#...####.#..#.#.#...#....##..##...#..##....
.#.#.................#.......#.........#.#.........#.....#.#....
.#.#..###.##..#....#...##.##.#....#.##.............#..#..#.#...#
.....#.....................#.............#...#.................#
##.###..##.###..#.###...######.####.##.#...#......##.##.#..#....
