16
.........#S#...#
.#.#..##.#.##..#
...#.........#.#
##.##..#.###.#..
.#.............#
.#.#........##.#
...#.#.........#
.###.#.#.###...#
...#.#.#........
.#.#.####..#.##.
.....#.........#
.#.##..##.##...#
G#...#.........#
.#.#.##.##.#....
...#...........#
####.##.#######.
