8
.......#
...###..
.#S....#
.##....#
...#...#
.##.##.#
......G#
##..##.#
