64
...........................#.......................#...........#
...#.####...##.##.##...###.#.#.###....##.##.#....#.#.###..#.#...
...#.........#.#.....#.....#...#.........#...#...............#.#
.#.....#.#.....#..####..#..#.#...#..##..##......#.#.#.....#.....
...#...#.......#.....#.......#.......................#..........
....##..##..##.##....#.#..####...#.#..#..###.##.#..#...........#
...................#...#.#.................#.......#...#........
.###.#.#.#...###.##......#.#....#.#.##.....#...#.#.#.#..#......#
.....#.....#...#.....#.....#.................#.......#.....#...#
.#.##.......#.##.#...#...#.##..#.#.#.###..#.##.#.....#...#.#...#
.................#...#.#.......#.#.............#...#.........#..
......##..#...#..##....####..#.#....##...#....#....###....##.#.#
...................#...#...#.........................#.#........
.#.#.#..#..#.##......###.#..#.##.....####...##.##.#.....#..#...#
...........#.....#.........#.......#.#...#.........#............
..#....#....#..#...##..#.....#.#.........##.#..#.#.#.#.#.#.#..#.
.#.....#.......#.....#.....#.....#.....#.......#.........#.#.#..
...#.###.....#....##.##..#.......##..##.##.#...###.####..#.#...#
.........#...........#...#.................#...#.......#........
....#..#.#.....#.#..#..#.#.####.....#..##..#.....#.#.#.#...##...
.........................#.......#...#.#...#...#.....#.....#....
....##.###...#.....##.##.#..#......#.....#.##......#...#.#.#.###
.#...#.....#...#...#...#.#...........#...#......................
.....#.###.###.#.......#.##..#..#..#.#.....#....##...#.#.....#.#
.#.............#.#.............#...#...#.......................#
.....#.###.#...#...#...##........#..##..##.#...#..####.....#.#..
.#.........#.#...#...#.....#.#S#.#.....#...#...........#.......#
...#.....#.#.#.#...#.#.#.#.......###.#.............#.#.#....##.#
...#.#...........#...#...#.......#...#.#.....#.....#...........#
.....#..####.#.#.#.#.#.....#.#....#..#...#.#....##.#.#...###.#.#
.............#.#...#.......................#.................#..
.##..#...........#.#.#.#.#..#..#....#....#...##.####.#.#.#......
.#.........#.......#.....#.......#.#.......#.............#......
..#.....#..#.#.##.#.......#..#.#.###...#.#..##..##.#...##.#.###.
.....#.....#.#.#.....#.....#.........#.......#.....#............
.....##...##......#.#.#..#.#.#..###.#..#...#..........#..#..##..
.#.......................#......................................
...#.....#..#..#.......#..##.#.###..#...##.#.......##........#.#
...........#...#.......................#.......#.......#.......#
#......#.#...#.##.#.#.##...##..#.#.#.#.#...#.#.#.####.....##....
.......#.#...#...#.......#...#.......#...#.....#.#.......#.....#
..#....#.#....##.#.#.#.#..#..#.........##..#.###.#...#.#...#.##.
.....#.....#.............#.....#.#.......#.#...............#....
.#.#.#.#...#.#...#.#.##......#.#.#.#...#.#...#..##.#......#.....
...#...#...........#.........#.........#.......#.....#.#.#......
##.....#...###...#.#.#..#.#..#.#.#.#.###..#.#..##........#.##..#
.......#.#...........#.#...#.............#.............#.....#..
.######..##.#..#.#.#...#...#.#..#...#..###..#.###..#.##.##......
.#...#.......#...#.#...#.#...........#.....#.....#.#.#..........
.#...#.###.#.#...#.#...#...#...##..#.#######.#.........#.##..#..
.......#.....#.#.................#.#.......#...#...#.#...#...#.#
..#.#...##.#.....#.#.##...#..#...#..##..##..##...###.......##..#
...........#...#.....#.......#...#...#.........#................
.##...##...###.##...###..#...#.....#...#...###.#...#..#...#..#..
...........#.............#.#.......#.........................#..
......#..#.#...##.#....#.#.#..#..#.#...#....######..#.#...#....#
.................................................#.......#.....#
...#.#.#.....#.....#.........####....##..#.#.###.##..#.#.###.#.#
.........#...#...#.#...#.#...............#.................#..G.
...####..#...####..#####.#.#..##.....##...#........#....##.#.#.#
...................#...#.........#.#.#.......#...#.............#
.#...##..#...#.#.......##..........#...##...#......#.....#.#....
...#.........................#..................................
###.#.##.##..#.#.##.##.#...#...#####.#...#.#.#.....###....#....#
