64
...........................................#....................
.###.##..#..#..#...#.#.#..##.#.....#...#.#...##.......#....#.#.#
...............#...#.................#...#...#.#...#.....#...#..
.#.##...###..#.#.#.........#.................#.#.....#.##....#..
...#.........#.........#...#...#...#...........#.....#.....#....
##...#...#.#.#.#..#....#.#...#....#..#.#.#.......###...##..#...#
...........#.#.........#...................#...#.#...#.....#....
.###.........####..#.##...###.##.#.#.#..###.#.##.#.#.###.#...#..
.....#.....#...#.......#.......#.................#.......#......
.#...#...#..##.....###.#.#.#.#.#....#...............#..#.#..##.#
...............#.#...#.....#.#.....#...........#.....#...#......
#......#.........#.#.#.#...#.##.##.#.......##..#.#...###.#.#...#
.#.........#.....#.......#.#...........#.....#...#...#.....#....
.##..#..........###..#.#.#...#..#....#.#..#......#..#...#....#..
.....#.......#.......#...#...#...............#...#...........#..
.##.##.###.##..#.#.#.#.#.....#...#.#..##.....#....##.#.#.....#..
...#......................S#.#...........#...#.............#.#..
.#...#.#.#.......#...##....#.##.##.#.#..#....#.....#.#.....#.##.
...#...#...#...#.......#...#.#.....#.......#.#.....#............
.##..#...#...#....#....#.#.........#..#......#.#.#.##..###.#.#..
...#.....#.....#...#...............#.#...........#.#............
#...##.#.#.#...#.....#..##.#.###.....#.....##.#.##.#...#..####.#
.....#...............#.#.........#.#.#.............#.....#.....#
.##..#.####..#.#.......#.#.###...#.#....##....#........###.#.#.#
.............#...#.#.................#.........#...#.#.........#
.#..#....##.#..#........#.....##.......#...#.#...#.....#.....#..
.......#.........................#.#...............#.#...#...#.#
.###...#.##.##.##..###...###.....#..##...##..#.........#...#...#
...#.#...#.....#.......#...#...#...#.#.......#.#.....#.......#.#
..##.....#...#....##.##..#.#...#.#....#..###.#.##.....#......#.#
.....#.....#.#...............#.....#.............#.....#.......#
.#.#.#.#..#....##...#####..##...##....#...#..#.#.#...#.........#
.......#.....#...............#.....#...........#.#...#...#.#...#
.....#....##.#####.###.#.#.#..#.#...##.###.......#.#.#..#...#..#
...#.#.....................................#.......#...........#
...#.#.###.#.#..####...#.#....##.#....##.#.#...##..#...#.#.#...#
.................#...#.....#.......#.................#.#.....#..
...###.#.#.##..#.#...#.##...#.....#....#.##...##.....#.#..##.#..
.#.....#.................#...........#.........#.............#..
...##..#..###.#.....####.##.##.#.#..##.......#.#.#.#.##..#.#.#..
.#.............................#...#.......#.......#...#.......#
.....#.#.##..#.#.#..#.#..#..#.##...#...#.#....##.......#...#....
.....#.........#...........#.......#...#.............#.#........
.#.##..#......#..#...#.#.#.##...#.####.#.###.#.###.#...#...#....
.................#...........#.........#.....#...#.....#........
.###...#.#...#.#.#..#.....##.##.##.#..#.####....##.##..###......
.......#.....#.................#.#.......................#...#..
##..##.#.#.....#.......#...#.#.#....##.#...#..#..#...##..#.###.#
...#...........#.#.........#...#.#...#.#...........#............
.#.#.#.##.##.#.......#.#.#.#.###...#...#..###..#.##.....#.#..#.#
...#...................#.#...#...............#...............#.#
.##..#.....####.##.#.......#..#.#..###..##.#...#...#.#.#.....#..
.............#...................#.#.............#...#.....#.#.#
...#.#....##.#.#.#.#.#....#....#.#.#.#..#..#.#..#......#.....#.#
.#...#.................#...#.................#.#.....#G..#.....#
.......#..###........##.....##.#.###...#.##..##....#...#........
.............#...........#...#.......#.....#.................#..
.#....##.#....#.......##.......###.#..##.#....###..#...#...#...#
...#.....#.....#...........#.#.......#...............#.....#.#..
...#.##......#.......#...#.#....#####..#.#...#.#.#.#.#.......#.#
.#.....#.#.........................................#...#.#......
...#.....#.#..#..#.#...#..##.#.#..#.##...#.###.#...#.###.#...#..
...........#...................#.............#.................#
.#.#.###..###.#####.#.#....##.#.######.#...###..###....#####.#.#
