8
G.......
.###..##
.#.....#
.....#..
....S#.#
..#..#.#
........
##..##..
