32
...........................#....
.#...#.#...###.###...##.#....#.#
.#.................#.#...#...#.#
.#.####.#..#.#.###.#.....#......
...................#...#........
.##.#..#.##..#.#.......#.......#
...........#...#...#.....#......
###..#.............#.###.#..#..#
.........................#.....#
.#.#...##...#.....#..##.##...#..
.........#.....#G..........#....
#..#.#...#..#..#...#.#.##..###.#
...............#.#.#............
..###....#.##........#...###...#
...........#.....#.....#.......#
.#..##...##....#..#.##.##.##...#
...........#.#.............#....
###..#...#.#....##.##.#.....#...
.........#.#.#.....#.........#..
.#..#.###..#...###.#...#.##..#..
...........................#.#..
##..#..#...####..#..#......#.#.#
...#.........#...#...#...#...#..
.....#.#...#.#.#.###.#.##....#.#
.#...#.......#.....#.#.........#
.........###.#...#.#...#.##....#
...#.#.#.#...#...#.......#.....#
.....#.#.#.......#.###.##...#...
.#...#...#.#...#...........#....
..###...#..###.....#.#...#..##.#
....S#.........................#
...##.#..###....#.#..##.#.#.##..
