8
........
..####.#
...#...#
.......#
......S.
.#......
G.......
#..##...
