8
........
...###.#
S.......
.####...
.#...#G.
...#...#
...#...#
##.##...
