8
.......#
..###..#
.....#S#
.#.#...#
.#...#..
...###.#
..G.....
########
