16
...#............
.#.###.#.###.#..
.#..G..#...#....
.........#.###.#
.#.....#.#...#..
..####.....#..##
.....#.#........
.###...#.#.###..
.#.......#.#...#
.#.##.##.#.#.##.
.#...#...#.#....
.###.#...#.###.#
...#...#..S....#
##.#####..##.###
.......#.......#
#########.######
