64
.................#.......#.....#.............#.....#.....#......
..###.#..#.#...#.#.#.#.#.#.###.###.###.#..##.#...#.#.#..##.....#
.........#.#.....#.#.........................#.#.#...#.....#.#.#
.#.#..#....#.#####.#...#.##....#..#####.#..#.....#####.###.#.###
.......#...#.............#...#...#...............#.....#.......#
######.#.###.##..#####.#.#.##.##.###.#.#..##.#....###..#.#.#.#.#
...#...#.......#.......#.#.................#.........#...#......
.#.#.#.#.##..#.#.#.###.#..####.###.###.#...#.#.####....#####.#.#
...#...#...#.............#...#.#...#..S#.#.#.........#.....#.#..
....###....#######.#..####.#.#.#..##.#####.####....#.##.##.#.#..
.#.........#...........#...#...#...#...#.....#...............#.#
.#.########..#...##.#....#.###.##..##........#...###.##...###..#
.#.#.........#.........#.#...#.........#.#.#...#.......#.#......
.##..#.###.###....##.......#.#...#.####....#..##.###.#..##.#.#..
...#.......#.....#.....#...#.............#...#...............#.#
#..#.#.###.#.#.###...#.#...#...###...#.#.###...#.##..#.#.###...#
...#.......#.......#...#.#.....#...#...#.....#...#...#...#...#..
.###.#######..####.###.#...##....#.....#.#..#.####.###...#.#.##.
.....#.......#...#.....#.#.#.#...#.#.....#.......#...#...#.#....
.#.###.###..##...#...###.#...#.###.#.#.#.#.##..#.#...###.#...#.#
.#...#.....#...#...#.......#.......#.....#.....#.#.#...#.#...#.#
...#.#.##.##.##..#.#.....###.#.#####.###.#.#...#..##.#.#.#.#.#.#
.........#...#.#.#.....#...#.#...#.........#.#.......#.....#.#.#
...#..##.#..#..#..#...#..#.#.#.#..####.#.#......#.....#....##...
.........#.......#.......#.#.....#...#...........#.#.........#.#
.#.####..#.#.#.#.#..###.##..####.#.#.#.#.#.#...###.###.#.#...#.#
.......#...........#.#.........#.....#.............#.......#...#
##.#.#.#.###.##.##.#...#.###.####.##...###.#...#..#....#..####.#
.#.#.#.............#...#.....#.....#.....#.#.#.......#...#......
.#...###.#.#.######...##.#...#.##..#.##..#.#.#.########....###.#
.#.....#.....#.......#...#.......#.#.......#.#...........#...#..
...###...##.##.#.#.#..##...#..##...###.####..#.##..#####.......#
.....#.#.#.....#.#.......#.......#...#.......#...#.....#...#.#..
###.#..#.#.#.###.#.##.#.#..####.##.#.######.##.###...#.###.#.#.#
.........#.....#.#.#.....#.#.......................#.#.........#
..####.#.###...#.#.#......##.#.##.....##.#.#.#.##.##.##..#.#....
.#.............#.......#...#.#...#.#.....#.#...#...#.....#.#....
.#.....##.####.###..##.###.#.#.#...#.###.#....##.#.....#...#.###
.#.....#.......#.....#.....#.......#...#.........#...#.#........
.#####.#.#...#####..##.###.#.#.#.#.###.#.#...###...#.#..###....#
.........#.#.........#.....#.#...#...#...........#...#.#.....#.#
####.###...###.#.#.#.#.#.#.#.#.....#...##.##..####.#.....###...#
...#...#.#.....#.#.#.....#...#.#.....#.#.....#.......#.....#...#
.#.##..######.##..##....##.#.#.#.#.###.#.######..#.#....##.#####
.#.............#...#.#.......#.....................#...#.......#
..#..#.#.#.#...#.#..####.#.#.#.####.####.##.##.##.###..#..######
...........#.....#.......#.....................#.......#.......#
....##.##.#...##...#######.#.#######.#.#####.#...###.####..#.#.#
.#...................#.......#.......#.#...#.#.#...#.....#.#.#..
...###...####.##.#...#.#...#..####.#.##..#.#.#.#...###.#.#.#.#.#
.....#.........#...#.......#.#...#.#.....#.....#.......#.#...#.#
.#.#.#####.##.#..###.#.#.#...#.#.#.#.##....##..#..##.#.#.###.#.#
...#.#.....................#.........#...#.......#.........#.#..
.###..#..###.#.#.#.#.###.#.#...####..#.#...##..##.##....##.#.#.#
...#.....#.#...#.#.........#.#.#.....#.#.....#.....#.....#...#.#
.#...#.#...#..##....#..#...#.#.######..##.##.#.###.#.#.#.#..##..
.#G..........#.#.#.#...#...#.......#.........#.#...#............
.#.#.####.##.#.#.#.#.####.#..#.#.#.#...#.......#.#...#####...#..
.........#.....#...#.........#...#.........#.#.#.....#.........#
##.#.###...#..########...#.########..#.#.#.#...#.#.#.#..###..#.#
.#...#.#.................#.....#...#...#...#.#.#...#...#.......#
..####.#.#..##.######..#.####.......#....#.###.#.#.....#.#..#..#
.........................................#.......#.......#.....#
####.###..###.#.#.#####.##.#######.####...###.#...##..###.#.####
