16
.....#.........#
.####..#.#......
G......#.....#.#
.###.#.#####..#.
.#...#.....#...#
.#.#....#####...
.#.#...#.....#.#
.#.#.###.##..#..
.#...#...#.....#
...#.#.#.#####.#
........S....#.#
##.#.#.#.###.#..
.#.#.........#..
.#.#.######..#.#
...#.........#.#
###.###..###.###
