64
..G#.............#.................#...#...#.............#.....#
......##.#########.#####.#.#.#####.#...###.#.#####.#.#.###.#.#.#
...#.........#...#.#.....#.......#.........#.....#.......#.#....
.#...#.#.##..#.#.#.#..##.####..#..#.####.#...#...##..##....##..#
.#.......#...#...#.....#...........#...#.....#...#.....#.....#.#
.####.####.###...#.#.#.###.#.#.#.......#.###.#.#.#####.##.####.#
.........#...#.#.....#...#.....#.....#.......#.#...#.....#.....#
.####....#.#.#.#..##..##.#.###....####.#...###.#.#.#...###...#.#
.......#...#.........#...#.....#...#.....#...#...#.#...#...#....
.##..#...###.#..#.###..#####..##...##....#.#...#.#.#####.##..#.#
...#.#.............#...#.......#...#...#.........#.....#........
##....#..#.#..###.##.#...###.###.###.##...##...#.#####.#..#..#.#
...#.....#...#...#...#...#...........#.......#...........#.....#
.#.....#.###.#.....###..##....####.#.#.###..##.#.#.#.#.#.#.###..
...#...#...#.....#.#.......#.#.....#...#...#...#...#.#.......#.#
.#..#####....##..#.#.##..#.#.#.#..##...#...#.#.#..##...#.###.#.#
.......#...#...#.#.#...#.........#...#...#.#.....#.....#...#...#
.##.##.#..##.#.#.....#.#.#.##.##.#.#.#.#.#.#.#####.###.##...#.##
.#...#.#.#...#.....#.#.#.....#...#.#.#.#.#...#.....#.#.........#
.....#.#.##..###.###...####..#..##...#..###..#.####..#...###...#
...#.#.#.......#.#...#...#.....#...#.#.......#...............#.#
.....#.####.##.#.#.#####.#####.#.#....#.#.##.#.#.#####.#.###.#.#
.#.#...#.....#.#.#.....#.......#.....#.......#...........#......
.#..####.##..#.###...#.#.#.#....##...#.#...##.######...#...###..
.#.#.....#...#.#.........#...#.....#...........#.....#.#.......#
.#.#.###.#...#.#.####.#..#.###.#...#.#.....###.#.###.#.#..#.#.##
...#.....#.......#...........#.#...#...#.....#.#...#...#...#...#
.#.##.##...#######.#########.....#.#.#....#..#.###.#.###...#.#..
.........#.........#...#.....#.#...#...#..S#.......#............
...##..##.##..#.###..#.#.##.####.#...##.#..#..######.#.#.###..#.
...#...#.........#.................#.............#.........#....
###..##.####.###...#########.#.#.#.#.#.###..#.....#.#...#..#...#
.....#.....#.....#...#.......#...#...#.......#.#.#.......#.....#
..####.#.#.#.#.#####.##..#.#..####.#.###..##.#.#.#..#..#.#.#...#
.....#.#.#.........#.....#.......#.#...........#...#...........#
####...#.###.#.#.#.####.##...##....#.#.#.....#.#.#.....#.###.#..
...#.#...#.......#.#.....#.#.#...#.............#.....#.....#...#
.#.#.#.#.....###.#.#.#.#.#.#.#.#####..#..#.#.#...###....#......#
.#...#.#.......#...........#.......#...#.......#.#.#.....#.#.#.#
.##..#####.##..###.##....#..#..#.#.###..#....#.#...##..#.#.#...#
.....#.....#.......#.......#.....#.........#.........#...#.#...#
.#......#..#.#..##...##.##.#..#.########.#########...#.#........
.#...#.#...#.....#.......#.#.......#...............#.....#...#..
##.#.#.#..####.#...#..#....##.####.#.#####.####.##.#...#.##....#
...#.....................#.........#...#...........#...#.#.#....
....##.#.#.####.###.#....#.#...#....##.#.##..#.#.###.#.#.#.#.#..
.#.#...#...#.......#.........#...#...........#.....#...#........
.#.#.#.######..##..#.###.#.##..###.####..###.#.....#.###...##..#
...#.#.................#.......#...#...#...#...#...#.#...#.#...#
.#...#..##.#.#####.#.#.#.###.#....##.##....#.###.#.###.#.#.#.#.#
.#...#...#.................#.#.........#.........#.#...#.#.#.#.#
.#..####.#.####..##.##.##.....#.#.####.#...#.#.#.###..##...#...#
.#.#.....#.#...#.........#.#...........#.#.....#.#.....#...#...#
.....#.##..#.#..#..###.#...###..##.#......####.##...#.####..##..
.#.......#.........#.....#.............#...#...#...#.........#.#
.##.####.#.##..#.##..#..#.#..##..#########.#.###.###.###.#.###.#
...#.....#...#...............#...#.........#.........#.#.....#.#
##.#...##..#..#.###.##.#.#####..##..####.#..##.##....#..#.#..#.#
...#.....#.#.#...#...#.#.....#.........#.#.....#...#.......#...#
..##.#..#..#.#.#.#.#.#.###.#.#.#...#.....#..#..#..##.##.##..####
.............#.#...#.#...#.#.....#...#.#.......#.#.......#...#.#
.#.#.....#...#..###..###...##..###.#.##.########..##.#.#.....#.#
...#...#.......#...................#...................#.......#
####...##########.#..#####.#.#.#.#######.###.##.###.#.#..####.##
