64
.........................#.........#.....................#...#.#
.#.###.###.##..#....##...#....#.##.#...#...#.#..#..#.###...#....
...........#...........#...#.......#...#.............#..........
.###..#........#..####.......#.##...#..#.#..#.....##.#.#...####.
...#.....#.................#........S....................#......
.....###.#.######.#....#.#...#..##.#.#....##.....#...#.#.#...#.#
...#.#.........#.......#.........#.....................#........
......##..#..#....##.#.#..#..#.#.....###...##.....#..#.#.#.#.#..
.......#.............#.........#.#.......#.#.#...#...#.......#.#
...#.#.###.#..#......####...##...#.#.##............#.....#..##.#
.............#.........#.......#...#.....#.....#.#.#.....#.....#
......##.....#.........#..##.#.##......#......#..#.#...#....#...
.#.......#.........#...#.........#.............#.#.....#.......#
.#.###.#..##..#..#....#....####...##..##.#.#.....#.#.#..#..#...#
.........#...............#.........#.........#.......#.......#..
...#.#....##.#.....#.#.##....#.....#.....###..#..#......#....#..
...#...........#.............#...#.........#.........#..........
..##.#.##....#..#.###....#..###..#.#..##.#.#..#....#.##......#.#
.#...........#.......#...#.#.......#.....#...............#......
.........##........#...#.###.....#.....#.##.##.#.#...#.#...##...
...............#.#.....................#.......#.....#.........#
...#..#........#.....####.#.####.#.###.##..#.......####.#......#
...............#.................#.#.......#.......#.....#...#.#
.#.#.###....###....#...#..#.....##.######..#...###....#..#.##...
.....................#.....................#...#...#...#.......#
##...#.....####.###...#.##.###...##....#.#.......#.###.....#..#.
...#.#.....#...........#.......#.....#.....#...............#....
...#.#..#.#......#...#.#.#......###.#...#.......##....##........
.#.........#...#.................#...............#...#...#...#.#
..#...#.....##...#.######......#.#.#####.#.....#.#...#.#.#.....#
.........#.....................#.........#.....#...#...#...#...#
#..##....###.#.##.#...###....#...###.#..###..#.#.#.#.#.###.#.#..
.........#.......#...........#...#...#...........#.#.....#...#.#
..#.##.#.#.#.###.##..#.##.#......#.#....#..#.......#.###.#...#..
...............#...#.#.......#...........#.....#...#.....#...#.#
.......#.###.#......#..#..#####..#...#.#.#.....#.....#.....#...#
.....#...#.#...#.#.........#...#.#...............#.....#.......#
...#.....#.#....##..#.##.#.#.#...#....#.#..###.#.#.#........#...
.#.....#.....#...........#...#...#...............#...#.......#..
##.##.##.....#....#...#....##........#.##..##..#......##...#...#
...#.......#.....#.......#.....#.#.........#...#.....#.......#.#
.###....#..#...###.###.#...#.##...#.##.#####.#.#....##...#.#...#
...........#...#...#...#.......#.................#...#.........#
..#.#....#.....#..##.#...#.#...#.....####....#.#.......##.##.##.
.............#.............#.....#.....#...........#.#.......#..
.....#...#.#.#.#...#######.#.#.#...##.#..##..#...#.#.#.#..####.#
...#.....#...#...#.........#...#.#.............#................
..#..........#....#.#..#.#.#.###..####.#.#.#..##....##...##.....
.#.......#.#...#.........#...#...........#.#.....#..............
.#.#.....#..#....#.#.#....##...##..####..##.#.#.#...##.#...#....
.......#.........#.#.......#...........#.................#...#.#
..#..#.#.#...##....###.##.........#....#.#.#.#..#..#.#.#...###.#
...#.#G#.#.#.........#.......#...#...#...#.............#.......#
...#.......#...#...#.#.#..##.#.#.#.#.......#.#.#....#..#..#.....
...................#...#...............#.....#..................
####.###...#........####.#.#....##.###...##..#...#.#..#####...#.
.............#.#.#.#...........#...#.#.........#.#.#.....#...#..
.#.#..##.###.#.#.#.#....#....#.#...#...#.#.#.##....####..#.##..#
...#...........#.#...#.............#.............#.......#.....#
...#......#....#...#....#...#....#..##...##...#.###.#....#.....#
.........#.....#.............#...#.......#...#.......#.....#.#..
....#..#.....####...####...#...###.#...#.#.#...###.##..##.#....#
...........#...........................#...#.....#...........#..
####.#.#.##..#.#..#.......######.##.###........##.####...#....##
