16
......G....#...#
.##....###.#.#.#
...#.....#...#..
.#.#.###...##..#
................
..#.....##..##.#
.....#.#.......#
...#.....##..###
...............#
...#.###....##.#
...............#
...###..##.#.#.#
...........#...#
.#.#...#........
............S...
......###.##....
