32
.................#.....#.......#
.###.#.###.###.#.####..#..##...#
.#S..#.....#...#.....#...#...#.#
.#####.#.#...#######.#.#.#.##.##
...#...#...#...#...#.#..........
.#...#.###.#.#.....#.###.....#..
.......#.#.....#.#.#...#........
.#...#...#.###.#..####.##..###.#
.....#.#.....#.#.....#.#.....#.#
##.#.#.###.#.#.#.#...#...###.#.#
...#.......#.#.....#...#.......#
.#.#..#..#...#.#.#...#.#..#.#..#
.........#.......#.........#...#
#.####.....####..#.##..#.#.#.###
.......#.#.....#...#.....#.....#
.##.###..#.##..#.#.#.##..##..#..
.....#...#.......#...#...#......
##.#.#.#.#..###.#..#.#.#.#.#.#.#
...#.#.#.#...#.#...#.#...#.#.#.#
.#.#.###.#.#...#...#...#...#.#.#
.....#...#...#.#.#...#.#.#.#....
.#..##.###.#.#.#.#.#..#..#...##.
...#...#.#.#........G....#.#...#
.###.###.#...##.#..###...#...#.#
.#...#...#.........#.....#...#..
.#.##..#.#.#.#.##....#.#.#####.#
...#.........#.#................
.###...###.###...##.#...##.##..#
.....#.......#...#.#...#...#.#..
.....#.#.#...###.#...###.###.#.#
...#.............#.......#.....#
####.###..####.###.#####.##.####
