8
.......#
.##.#..#
G..#...#
.###.#.#
.#...#.#
...###.#
.#..S..#
#.##.###
