64
.....#.............................#...........................#
.###.#...#.#.#...#..##..##...###.....#.###.#.#.#..#.#......#.#..
.......#.....#.......#.......#...............#.........#.....#..
.##....#.##....#..##.##..####..#.#.##.###........#...#....#..#.#
.......#...#...#...#.#...#...#.............#.#.#.........#...#..
###......#.##..#...#.....#.#.....###.#.#..#..#..#.#.....#..####.
.....#.#.#...........#...#.....#.#.........#.......#.....#.....#
.##..#....#..###..##..#..#.#.....###.##.#....##....#.#.....###..
...........................#...#.......#.........#.....#.#...#.#
.##.#.##.####.#####.#....#..#..#.#.......###...#...###...#.#.#.#
.#.......#.....................#.......#...#.................#.#
.............#.##..######..#..##..###..............#.#..##.#....
.#.........................#...#...............#.....#.........#
#..#.#.#..##...###..#.......#..#.#.##.....##.###.#...###.###....
...........#.......#.........#.......#.................#........
.##.###..#.#....##.#.#..#.#...#..#.....#...##...##...#.#...##...
...#.....#.........#.......#...#.........#.#..G......#...#.....#
##....#.#..###....##.#.#.#...#.#.#.#.#...##..##....#..####..#.#.
...#.#.#...#.......#...#...#...#.....#.........#.#.#...#.#.....#
.#...#.....#...#...#...#..##...##.....##.#..#..#.#.#...#.#.##..#
...#...#.....#...............#.....#.....#.....#.#...#.#.......#
.#.#......#.##.#....#......#.#.......#........##.....#.##..#.#.#
.....................#...#.#...#.#.#...#...#.#.#...#.....#.....#
..###.##.##...#.###....#.#.#.#...#....##..##...#.#....##.#.###..
.............#...#.......#.......#...........#.......#.#.....#..
#.#......#..#....#......###..#......#.###...#..####.##.....#....
...............#.#...#...................#...#...........#.....#
.......#.....#...#.###..##...#...###...#.##..#.....#..#.#...#..#
.....#...#.#...#.#...................#.#.............#...#......
...#....#.....#..#..####.###..#..#.#.....#.......#.#.....##.....
...........#.........#...#.#.....#.......#.....#.......#...#...#
.#.#..###...#...............#..#.##......#.##....##......#..##.#
.#.#...........#.#.#.........................#.#.......#.#......
.#...#...##.#.....##...###.#.#...#.##......#...####.#.##....#...
...............#.#.....................#.#...#.....#.........#.#
.......#.#.#.##..#.#...#...#.###.#.#.###...#.#...#.#.#####.....#
...#...#.....#.............#.........#.......#.......#.....#....
.....###.##....#.#...#.##..#.#...#...#.#.#.....##......#..##...#
...........#...........#...#.........#.#.....................#..
...#####.......#.#...#.#.#...#.#.###...#.#.#.#.#.#.....####.#..#
.............#.......#...#...#.#...............................#
#....#...###.#.##...##...#.......#...###.#..##.#..#.##.#.###.#.#
...#.........#.......#.........#.#...........#.........#........
.#.#.#...###..##..#..#...###.#.#.#....##.........#.#.##.#.##.#..
...#.......#.................#.........#.......#.......#.....#..
..#....#....#.##....##...#..#.#..####.##.....#...........####.#.
.......#...#.......#.............#.......#.....#.........#.....#
..##.#...#...#.##........#..##.#.#..##.##..###.#....#........#..
.........#...#.........#.......#...............#.......#.......#
.....#.##........#...#.#..##.###.##....#.#...#.#.#.##..##.......
.#....S....#.........#.........#...#...#...#.#...#...#..........
..#...#....#...#...........###..#....#.#....##.#.#........##..##
.....#.............#.......#.......#...#.......#.#.........#....
.#.#.......#.#..#.......##.##.##.#.#.###..###.##...#.##..#...#.#
.#...................#.........#...................#.......#....
..#.###.#..#......##..#...#....#.#.....###.#.######.#..#.....#..
.#.........................#.............................#.#....
.#..#..###.##...#......#.#...#...#.#.###....#....#.....#.......#
.#.....#.................#...#...#.......#...#.......#.#.#...#.#
.....#...###..####...##...#..#.#...#.#..##....#.#..#.....#.#.#.#
.......#.#...#...#.................#.#.....#.......#.....#......
..#..#...#.....#.#...#.#.##.####..##...###.##..#...#.###..#....#
...............................................................#
...###.#......#####.##.#.#.#.#..#.##..##...##.##.......#..#..#.#
