8
.#S....#
...###..
........
...#.#..
.......#
#.......
....G..#
#..##...
