32
...............................#
.#.##...##.#......#...##...#.#..
...#.........#...#...#.......#..
#....#....###..###..#..####.#...
.......#.......#.......#.......#
.....#.####..###...#.#.#.#......
.#.......#.......#.....#.#...#.#
...#.....#.#.#.#..#....#....#...
.........#.#.........#...#......
#..#..#.#..##.#.#........#.#..#.
...........#.............#.#....
.#.#..#.#.##..#..###.......#...#
.....#.....#.#...........#...#.#
.#.....###...#####.#.##.##......
S#...#...#...#.............#....
...#.#.#.##.....####.###......##
...#...#...#...#...........#...#
..#..#.#.#.#.#.###.##..#....##.#
.#...#.......#...#.#...#.......#
.....#.#.#.#.....#....##.#####.#
...#...........#.......#...#....
#...#....#.....#...#.#.#.#.##..#
.........#.#.........#...#...#.#
...#.##..#..##.###...#...#.#...#
.#.#.........#.....#.........#.#
.#.#.....##...##...#####...###.#
...#.#.........#.......#.#......
.#.####...##...#.#...#.#.#......
.................#.....#...#...#
...###.......#...#.#.#.....#.#..
.........#..........G..#.......#
..###.###.#..##.##...#...#######
