32
...........................#....
.#.##.#.##...#.#.######....#.#..
.#.......#...........#.......#..
.....###.#.#.#.#..#....##.##...#
.#.....#.......#.....#..........
..####.#.#.#.#...##..#...###.#.#
...................#G...........
...#....##..####.#.#.#..#.##.#..
.......#.....#..................
.....#.#.#......#.##...#.#...#..
.#.......#.#.#..................
...###...#.#.....#..#......#....
...#.#.......#...........#......
.#.....#.#...#...###..##........
.#.....#.#.#...........#........
.#.........#.###.........#.##.#.
.#.............#.......#........
.#.##....#...#...#.#.##..#.#.#..
...#.#...#......................
#..#.#.....#...#.#.......###....
.........#.#.................#.#
.#...#..#..#.#.....#.#.###.#.#.#
..S....#.......#.............#..
..###..#.#.###.#.#..#....#.....#
.........#...#.#...#.......#....
.##.#..#.#.#......##.....#.#.##.
.......#...#...................#
.#####.#...#.#.#.#......##...#.#
.........#.#.......#...#.......#
###.#..#.....#.......#.#....##..
.............#...#.......#......
##..#...####.##..####...#...#...
