64
....G..#...........................................#...........#
.##..#.........##..#.#...##..#...#..#....##..#.....###...#.#...#
.............................#...............#...#.....#.......#
.#.#...#.#....#....#...#.#...#...#.#.#.#.............#...#.#.#.#
.........#...#...#.#.#...#...#.#...............#.#.............#
#..#...#.....#.#...#.##.#..#.#.##......#....##.......#...#.###.#
.#.#.#...............#...........#.#.....#...#...#...#.........#
.#.#.#.#.##....#.......#..#....#.....#...#.#.#..##.#.###..##..##
...#.........#.#...#...#.#...#.#...#...#.......................#
..#.##...#.....#.......#...##....#..#...##.#####.##..#..##.#....
.......#.#.......#.....#.......#...#.......#.............#.....#
..#....#..#.#....#...#.......#..#..#...#.#.#..#....#.#.#...#.#..
.....#.......#...#.#...#.....#.#...#.........#.....#.#.#........
..###..###.#.#.#...#.....#..#..#..##...#...#.#.##......###.#...#
.......#...#...#...#...#.....#.........#.....#...............#..
...###......#.....##...##.#....##...##.##.##.#.#.####..##.#.#..#
...............#.#...#...#.#.#.....#............................
..######...#.#...............#...#.####...##..##...#.###.......#
.#.........#.....#.....#...#...#................................
.#.##.#.#......#.#.#.#.##....#.##..#.#...#....#..#.#.#.###.#.#..
.#.......#...#.......#.#.....#.#.........#.#....................
#.......#......#....##.#.#.#.#....#...##...#.#...#.##..##...##..
...............#.......#...#.............#.....#...#...........#
.###....###.##...#.#...##...#.##...#....##.#...#......#.#......#
.......#.......#.#.#.....#.....#...#.............#.#.......#....
.#.....#.#.......#...###.##..#.#.....##.#...##......#.##.#.#..#.
.....#...........#.#.............#.#...#...#....................
.#.#.###........##.#.#.#..#....#...........#..#............#.#..
...#.........#.#.....#.#.......#...................#............
......##.#...#.#.##.##...#.....#......######.....#.#...#...#.#.#
.#.#...#.......#.#.....#...........#...#.....#.#.#.....#.#.#....
.#.........#.#.#.#.......#.##.#....#.#...#.##..........#...##..#
.#...#.......#.....#.#...............#.#.....#...........#......
...#...#.##....#.#.#.#.....#.....#.....#.#....#.#..#.#.#.###....
.#.#...#...............#...#...#................................
.#.#.....#....##...#...#......#.##..##...#........##.....#...#..
.#.......#.#.....................................#.....#...#...#
.#.#...###...#.#.#.#....#..##....#.......#...###...###..##.#.##.
.#.........#.#.#.........#...............#.................#...#
.#.####...##.......#.##....#.#............#.###.#..#...##.#..#..
.......#.#.....#...#.#.......#.........#.....................#.#
..........##.#.......#..#....#...#.##...#..#...##...##..###....#
...........#.#.......#......S..#.................#..............
.#.####..#.#.#...#..###...###.#.......#....#.##...##.#.....#...#
.........#.#.#.....................#.....#.#...#.......#.#.#...#
##.#.....#......#.##.#..##.#.##.#...#..#.##.##.#.#...#.#.#...###
.......#...#.....#.........#.....#...............#...#.#...#...#
..##.#...#.#.#...#....#..#.#.#....#....#...#.##......#....#....#
.............#.#...#...............#.....#...#.....#...........#
...#.#.#.###.....#.#....##.#.....#.#...#####....#....#.#........
.#.............#.............#...#.#.......#.........#.....#....
.###...##......#.#....#......#..#.##...##..#.#.####.##.#.###.#.#
...#.....#.........#.....#...#.......#...#.................#.#.#
.#....#..#.####.##.#.....#.#...######.#....#.#.##......#...#.#..
.#.....#.#.................#.............#.........#.#.#...#.#.#
##...###......#..#.#....#.##....##.#.#.##.#..#.#.###.#.#.......#
.........#...#.........#.......#.......#...#.............#.....#
..##...##......##...##.#.#..#.##.#.####..#.#.#.###.##.#.##.###..
.#.....#...#.....#.............#.................#.............#
.#.####.##.##.#..#...#..####.#.#..#.#.##.#..#....#.#..#.##.#....
.......#...#.#...#...........#...............#.............#...#
..#..#.....#....##.#..##..##.#...#.....#...#.....####..#.#.....#
.....#.................................................#........
#..#...##.##.....#..#.##............#.##.#.##.##.#.#.##....####.
