8
.......#
.#...###
.#....S#
.#.#.###
G.......
.#.#...#
.......#
#####.##
