32
..............G#................
.#.#.#..####..##.#.###.#..####.#
.#.#.#...#.......#.....#........
...#.#.#.#.###.####.##.###.#....
.#.....#.#.................#...#
...#.#.#.#.##..#.#....##.#.###.#
.......#.........#...........#.#
.#.#####....#.########.##..#.#.#
.........#.#...#.....#.#...#...#
.#...#####.#...#..##.#.#..##.#..
.....#...........#...#.....#...#
.#.#.#..###..#......##...##..#.#
.......#.........#.#............
##..##.#..########.#.##..#.#.#.#
.....#.#...#...#.............#..
.###.#####.#.#.#...##..#.###.###
.#.#.......#.#.#...#.......#...#
.#.#########.#..#....#....#....#
.#...............#..............
...#.##.#.#...##.#.##.#...####.#
.#.#.....#...#.......#.......#.#
.#######...###.##..###.#####.#..
.........#.......#.....#...#...#
.#.#...#.#.##..#.#...#.#...####.
...#...#.#.....#.........#.....#
.###.#..###..#.##..#....#.##.#.#
...#.#.......#.........#.......#
.....###.#..##...#.#.#.#........
.#......S#...#.....#...#...#.#.#
.#.###..####.#.#.#.#.....##..#..
.......#.......#.#.....#.......#
..####.#...##.#########.########
