8
......G.
.#.##...
S.......
..#.....
........
...#.#.#
.......#
#..####.
