16
.#..............
.#...#..#...##..
.....#.........#
......##.#.#.#.#
...#...#.....#..
.........#.#.#.#
..........S.....
##...#....##.##.
...#...........#
.#....#.#..#...#
.......#.......#
.#.........#.#..
...#.#...#.#.#..
...#...##...##.#
..G............#
###...##.##.#...
