64
...........#.......#...........................................#
.#.#.#...#.####..#.#...#.....#.#.##.##...#.####..#...##.....#..#
.#.#.#...................................#.#.......#.....#...#.#
.#......##...#....#..#....#..#...##...#.......#######..#..##...#
.#.......#...........#.....#...............#.#...............#.#
.#####...#.###.#.#.#.#.#.........#.#...###...#.....#.#....#.##.#
.............#.#...#.....#.#.#.....#.........#.......#..........
.##.#.#..###...#.#..##..##...#.#.#.#..##.#.#.#.....#.#...#.#.#..
.............#.....#.......#...#.#.............#.......#........
.#..##.......#..##.#.....##..###..#..##...##.#.....#...#....###.
.........#.........#...........#...#.....#.......#.....#...#....
..##.#...#.#.##...#.##.#..###..#.#.......#.#....##.#.#.##..#.#.#
.........#...........#.............#...#.....#...#.......#...#.#
.##...##.#.#.#.#.#.#.##......##.###......#.##......##.##.###....
.......#.......#...........#.......#.....#...............#...#.#
.#......#..#.#.#..##.#.#..##........##.#####.#.##....#.#...#...#
...............#.......#...............#.............#..........
.#####...#...#.#...##...##.#.####..#.#...#..##.#.###......###.##
.......#...........#...#...................#....................
...#.#...##....#.#....##..#....###.#.............##.....#......#
.......#...#.............#.......#.......#...........#...#...#.#
.......#.#..##.....#..##...##..#.....##..#.#..#...##...#.#...#.#
.#...#...................#...#.....#...........#...#...#.#......
..##.#...#...#.###...#.....#.....#.#........##..##..#.......#...
...#.......#.............#...#.......#.#...............#........
......##........#...##.....##.#......#.#...###..####.#.#.#.##..#
...#.......#.........#...............#...............#.........#
..#..###.###.......##..#.....#.#...#.#.##..#....##..#.#...#..#..
.....#.....#.......#...#...............#...#.#.........#.......#
.#..##..#....#...#.#.....###.....#...#.#.###.....#.........#...#
.........#.........#.......#.#.#.....#.............#.........#..
...##..#.#...#..##.#..#....#.#.#.#.#.........#.....##.##...#.#.#
..S#.....................#...#.....#.#...........#.......#...#..
###....#..####.#.###...#.....#......##..#..####..##.##...##..#.#
...................#.#.#.......#...........#...........#.......#
...###....##.###.#.#.##..#...#...#.#...#...#.#.#.#.#.####..#.#..
...#.#...................#...#.......................#..........
#..#.....#.#.##......#..##...#.##..#..#..#.#####.#.#.#####...###
.....#.#...........#...#...#.......#............................
...#...#.....#####.#.#....##.#.#.......##..##.#..#...#....##...#
.........#.....#.....#.......#.......#...#...#.......#...#.....#
.#....#.####.#...#...#####.....#.#..#..#..##...###.....##..#####
.#.............#...#.......#.................#.........#.#.....#
.#...###.#.#...###..#......#.#.#...#...#...#.#.#.####....#.....#
.......#...........#...........#...#.....#...........#...#.....#
...#.......#.###..##...##..#.....#..##...#.#....##.#..#...#.....
.#...#.#.............#.........#.#..............................
#...#.#....#...#...........#.#.###.##.#..###..#.#..##....##.##..
.........#...............#...#...........#...........#.#.......#
.#.#.....###.#.#...#.....#.#..........#.......##.....#...####..#
.#.#...#.......#.#.#.....#...#.#.......#.........#...........#..
.#.###..###..#.........#.#......###....#...#...#.#.#.#.#.#.#...#
.........#.........#.......#...#.................#...#.#.#......
.#.#..#..#.....#..##...#.........##.##.###..##.#.#..#..#...#..#.
.........#.......#...#.......#...#.......#...........#.#.#.....#
.......#...#.#....##.#.##..##..#..##.###.#.#.....#...#...#..#..#
...............#.....................................#..........
.##.#....#.#.#.##.#..#.###...##....#.#.#.#...###.#.#...#..##...#
.....................#.#.....#...#...#.......................#.#
...##....#...#.......#.#..#####..##..##.##....##.##.#.#.#..##...
.......#...........#.............................#..............
.#...##.......#......#.#...#..#.###.#....#.#..##.#.#.#..###.....
...............#.......#..........................G.............
#######.##...#...####..#.##.#..##.###..#..###.#...##.....##.###.
