16
.#S............#
.........#.##..#
...#...#........
.#...#.....#.#..
.#.........#.#..
....#..##.##....
.#..............
....#..#....###.
...........#...#
.###....####....
...............#
.#.#...........#
...#...........#
.###.#.#.#.#...#
G...............
#.#####.##...#.#
