8
....G...
.#...#.#
.....#.#
.##..#..
........
..#....#
S....#..
.##...#.
