32
.........#...#...........#.....#
...####....#.....###...###...#.#
.#.........#......S........#.#..
.##.#.###.#####..###.#.#..##.#..
...........................#.#.#
###.....#....###.#####.#...#.#..
.#...#...#...#.#...........#....
...#####.#...#.#.####.#######...
...#...#.#...............#.....#
.#.#.#.#.#.....#.#.#.###...###..
...#...#.......#.#.#.#...#...#.#
.###..#..###.#...#.#..####...###
.............#.#.#.#.#.....#....
##.##.####.#.#.....#.#..##.###.#
.#.......#.....#.#..............
.....##..####.##.###.#..##.###.#
...#.....#...#...............#..
.#...####.....#.#..#.###.#.###.#
.....#.......#...#...........#..
.#..###..#.#...#.#.###..#..#.#..
.#.........#...#.#.....#.......#
....##.###.#####.#.#..#..#.#####
.#...#.....#.#...#.#.#.....#...#
..##...##..#.#.#####..##.#.#.#..
...#...#.....#.#.....#...#.#.#.#
.#.#.#.#..#..#.###.##....#.###.#
.#...........#.........#.#.....#
....####..#..#.#...#.##.##.#.#.#
.............#.#.#.........#...#
...######..#.#.....###..#.##.#.#
.................#........G..#.#
#####.#####.####....#####..##.##
