16
..G..........#..
..#..##.##...#.#
...............#
......#..#...##.
.....#.........#
...#....#.#....#
.....#.........#
.##..#.#.##.....
.#...#.........#
.......##...##..
.......#...#S...
....#..#..##.#..
.#..............
.#####.....#.#.#
...........#....
###.#.#..##.#..#
