64
.................................#...............#.#...........#
...#.##.#..#...#.###.#.######..#.#.###.###.###.#.#.#.#####...#.#
...#.........#...#...#.........#...#...#.#.#.#...#.....#.....#..
.##.##....#.#....#..###..#####.#####.###...#...###.##.##.#####.#
.....#.....#.....#...#.......#.....#.......#.#...#...#...#...#.#
#....#####.#..######.#####.#.####..##.##.#.#.....#.#.#..#..#.#.#
...#.....#.#.....#...#.....#...#...#.....#.#.......#...#.......#
..####...#.#####.....#...##..#...#.#...#.#.#.#######..##.######.
...#...#.......#...#.....#.....#...........#.........#.#.......#
.#.#...#.##..#.#.#.#..##.#.#####.#.##..#####.#.#.##.##..###.##..
.....#.......#.#.#.........#...#.....#.#.....#.#...#............
.#.......###......####.#.###.#..##.###.#..#....##....##.##.###.#
...#...#...#.#.......#.#.....#...#...#.#.....#.#...#.....#.#...#
#.####.#.#.#.##.##..##..####.##..#...#.#.#..####.###.#.#.#.#....
.....#.#.#.#...#.#.....#...#.#...#.#.......#.....#...#.#.#.#.#.#
.###.#.#.#.#.#.#.#.....#.#.###.###.#####.###.#...#.###.#.#.##...
.#.....#.#...#.......#...#...#...............#.....#...#.#......
.####.##.###.##....#..##.###.###.#.##..######.####....##.#####.#
...#.........#...#.#.....#.#...#.#...................#.#.....#.#
#....###.#.#.#.###..#.####..##.#.######.########.###.#.#..#.....
.......#.....#.#...#.....................#...#...........#.#.#.#
.#####.#..##.#.#.###.#..#.##..########.#.#.#.#.#.#######.#.#....
.....#.#...#.#...#...#.......#.......#.#...#.....#.....#...#.#..
.#.#.#.###..##.###.#..####...#.#..##.###.#.#####.#.##....#.#.#.#
...#.....#.....#...#.....#.#.#.#.#.#...#.......#.....#...#...#.#
.#.###.#.#########.##.##.#.#..##....##.#.#####.##.####.#.#.#....
.#.........#.........#.....#...#.#...#.........#.......#.#...#S#
.######.##.#..####.#.#.##...##...###.#.###.#.###.#.#.###.....#.#
.#.......#...#.........#.....#.#...#.....#.........#.#...#.#...#
.#.##.##.###.#.###.###.#.#.#.#.###.#####.#######.###.#.###..####
.#.....#.#.......#...#.#...#.#...#.........#...#.#...#.#...#....
..#.##.#.##.##...##..###....####.#.#....#..#.#.#.#.###.#.###.#.#
.#.......#...#...#...#.....#...#.#...#.#.#.#.....#.#.....#.....#
.#..####.#.#.#.#.#.#....#..#.#.#.#.###.#.#.###.###.#..###...##..
...#.........#...#.#.#...#...#...#.....#.#.#.......#...#.....#.#
..##.###.......#.#.#..##.###.######..#.#.#...##.######.#.#####.#
.....#...#.#...#.#...#...#...........#.#.............#...#.....#
#..#######..#..#.###.#..######.###.###....##.#.#.##.#....#.###.#
...#...#...#.......#.........#.........#.....#.#.......#.#...#.#
.#.#...#.##..###...#.###.#.#.####..#.#...#.###.######.##.##..#.#
.#.#.....#.......#.#.......#...#...........#.#.........#.....#..
.#.#.####.##.#.#.#.#.####.##.#.#.###.#.#.#.#.#.#######...######.
...#.#.........#.#.#.........#.#...#.......#.#.........#...#....
..##.###.#.#.###.#.##.#..#.#.#..#..#.#..####.#.#.#######.#.#.#.#
...#.....#.#.#...#.#...#...#.#.....#...#.....#.#.......#.#...#.#
.#.######..##..#.###.#.#.#.#########.#.#.#.##..#..##..##.#####.#
.#.............#.....#...............#...#.#...#.#.#...........#
##.#.#.#.#####.#...##.##.#.#.#....##.#.#.###.##..#.#.#.###.#.#.#
.....#.........#.#.#.........#...#...#.#.....#.....#...#...#...#
.###.#######...#.###.#...#######.....#.#######.####.##....##.#.#
.#.#.#.......#.#.......#.#.......................#...#.#.#......
.#.#.#..####.#########.#...#...#.####.#..#.#...###.#.#.#.#.#.#.#
.#...#.#...#...#.......#...#.#.#.#.....#...#.#.#...#.#...#.#...#
....##.#.#.##..#.#######.##..#...#.#.#####.#.#...#.#...##.##.###
.#.....#.#.#.........#.....#.#.#.#.#.......#.#.#...#............
.#.###...#.#..###..#.#.###...###...#####..##.###.#.#.#.##.####.#
.......#...........#.................#.#...#.#...#.#.#...#.....#
...#.##..#####.####.####.#...#######...###.#.#..##.#.###.#..#...
.#.#G..#.#.........#.......#.#...#...#...#.#...#.#.......#.....#
.#.....#.###.#####.#.#####.##....#.###.###.#####.#.######..#.###
.#.#.#...#...#.#.........#...#.....#.....#.......#.#...#...#...#
.#..##.###.##..#...###.#..##.#.#######.#.###.####..#.#.#.#####.#
.#.........#...........#...#.............................#......
##.##.####.##.#.#.######.###############..#######.#######.######
