16
....G......#...#
..##.###.#.###.#
...#.....#.#...#
.###.#..##.#...#
.#...........#.#
##.###.#.####...
...#.....#...#.#
.###...#.......#
...#.#.....#....
.#...#####.##..#
.#.......#.#...#
.##..#...#.#.###
.......#...#S#.#
#######.....#..#
...............#
##.#####..######
