64
...........................#.......................#............
.....##...##...#....#........###.......##.#..#.###.....#.#......
.................#.#.........#.......#...............#...#.#...#
.#.#...###.#.#.#.....##.#..#.#...##..###.###.###...#...#.#..#...
...............#.............#.....#.#.#.........#...........#.#
....##.....#......#......#.##..#..#.....###..###.......#####....
.........#...#...................#.......#.#...#.#..S....#......
.##........##.#..###...#...........###.#...#.#...#.....#.##.#...
...............#.....#.........#.#.....#.#.....#.......#........
...#..###.##.#.#........#####......#.#.....#...#.###..#..####..#
.............#.................#.....#.#...#...#...#.......#.#..
.....#.#...#...#....#..#..#...#.##.....#####.#..#..#.#.#.#.....#
...........#...#.......#...............#.................#...#.#
.#.#.#.......#...#........###..#.###.#...##..#...#.....##.####.#
.#.#.............#.#...#.........#...................#.....#....
.##..#.....#.#...##....#...#.##......#...#.####....#....#..#.#.#
...........#.............#.......#.......#.........#.....#......
.#.###.#.#...#...#....####.#...#.####.##.##...##...#.#...#.##...
...#.#.#.#...........#.......#...#.......#.............#.......#
.#...#.#.....##................#...#####.#.#..#.#.###.....##.#..
...#...#.#.........#.....#.#...............#...........#.......#
...#####....##.#......#..#.......#.#.........#.#.#.##.####.####.
.......#.........#...............#.....#.............#.........#
##.##....#.#.#..#.....#..#.#...#...#.#.###.#.#..#..#.##.....##.#
...........#.#.......#...#...#.....#...............#.....#.....#
.#.....#.#.#..##...#.#..#...#####.....##..#..#####.###.###.#.#.#
...#...#.#.......#.......#.............#...#...........#.....#.#
.#...##....#.#..##...#...#.....#..##.....#...#..###..#...#.#...#
.#.#.......#...#...#.#.....#.........#...#...#...#...#.....#.#..
.#.#..##.#....#..#.#.....####.##..###......#.#...#.....###...#.#
...........#...................#.....#...#...........#.......#..
.#.##..#.#.#.#.......###.#.#......#..#...#...#..#....#...#.....#
.............#.............#.#...#...........#..................
.#...#.#...#.#...#....###....#..##..###.......#..#.##..#.....#.#
...#.#.....#...#...#.......#...#.............#.#.....#.....#....
.#####...#####.##.#####.##.##....#.....###...#...#....####..##..
...........................#...#.........#.#...#.#.......#.#...#
...#.##..#.#.#.#...##..#..#..#..#....#.#.#...#...#..##.#.#...#.#
...#.....#.....#.....#.....#.#.............#.........#.....#...#
.#.#.#.#.#...#....##..#.#..#.#.##......#...#...#..##...#.#.#.#.#
.......#.....#.....#.....#.....#...#.#...................#.#....
.#.#.##..###..#..#...#.#.#..###....#........#........##...##...#
.........#.....#.....#G#.........#...........#.........#........
#...#.#..#...#...###.#.#.##.#.#####..##.....##....#..##.##......
.#.........#.......#.#.............#...#.....#.#...........#...#
..#.#...#..............##....#.##...#..#...........##..#.....#..
.......#...#.....#.......#...#...#.......#.....#.#...#...#...#..
.......#.#.##.#....##....#.....#.#...#.#.......#.#...#########.#
...........#.#...#.....#.........#...#.#.....................#..
...#..#......#..##.###....##.....#.###.........##.####.##..#.#..
...#.............#.....#.....#...........#.....#.......#.....#.#
#..#.#...##..#.#...###...#..##..........##.#.#.....###....#.....
.....#...................#.#.#...#...#.....#.#...#...#.........#
..##..#..#..##.....#.#..#....#.#...###...#.#.#..##...........#..
...#.................#.......#...#.#.......#.#.....#...#........
#.............###......#.##..#...#...##..#.#.#.#.#.#..##.#.#.#.#
.....#.............#.......#...#...........#.....#.#...........#
...#.#..#.##...#.#.#...#.....#....#.##.#.#.#...#.....##......#.#
.#...#.........#.......#.....#.........#.#...#...#..............
..#.##.....###.....#.#...#.#.....#..##....##...#.#....#.##.....#
.....#.#.#.#.....#...#...#.......#.#.....#...#.....#............
..##.....#....#..#.#.#.##..###.....#.....#....####.#..#..#..#..#
...#...#...#.........................#.....#....................
##...#.##...####.#...##.........###.#.#.#..#####..#.####..#.####
