32
...#...............#...........#
.#...#....#....#.#.....#.#.##..#
...#.#.#.............#.....#....
..#.........#....##.##.#...#...#
.......#.#.....#.....#.....#.#..
.##.#..#...##.##.....#.###...##.
.......#.......#.#...#...#.....#
....###..#.........###.#...###.#
.#.#.......#.#...........#.#....
.#..###..#....#..#.#...#...#.#..
.....#...................#.....#
..#..#...#.#...##...##....##...#
.............#...#.#.....#.....#
##.#..##..##.#.......#.#.#.##...
.#.........#.......#.........#..
.#.....#...#.###...##........#.#
.........#...........#.........#
.#####...#...#.....#.#...#...###
...........#.......#.#.....#....
...##....#...#.#.#...#.##..#...#
.#S..#.....#.#...#...........#.#
.#...#.#####.#.###..#..#####.#.#
...#...#...............#........
.#.#..........###......#....#..#
.#...#...#.#.#.......#.#.......#
.#.#....#..#......###.........##
.....#.................#........
.#.##.#...#...........####......
...........#.........#.........#
...#...#.#..#..#.#######.#.#..##
...............#.........#..G...
##.####.####..##.##..#..##...##.
