16
................
.#..#.####..##.#
G..#.....#...#.#
.#.#.#.#.#...#.#
.......#.#.....#
.##..###...#.#.#
...#.....#.#...#
...#.#.##..#.###
...........#...#
...###...###.###
...#.....#....S#
##.#..###..#.#.#
.#.#.....#.....#
....###.....###.
.......#.......#
#.#######...#.##
