8
.#......
....##..
...#G...
#..#....
.....#.#
.#...#..
S#......
.....#.#
