16
.......#.......#
#..#.#.#...##...
...#......S....#
...#....#......#
.#.......#......
....##...#.###.#
.........#...#.#
.#.##....####...
.....#.....#...#
...#.#...#.#.#..
G....#..........
.#...#...##..#..
...........#...#
...#.#.....#...#
.......#.......#
##..#.##..#.###.
