8
.#S....#
...##..#
.......#
...####.
........
.....#..
....G..#
.#.#####
