16
.........#.....#
.#.#.#.#.#.#.#..
.#...........#.#
##.#.######..#.#
....S......#...#
.#.###.#.#.#...#
.#.#.......#.#.#
.#.#.#..####.#.#
.#...#.#........
.#.#.#.#.#..####
...#...#...#..G#
...#.#####.###.#
...#...#.#.....#
.#####.#..#....#
.......#.......#
#..#..#.#####.##
