64
...............#.............#.#...........................#....
##.#.###.#.##..#.#.#####..##.#.#..##.#.##.#..#....#.#.##.#.###.#
...#.#.#.#.#.....#...........#.......#...#.....#...#.....#.....#
.#.......#.##...######.##..#..#.#.##.###.######..#.#..####..#...
G..#.#...#...#.......#...#...........#...#.......#.#...........#
...#...#.#.#...#.###....#..#.#####.......#.#####...#.....###.###
.#.#...#.....#.#.#...#.#...#.......#...#.....#.....#...#........
.#.##..#########.#.####..#.###..##...#.#######..##.####.###.##..
.#.............................#...#...#.......#.....#.....#...#
...####.##.###...#.####.######.#...###...#.#####.....#..##.#.#..
...................#...#.......#.................#...#.......#.#
.#.#.###.#..###..#.#.#.#...#..#.#######.###..#..#..#.#..#.#.#..#
...#...#.#.#.....#...#...#.#.....#.................#.....#.#....
.....#.#..#.....##..##...#...##..#.#.##..#...#.###..##.#.#.#.##.
...#...#.....#...#.......#...#.#...#.........#...........#.#...#
...#...#.#######.#####.#..##.#.#.#....##.###.#.#.#####.#...###.#
.........#.......#...#.#...#...#...#...#.......#...#...#.....#.#
...#..##....###..###.#.#.#...#.######..#.#.#.#.##..#...#.....#..
.#...#.....#.#.......#.........#...#...#.#.....#...#.....#.#....
..##.#.####..#.#...#..########.#.#...#....##..##.#####.###.###.#
.#.....#.#.....#.#...#.......#...#.......................#.#....
.#..##.#...#.##..####..#.#..#..#.####..#.#...#.###.#.###.#....#.
...#...#.#.#...........#.#.....#.......#...#.......#...#...#...#
..##.###...#...#.#..####.###.#.#..####...#.#.##..#..##.#######.#
.#...#.#.......#...#.....#.......#.........#...#.....#.........#
.#.###.#.##..##..###.#.#.#.#.#.#######..##.###.....#.#.#.##....#
.#.#...#.............#.#.#...#.......#...#...#.....#.#.........#
##.#.#....##..####.###.#...#.##...#..##.####...###.#..##.#..##..
...#.#.#...#.#.......#.#...#.........#.......#.#...#.....#......
...#.#.....#.....#.#.#.#..##.#####.#....######....#.#....##.##.#
.....#.....#.......#.#...........#.....#.........#...#.........#
.#..#..###.###.#.#.#.#.###.#.###.#####.#.##.#.##...#.##.#.####.#
.....................#.#.....#.#...............#...#...........#
.##.########..##..##.#.#.###.#.#######.#.#.###..####.#.####..#.#
...#...........#.#...........#.............#...............#...#
.#.#..#####..#.#...###..####..#.##.#.#.###.#####.#.#.###.#.#.#..
.#.#.#...........#.#...#...#.......#...............#.....#.#.#..
#..#.#.#.#####..##..##...#.#.######.###...###..#.###...#.#.#...#
...#.............#.....#.#...#...............#.#...............#
..####.##..#####.####..#.#.#.#.#..##...#.#.#...#.#.#######.###.#
.....#.....#.#.........#.#.....#.#...........#...#.........#...#
.#.#.#.#.#.#.#..#####.##...#####.#....####..#.##.###.####..#...#
.#.#...#...#.#.............#.....#.........#.....#...#.....#...#
.#.###.###.#.#.####..#####.#.##.....#####..#.#.#.#..##..###..#..
.#.............#.#.......#...#.....#.......#.......#.....#...#.#
.###.#...#.#.#.....##..#.#.#.#.#.#.#.##..###.#.##..#.#.#...###..
...#...#.#.#.#...#.....#.#...........#.#.....#.#.........#......
#....#.#.#...#.#.#.##..#.###.#...###.#.#.####..#####.#.#.##.##.#
...#.#.#...#.....#......S....#.#.............#.....#.#.#.....#.#
.#####.##..#.###.#..##..##.###...#.##.#.#..#.#.##..#....####...#
.....#.#...#.........#.#.#.....#.#.....#.........#.........#...#
##.#.#.#..########.##.......###....#.#.#.###.###.#..####.#.#.#.#
...#...#.......#...............#.#...#.#...#...#.......#.#.#....
..#..#.#.#.#.....#...###.#..##.#.#...#.#...###.#.#.###.#.#..##.#
.......#.#.......#...............#...#.#.#...#.#.#.....#...#....
.#.#.#.#...#.#.###..##.....#.##.###..#.#.#.#.#.#.##..#####.#...#
...#...#.....#.#.....#...#.#.#.#...#.#.#.#...#...........#...#.#
.#.......##...#..##....#.#...#...#...#.#.#.#.#..##..##.##.#..#.#
.....#.#...#.........#...................#.#.....#.....#.....#..
..###..###..##.#####.#.#..####.......#.###.#####...#.#.#..##.#.#
.#...........#.........#.....#.#.....#.....#.......#...........#
.#.####..##......#.###.......#.#.#.#.#######.####..##.####.###..
.#...............#.......#.................#...................#
####..###...###.#.####.#.##...######.########.#.##.####.###.####
