8
.......#
...##...
S..#...#
.#.#.#.#
.....#G.
.....#.#
........
...#.###
