8
......G.
.#.###.#
.....#..
..#.#...
........
...#.#..
S.......
#.###..#
