64
...........#...............................#.....#...#..........
.#.....#.#.###.#.#.#...###.....#.#.....###...#.#.#.....#.#.###.#
.......#.#.....#.......#.......................................#
....##...#..#.##.###............###..######..##......###...#....
.#.......................#.#.......#.............#.....#...#...#
.##..###.#.#...#...###.#...#.#.#.#.##..#.##.###....#...#.#.###..
.#.....#.#.....#.......#...#...#...#...................#.......#
.#.#...#.#.##..#.##...##.###.#.#..##.#.#...###.#.....#.#.#..##..
...........#.....#.............#.............#..G..#.#.......#.#
.#####..##.#.##.###....##....#....##..#.#......###.#....####.#..
.#.....#.#...#.....#.#...#.....#.......#...#.....#...#...#...#..
...........#....##.##..#.##..#.#.....#.#...#.#.#.#..........##.#
.#...#.#.......#.#...#.#.........#.#...#.....#.#.........#.#...#
.#.#...#.#.##....#.......#.....#...##.#...#.#....###....##......
.......#...........#...#...#.#...#.......#.....#.....#.........#
..##.#.#...#.#####...#...###..##..#........#.#....#.###.###..#..
...#.....#.........#.....................#.....................#
.#.#.#.#.#....####.###.#...#......#..#.#.....###.#.#..##....##..
.....#.......#...#.....#.....#.......#.............#...........#
...####.####.#.#.#.#.#...#.#.#.....#.#.###....#....#.#..#.##.#.#
.................#...#.......#.....#.........#.......#.#........
#...##.###.......#...#.#.#.#.....#.##.#........#.#.##....#.#.#..
...#.....#.....#...............#...........#.......#...#.......#
.#.#.##..#.###.#.#...#..##....#......##.##..##....#..#.#.#......
.......#.....#.....#.....#.....#.#.#.....#.....................#
..##.#..#....#...#.......#.###.#....##...#...##..##..##.###.#...
.#...............#...#.......#...#.....#...............#.....#..
..##.#..##.#..##.#.#.#..#####..#.##....##..##..#...#.#..##..##.#
.#...............#.......#.#...#.................#.............#
.#.#..#..#..##.......#.#...#.#.#.#.###.#.##..#.#.......#.#...#..
.......#.#.#...#.....#.......#.....................#.....#.#...#
####.#.#...#.#.#..##...###.#.#.....##.##...######....##..#.#...#
...#...#...#.#...........................#...............#...#..
.....###.#.#.#.######..##..#.##.#..#.##...##.#.......#.........#
...#...................#.........#...................#...#.....#
.#...#..##.#.###.#.......#.#####.#.#....#........#.###......###.
.....#S..........#.#.#.............#.......#.#.#...#.......#....
.......#.#...#..##....#..#...#...#...###.#.#.#.#...#.#...#.#....
.#.#...#...........#.....#.#.........#...#...#.........#.#...#.#
.#.##..#.#.####........#...#.##.#..#.#...........#..#..#.#.#.#..
.........#.#.........#.....#.................#...#...#.#.....#.#
.....##....#.##..#.#.#.#....##..#..###.....##....#.###..#......#
.#.#...#.#...........#.#.#...#.....#.......................#....
...#....#....#.#.##..#.......###.#...##.##.#.#.#..##.###........
.#...#.....#.#.....#.........#...#.........#.........#.......#.#
.#.#####.#..##.#...###.#.##..#.#...........#####.###..##...#....
...............#.............#.#...#...#.#.....................#
.#.###.##.##..#..##..##........#..##......##.#.....#.........#..
.................#.#.....#.....#.....#.#...#...#.........#.#....
.#..##.#.#..##.#...#..#.#.#....#.#.#.#.#.#.....##.....##.#..#...
...........#...#...#...........#.........#.........#...#........
#..#...##..#...#.#..#.....#..#...#.##.##.####.#....#.#...##..#..
.........#.#.........#.#.....#...#.....#.#...#...#..............
...#..##.#..##.#.##..#.#.#.####.....##.#.#.....##..#.#..#.....#.
.......#.............#...#.#.....#...#.....#.........#..........
.#.##........#.#.#.##....#.....#...#..#....#.######.#..#..####.#
.#...#.....#...#.....#...#.#.#.............#.....#...#...#......
.#..##.......#..##...##....#.#...#..#....#...........###.....#.#
.#...#.....#.#.........#.......#.......#.#.#.#..................
..##.#.#..#..##..#.##......###..###.#..#...#.#.###...#...#####..
...#.....#.....#.#...#.#...#.....#.....#.#.#.......#.#.#........
...#..##.#.....#.#.................##..#...#.#..##...#.#....#.##
...........#...........#.......#.....#...#.....................#
#.###.#.#.#..#####.#........##.##.##.#..##..#####.#.##...#...#.#
