32
.................#..............
.###..#..#.#....#....####.#.....
.#G..................#..........
.###.#.#..##.#######.....##.#...
.....#.#...#.....#.....#.......#
.#.###..#......#....##.....#.#.#
...................#.#..........
.#.#.....#.#..##...#.#..##...#..
.#.......#.........#...#........
.##..#.......#...###...#...#....
.....#.............#.....#.#...#
.#..#..#...#.#.....##...........
...#.........#...#...........#.#
.#...##.####.#.#.#...##..#.....#
...#.#...........#.#.........#..
...#...#.##.#.........#...#..#..
.......#.................#.....#
#####..#.....#.......#...#...#.#
...........#.........#.....#...#
..#..#.####..#.....#.#.#..#....#
.................#.......#.....#
...#.##....#.##..#.#.##..#.#....
...#.#.....#.....#..............
...#.#.##..#.##.....##.#.#.#...#
...#.#.......#.#.......#.......#
...#.#.###...#....#####..##..#.#
.........#.#.#.........#.#......
...###.#.#...#.#.###...#.....#.#
...#...#.#.#.#.......#.....#...#
.#.#.....#....##.#.....##..#.#..
.........#S#...................#
.###.##..##.#....###.###.#####.#
