32
.......#.....#................G#
...#.#.....#.#.#.###.#.#...#.##.
.#.........#.......#.#.....#...#
.#....#....#####.#...#.###.#.#..
...#.....#.......#...#..........
.....#.#...#.....##.##.....##..#
...#.#.....#.................#.#
.....##..#.#...#.....#.#.#.....#
.......................#.#......
.#.#...##...#............#.#...#
...#...#...........#...#........
...#...#..#...#..#.....#..###..#
...........#.....#.......#.....#
.#..#..#...#...#..#..#.#.#....#.
...........#.............#...#..
.#..##.#...#.....#.#.#.#.#...#.#
...............#...........#.#..
.#.##..#..#..###.####.#.#..#...#
.#...........#S#.....#..........
#..#...#.#.....#..#..#..#.#..#..
...#.....#.....#...#.#.#.....#..
..##.....#...#.###...#.#....##..
.........#.....#...#.....#......
.##.##...#....#..#.#...###.#.##.
.............#.........#...#....
...#.......#...........#.#.#.#.#
.....#.......#.................#
...#.................#.#.#.##..#
.#...............#...#.......#..
...#.#.#.##.###...##.....#.#...#
.......#...........#.......#....
.##.#....#..####.#.##.#..####.##
