32
.........#...#.............#...#
.#.#.#.#.#.#.#.#.#####.#...#.###
.#.........#...#.#.....#.#.#....
..#####.########.#.###.#.#.###.#
.............#...#.#...#.....#.#
.###.##..###.#.##..#.###.#.#.#.#
...#...#.#...#.#...#.#...#.#...#
#####..#..#..#.#.###.#.##..###..
.......#...#.#...#.#.#.#...#...#
..##.#.#.#..#...##.#.#.#.###.###
.#.......#.........#...#...#...#
.#####.########.##.#.##.##.###.#
..S........................#...#
.####.##########.#.##..#......##
...............#.#.#...#...#...#
.#.#####.#..##.#...#.###.#.###.#
.......#.#.....#.#...#.......#.#
.##.##.#..####.#.....###.##.##.#
...#...#.#...#.#...#...........#
..##.#.#.#.#.##..#.##..#.##....#
.#...#.#.....#...#...#...#.....#
##.###.##.##.#.#####..####.###.#
...#.........#.....#.#.....#...#
.#######.#.#.###.#.#.#..####.###
.#...#...#.....#.#...#.#.....#..
.#.#.#.#.#.###.#.#..##.#..####.#
...#.#.#...#...#.#.#...#.......#
.##.....####...#.#.#.##.#.#..#.#
...#.#........................G#
.#.#.#.####.#...####...#.#####.#
...#...................#.......#
##.######.####.#################
