64
.........................#...#...................#..............
.###.....#####....###.#..#....##.#.##..#.......#...#..##........
...........................#.......#...#.#...#...#.......#.#....
##....######.#..###....#.#.#####.........#..##...#..##.#.#.##..#
...#...........#.....#........S..#.......#...................#.#
....##...#..#....##..#.#.#........#.##.#.#.#.#.#...##.##...#...#
.#.......#.....#.......#.#.#.......#.......#...#.#.........#...#
...#.#...#.###...#....##.#...####..#.....#...###..#....#...#.#.#
.....#.#.#.................#...#.....#.....#...........#.....#..
##.#.#.#.....#.#.#...#..##.#....###.##.#.###..###....###..##....
.#.#.#...#.#...#.#...............#.......#.........#.....#.....#
.#.#...###.###.#.#.##.#......#.....#.......#.#.###.#..##...##...
.............#...................#.#.#...#.#....................
...#.....##..#.#...#.###.#.......#.#.#...#.#.##........##.#..#..
...........................#.....#.....#.....................#..
..#...###.#......###.##....#...##...#..#.....#.#.#.#..##.....#.#
.....#.....#.#.......#...#.........#...#.........#.........#...#
.###.#.#..#..............#.#...#.#...#.#.#.........#.##...##.#..
.......#.....#.#.................#.#.........#.....#...#.....#.#
.......#....#.....##..#...#..##..#.##.#.##.........###.###..##..
.....#.#...#...#...................#.....#.#....................
...........#.#...#..#.#..##....###.#.#.#.#...#.....#.##...###..#
.............#.............#...................#.....#.......#..
.#.###.##..#....####......##.....##.....#..#####.#.#...#...#.##.
...........#.#.....#.....#.....#.................#.#.#.#...#....
#..#....#.#..........#..##.##....#.#...#..#...####.###.#.#.....#
...#.................#...#.#...#.........#.............#.#......
...#..#.....#..#.#..#.#..#.#.#######.#.###.#.#.#.#...##..#.#.#.#
.......#.......#.#.........#.#...#.........#...#.#...........#..
##.#.#.##.#...#........##.#..###.#.....#.###.........##..#......
.#.#.#...#...............#.......#.............#.....#.........#
.#...#...#.##..##..###.#...###.....#.##.#..#.#..#..#....###.....
...#.......#...................#.#.......#.#.#.......#.......#.#
..#..#.##..###..#####..###.##....#.#.##..#.#.##.##.#.#.#...#...#
...............#...#...#.#.....#...........................#...#
.#.#.#.#...#.#.#...#...........#...#...#.####......#..#..#.#.#..
.#.....#...#.#...#.................................#...........#
...#.#..#..#...#..#..#.#.#...###.....#.#.##....#.#...#....##.#.#
.....#.......................#...#...#.....#...#.............#.#
#####..#.##.##.......##...##.....#...###.#..#.#....###.#...#....
...........#.#...#.#.....#.....#.......#.#......................
...#.###.....##..#.###...#.###.#.#.#.........##..#.#.##....#.#.#
...........#.....#.#...#.#.........#.....#.#.....#.....#...#.#.#
##.#.#....#..##..........#...##..#.##.##...###...#.#...#.#.....#
.............#.#...........#.............#...#.#.#...#.....#....
.......#....#..#.#.....#.####.##..#.#.#..#...#.....#.....###...#
.....#...#.....#.#...........#.....................#.......#....
...#.###.......#...#.##..#.....##.#....#.##..#.#..#.....#....#..
.#.#.........#.#.#.....#...#...#...........#...............#....
....#....#.......#...#...#...#.#.#.#.#.#.#...#.#.#.....###..##.#
.#...#...#...................#.................................#
.#.#.#.#.........#.###.##...##.#.....#....#..#####..............
...#...#.....#...#.......#.......#.#.................#...#...#.#
.....#....##.#.#...#.#.#.#...#....#....#.###.#.#...##..#...#...#
...........#.........#.........#.............#...#.....#...#....
.#.#.##.#..#.##..#.##.##.####..#.##..##.#.##.#.#.#..###.####.#.#
...............#.#...........................#.....#............
.......#.#.###.#.#..#...#.....#.##.#.#..#..#..#..#.#...##.##...#
.#.#.#...#.....#.......#...#.......#.......#...............#.#.#
...#...#....##.####..##...#.#.........##.#...#.#..######.....#.#
...#............................................................
...#..#####....#...#.#.#.#...#.#.#.#..#.##...#.#.....#.#.....#.#
.....#.................#.............#...............#....G.....
.#.#.##.#.#.####...##..##.#...#...#....##.##.###.#####..##..##..
