32
.................#...#.........#
......###.#....#...##...#..#.#..
.......#...........#.......#...#
.##........#...#.#.#..#.#..#.##.
.......#.#...#.............#...#
....##....#.####.#...#...#.#.#..
.......#.#...................#..
.##.###..#.#.#...##.#.##.......#
.......#.#.................#....
##..##...##..#...#....##...#...#
...#.....#.#...#S..#.......#....
.#.#..#....#.#.....#.##.#.......
.......#.......#.............#.#
.#.###.#.#..#..#...#.#...#.##...
.......#...........#...#.......#
....##.#######.##...#..##.#.#..#
.......#.....#...#...#.#.......#
...##.....#..#.##..#.#.#.###..#.
.......#.............#.....#....
##.......#...#.#..##.#..#.......
...............................#
#....#####..##..#...#..##..#...#
.....#.....#...#.......#.......#
...#.#.....###.....#.###.#####.#
.......#.......#.#.......#.....#
.##....###.......#.#..##...#..##
.#...#.#.#...#...#.#...#...#....
...#..........####.###..#.#....#
.......#.............#..........
.#.#.#####.#.##...#...####.#.#..
G#..............................
.#.##.##.##..###.#..#.#.....#..#
