32
.......#.............#.........#
.#....#...#..###.##........#....
....G#.....................#....
...###.###.#.#.####.....#..#....
.........#.#.#.............#...#
...#.#.#.#.#.##..#.###.#.#.###..
...........#.#...#.#.........#.#
..#..####....#.....#...##...#...
...................#.#..........
.##..#.#..##.#.#.#.........#.#.#
...#.........#...#.......#.....#
.#.#....#....#..##..####....##.#
...#...........................#
.....#....######.......#.#.#.#..
.............#.........#........
.....###.###.#.#.###.######....#
...........#...#.#...#..........
.#.#..#....##......#.......#.#..
...............#.......#........
.#.###.#.#.#.###.###.#...#.###..
.......#.....#.......#.....#...#
.###......##.#..##..##..##.#.#.#
...........#...........#........
.#.###.....#...#....#.##..##.#..
.#.....#.....#.#.........#.....#
...###...#...#...#.##.##.#.##...
.#.........#...#...#.......#....
..#.#.##....##.#.#......#.##..##
.......#...#.....#.........#...#
........##.#..#......#...#..#...
.....#..............S....#.....#
##...###.#.#.##.#####..#..#..###
