32
.........#...........#.........#
.#.##......#.##..#.#...#...#....
.#.#...#.....#...............#..
.....##....#.....#...##..#..#...
.#...#.#...#.#...#.#...#.....#..
.......#.#.#...#...#.#.#.......#
........G..................#...#
.###....##..#####..#..#..#.#....
.............#.........#.......#
.....#.#.##....#.##.#..#...#.#.#
...........#.#.#................
.##..#...#.#.#.#.#.###...##.#..#
...............#.....#.........#
...#.....#.................##...
.......#.....#.#.........#...#..
.#...#..#....#...####...........
.....#...#...........#.......#.#
##.#.##....#....#.##.........#..
...#...#........................
...#.#..####...##....###....#.#.
.#...#...#...#.......#..........
.#.#...#.#...#..##...#.......#..
.#.....#...#...............#...#
.#.##..#.#...#.#...#.#..........
.......#...#.....#.....#.......#
.#...#..####....#..####..#..#...
...#.#.......#.............#.#..
.#.#...#.#....#####...##.#.....#
.#.............#...........#....
..##..##.#.#.#........##......#.
......................S....#...#
..#...##.#.#.#.#.#.###....##.###
