64
.............#...................................#...#.....#...#
.#.........#.....#...#....#....#.#....##.#.#####.#.#.#.#.#......
.......#.....#.............#.............#.......#.#.........#..
.##..#.....###..#..###.#.#...#...#..#.####...#..#...#.....####..
.................................#..G........#.......#...#.....#
.#.##.#.#..#.....#.###.#.#####.#.#..##..#..##.#...#.....#......#
.#.....................#.........#.......#.............#........
.#.#####...#.....#.###.....#.#...#.......###...#.#...#.#...#...#
.#...........#.#...................#...#.....#.#...#.#...#......
.#.###.......#..#..#.#.#.#.#.#.###.#.#..........#..#.##..#.###..
.......#.....#.......................#.........................#
.......#.#.#..##.....#.....#.####...#.#.#..#.#.....#.#.###...#.#
.......#.........#...#...#...........#.......#...#.............#
.......###.#...#...#.#.....##..#...##..#.....#..#........##..###
...#.....#.........#.....#.......#.......#.........#............
#..#......#...##.######....#.#..#..##........#...###...#.##.##..
...#.......#...........#.....#...#.#...#.......#.......#.#.#...#
.#####.#.....#...#.#.#.#.#.#...#...#.#.#.........#.....#.....##.
.........#...........#.#.......#...........#.......#.........#.#
....#.##.##.#..###.....##......#.#.#...#......##...###.###.#.#..
...#.........#.....#.......#...#.........#.....................#
......##.###.#.#.....#.#.#...#...#.#.#.##..#...#..#####.........
.........#.....#...#.........#...#.......................#......
.#.#........##.#.#####.#####...##..#........##......#...###..###
.#.........#.........#.....#.....#.#.......................#....
...###.#...#..##..#...........##.#.##.#.##.#.#.##.##..##.#.#....
...........#.............#...#...#.....#.......#...#.......#....
.#.#.##..#####.#.#.#.##.#..#.#.#.#.#..#..........#.#.#....##...#
.........#...#.....#.....#.#...#.#...#...........#.......#.....#
...###.#.#....###..#.#...#.##....#.#.........#..####.#.#....###.
.......#...#.......#.#.#.#.#...#.....#.....#.#.......#.#........
.....###.###...........#.#.#..##.#.......#...##....#.#.#...#...#
.#...#.......#.........#.....#.....#...#.......#.....#.#.#.....#
...#...##.#.#....#......###.##.#..##.......###..##.#...#....##.#
...........#...#...........................#.#...#...#.......#..
.##...#.##.#.##...#.#..#..#..##.#.##.#.#.##......#..##..##...#.#
.....#.#...#.....#.............................#.#.............#
#.##.#...###.....#.#.....##.#..#...#....###..#...#.#...#....#...
.....#.#.....#.........#...#...............#.....#.#.#...#...#..
..#.##.#.......####....#.....#.#.#.#..#..#.###..#......#.##....#
.#.......#.......................#.....#...........#.......#....
.#.###...#.......##..#.##.#....#.#..##.....#..#.##...#..#....#.#
.......#...........................#.............#..............
...#.#...#...#.#.#.##.##.......#....#..#.#.#......######.#.##...
.#.#.....#.............#.....#.#.......#...#...........#...#...#
.#.#.#..#..#.....#.#.#.#..#..#....##.#.#.#..#....#.#...#.#.#.#..
.........#.#...#.........#.....#.....#.#.......#...#.......#....
.##...##...###.##..#...#....##..#....#....#.#....#......#....#.#
.......#.....#.....#.....#.........#.........................#.#
#..#.##...#.....##....#.#.#..#...#.#..#......#.#...#.#...#.#...#
...#.........#.....#.......#.....#.#.....#.#.#.#.....#...#...#..
.#..###....###.##..##......#.###.......#.#...#.#.#.##..#..#.#...
...#.....#.............#.#...................#.................#
..#...##.#..##.#.#.#.#.....#...##.##.###........###....#....#.##
.#...#...#.#.........#.#.......#...................#...#.#......
...#.#.###.#.##...#.#..###...##..#.......###.#.##..#...#.#.###..
...#...#...#...#..S#.....#...........#.....#...#...#.......#...#
#.#......#.#.#...#.#.#...#.#.#.##.....##.#.#.#...###.#.#.......#
.....#.......#.....#.............#.#...............#.....#.....#
.#.#.#.##..#.......#.#.###..#.##.#.#####.#.#####.#.#.#..#....#..
.#...............#.#...#...#.....#.........#.....#.#...........#
.##.##...#...###........#.#..#...#....#....#...#....###......#.#
...................#.........................#...#.........#....
...####..#.##...###..#.##.#....##.##..#...#.#....#..#.#.####.#.#
