64
...................................#.............#.............#
..####.#.###.#.#.##.#.##..#....###.#..####..######.#.#.#.#.#####
.#.#...#...#.#...#...#.......#.#.....#.............#............
...#.#.###.#.####..#.#.###.##..#.###.#....#..#.###....##.#.###.#
.#...#.....#.....#...#.#.......#...#.......#.#...#.#...#.......#
.#.#.#....#.####.#...#.#.###.#...#.#...#.#.##..#..####.####.#..#
...#...#.#.....#...#.#.......#.....#.#.........#.....#..........
.###...#.#.##...#.....###..#.##..#.#.#.#..########.#.#.#.#.#....
.#...#...#...#.............#...#...#.#.#.........#...#..........
.#.###..##.....#.#.##..#.#.#.#.#####.#.###.###..##.#.##...####.#
.#...#.....#...#.....#...#...................#.........#.......#
###..#.#.#...#.#####..##...###.#.#.#.###..##..#.#.##.#.#.###...#
.....#...#...#.#...#.........#.........#.#.......#...#.#...#.#.#
.#.##..#..###..###.###.#.###.##..#...#...#.###.#.#.#...#.#...#.#
.......#.........#.........#.....#.#...........#...#...#.#...#.#
.#.#.#.########..#.#.###.#..##.##..#.#.##.#.##.#.#.#.##..#.###..
.#...#...........#.#...#.#...........#...........#...#...#.#...#
.#.#.#.#######.###.##..#.#.#.#........######.#.#.##..#.##..###..
.#.#...........#.........#...#...#...#...............#.........#
##.##..#.#..##....##.#.#.#########...#.#.#.###.#.#...#######.#..
.........#.#...#.#...............#.....#.........#...........#..
.#.#.#####.#...#.##..###....##.#.#.#...#.#.###..#.######....##.#
.#.........#.#.#...........#...#...#.....#.#...#...#............
.###.#####.#.#.###..##.####..###...#..#.##...#.#.....#.#.#.#.###
...#.........#...#.#.........#...#...........#...#.#.......#...#
...#...##.##.#.###...####......#.#.###.#####..#.##.###.#.#.###.#
.#...#.......#.....#.....#.#.......#.......#...................#
..####...##..#.####...##.#.#..##.#..#....#......#####.#..##..#..
.#...#.....#.#.#...#.....#.#...#.#.......#.#.#.............#.#.#
...#..###....#.#..#..#.###..#..#####.#.##.....##.#.#.#.##..###..
...#...........#.#...#.......#.#...#.....#.........#.#...#...#.#
##.#.#.##.#####..#.#.#.#.###.#.#.#.#...#.#...#.#.#...#.#...#.#..
.....#.....#.....#.....#.........#.......#.....#.#.#.#.....#.#..
.#..##.#.#.#.#.##....#.#.#.#.#.#.#######...#.###.#.#...##.##.#.#
...#.........#.........#.#.................#.#.....#..S....#.#.#
##.#....#####.##.#.###.#...#.#.####..###.#.#.#.##.#..####..#.#.#
.#.#...#.......#.....#...#.....#.........#.#...#...........#...#
.#.#####.#####..#.#####..####..#...#####.##..###.#...#.###.#.#.#
.......#.#...#...#.........#...........#...#.........#.....#...#
.#####...#.#..##.#.#.#.#.#.#.#...##..#.#...###..####.###.#...#.#
.....#...#.........#.......#.#...#...#.#.#.........#.#...#...#.#
.###.#########.#.###..##.#####...#..##.....#.#.##..#.#.#.####..#
.#...#...#...#.....#.................#.....#.#.#.......#.....#.#
.#.###.#.#.#.#.#.#..#..#.#########.#...##..#.#.#.##.##...#...#.#
.#.....#...#...............#...............#.#...#.....#.#.#...#
..#####.##...#.#...#.#..##.#.....###.##..#.#.##....#.#..##.#.#.#
.#.......#.....#.#.#.#...#...........#.....#.....#.#.#.....#...#
.#.##.##.#.#.###.#...#.....##..##..#....##.####....#.#.####....#
.......#.....................#.......#.#...#.......#.#.....#.#.#
..##..#..#..###.##..######.#.#.#.....#...#...#######.###.#.#...#
.................#...#.........#.....#...#.............#...#....
..#....##.#....#.#.#...##.#.##...#.#..#..#####.##..##..#.......#
.#.....#...#.#.#.....#.#.....#...#.....#...#.........#.........#
##.#.###.#.#.#.##.##.#.###.#.#.##..#####.###.###.###.#.####..#.#
.........#.....#...#.#...........#...........#.#...#.....#.....#
..##.##.##..####...#.#.#.#...#.##.##.#####.#.#.##....#.#.#.#.#..
.#...#.........#.....#.#.#.....#...#.#.....#.....#.#...#...#...#
.#.##....#.#.#....#..#.#.#.###.#.#...#..####..##.#..##.##..#...#
.#.....#.#.#.....#.#...........#.#.......#...#.#...#.....#...#.#
.###.###.#.#.#.##..#.##.####.#.#..####.#...#.#.##.##.##..#.##..#
....G......#.#.............#.....#.......#...#.......#...#......
.#.#.#.#.#.#.##..#.##...##.#####...###.####..#####.#.#.###...#.#
.....#...........#...............#...#.....................#...#
.######..#.#####.#.###.#.#.##.#.###..#.##.#.#######.#####.######
