64
.......#.........#.....#.......#.#.......#...#...........#.....#
.##.##.#.#######.#..##.#.#####.#.#.####..#.#.#.###.###.#.#.##..#
.........#.......#.#.#...............#...#.#...#.#.....#...#....
.###.####...##.##..#.#####....###.##.#.###.#####.##.##..#.##.###
...#.......#.#...#.....#.....#.....#.#...#.#.........#.#...#...#
.#.#####.###..##.####..#.###.#.###.###.#...#.#.#..####.#.#####.#
...............#.......#..S#.....#...#.#.....#.........#.....#.#
#.##.###...#.#####.#.###.#.###.#.###.#.##.#####.##...###.#.###.#
...#.....#.#.....#.....#.#...#.#.#...#.........#...#...#.#.....#
...#.#.####..#.#.##.##.#.#.#.##..#.##..#...#.#.#.###.#...#.####.
...#...#.....#.#.#.......#...#...#...#.....#.#.......#.#.....#.#
.##.##.###.#.###.#.#.###.#.###.##.#..#.#.###...#####....####.#.#
.....#.....#.......#.#...#.#...#.#...#.#.#.#.......#.#.#.....#.#
#..##.#######....###.#...#.#.###.#...#.#.#.#.###.#.#.#.#.#####.#
...#.....#...#.#...#.#.....#.....#...#.....#.....#.#...........#
..##...#.#.#.#.###.#.##.#..#.#.#####.##..#.###.##..#.###...#...#
...#...#.....#.......#.......................#.#...#.....#...#.#
.#.#...##.##..######.#.###.##..####.##.#####.###.###.#######...#
...#.#...#...........#...#...........#.....#...#...#.#..........
.#.#.###.#.#.##.##.#.#.#.###.#######.#.####.##.##..#.#..#..###.#
.....#...#...#...#...#.#...........#.#.......#.....#.#...#...#.#
.#.#.#..##.###...#.###.#.#####..####.#.###.#########...#####....
.....#...#.....#...#.....#...........#...#.....#...#.........#..
###..##..#..#..###.#..#.##.#####.##.#..###.#.#.#.#.#####.#.#.#..
...#...#.#.#...#...#.#.#...#.....#.........#.....#...#.......#.#
.#..##...#.#.###.##..#...#.#.##.#...##.##..#.####..#....##.###..
.#...#.#.#...#.....#...#.#.....#.....#.#.#...#...#.#...#.#...#.#
...#.#.#.##..#.###.###.#..#.#..#..####.#.####..##....##..##.....
...#...#.#.......#...#.#.#...#.#.#.#...................#...#....
.#.#.###.#.###.#.##....#.#...#.#...#.##.##.#.#.#..####.###.#####
.#.......#.........#.#.#...#.#...#.#.....#.#...................#
.##..#####.#..####.#.#.#####.#.###.#####.###..####.#.##..#.#.#.#
.....#.....#.....#.#.....#...#.#.......#...#.....#.#.....#.#...#
.##..#.##..#..##.##..#####.###.#####.#####.#####.#.######...##.#
.......#.#.....#...#.#.......#...............#...#.#...#.....#.#
#..#####.#...#.###.###.###.#.####..##....###.#.#...#.#.#.#####.#
...#...#.#.#...#.......#...............#...#...#...#.#.#.#...#..
.###.#.#.....#.##.#####..##..#...###.#.#.##.#..#.#.#.###.#...#.#
.....#.#...#...........#.#.#.#.#.#...#...#.....#.#.#.....#.#.#.#
.###.#..######.####..#...#.#.#.#.#.####..#.#####.#.#######...#..
.....#.......#...#.......#.#.....#.....#...#.....#.#............
#####.##.#.#.#####..####.#.####.####.#.#.#.###..##.#.####.###..#
...........#.......#...#.#.............#.......#.....#.#........
.####.##..##..##.###...#.#########.#.#.###.#.###.###.#...#######
.#...#...#...#.........#...#.....#...#.#...#.....#...#.#.#...#.#
.#.#.#.#...#.#.##...######.#.#.#.#.#.#.#...#.#.###.##..#.#.#....
...#.#.#.#.#...#.#.........#.....#.#.#.#.#.#.#.#.........#.#....
###....##..#.#...##.#####.##.#.###.#.#.#.###.#.####..###...#.#.#
...#.#...#.#...#.......#.....#.#.#.#.#.......#.....#...#...#.#.#
#....###.#..###..##.#..#.#.#...#...#..####.#..#.##.###.####..#..
.....#.#.........#.....#...#...#...#.#.....#.#...#...#...#...#.#
.#.#...#...#...#.#.#.###.###.#.###.#.#.##.##.#.#.##..#.#.###...#
.........#.#...#...#.#.......#...#.#.......#...#.....#.#...#....
.#..####.#...#.#.###.#.#...###.#.###.#####.##..#####.#.##..###.#
.#.#...#.#.#.#.#...#.#.#...#.....#.......#...#.#.....#...#.#G#.#
...###.#...#.#.###.#.#.##.##.#####.#####.#.#.##...#####.#....#.#
.#...........#...#.#...#.....#.............#.#...#.........#....
.#.#.###.##.##.#.#.#####.#.#.#.#...#.#.##....#..####.###.#.#.#.#
.#.#.........#.#.#.......#.......#.#.....#...#.......#.#...#...#
.#.#.#...##..#.#.#.#..##.##..#.##..##.##.#.###.######....#.###.#
.#.#.#...#.....#.#...#...#...#.....#.....#.............#.......#
...#...###.#.#.#.#.#######.#.#.#..#....####..###.#####.#####.###
.....#...........#.........#...#...........#.........#.........#
##.##.#######..###############.#########################.###..##
