32
....G........#..................
...##..#...........####.........
.#.....#.........#.........#.#.#
.#...#....##..#..#..##...##....#
.......#...#.#.....#...#.......#
.#.#..####.............###.###.#
.............#.......#..........
.#.#...#...#.....#.....#.###...#
.............#.#................
.....#..#.#..#.#...#...#...#...#
.....#...#.........#...#.#......
.###.#..#..##..#...#.#.#.#.###..
.....#...............#.......#..
.#.#.###..##....#......####.....
.#.#.......#.#...........#.....#
.#....#......#.##....###.#......
.........#.#.#.....#............
.##....#...#.#.........#.#####.#
.#.......#.......#.#.#.......#..
.#.#....#.#..#...###.#..#....#.#
...............#...#...#.......#
...#..###......#.#.###.....##.#.
.....#.....#...#.......#........
.#.....#...#.##..##..#...#...#..
...#...#.........#.......#.....#
....#........#.##.#.#..#...#....
...........#...............#.#..
.##.##..###..###.#..##.#.....#..
.#...........#...#.#............
...##..#.......#.#...#...###..##
...#...#..S#...................#
...#####.##...#..#..#..#.###.###
