64
.......#...#.......#.........#G..#.........#...................#
.....#.#.#.#.#####.#.###.#.###...#.#.#..##.######..#.#...#####.#
.#.#.....#.#.....#.....#...#...#...#.#...#...#.....#.....#.....#
.#.###..##.#..##.#.##.##.#.#..######.#.#.###.#.#####.#.####..##.
.#...#.........#.#.....#.#.......#.........#...#...#.#.....#....
###..##########....###.#.#.####..###.#..##.##..#.#.#.#.###.#####
...........#.....#...#...#...........#.....#.....#.#.#...#.....#
.##.#..##..#.###.###.#.######...##.##..#.#.#.#####.#.#.#.#####.#
.......#.#...#.....#.#.#...........#.......#...#...#...#.......#
.#######.####....#.#...#.#########.#.###...#.#.#####..##.###.#.#
.#.............#.#.#...............#.......#.#.......#...#...#.#
.#####.###..####.#..####.#.#.###.#.###.#####.##..#####.#.#.##..#
.....#.#...#.....#.#.......#.....#.............#.......#.#.#...#
.###.#.#.###...#.#.#.#########.#...###.#..##.#.#.#######.#.#.#..
.#.......#...#.#.#.#.........#.#.#.#...#.....#.#...#.........#.#
.#.#...###.#.#.#.#.#.###.###...#.#.#.#..##...#.###.#.#.###.#...#
...#.....#...#.#.#.....#.....#.#...#.#...#.#.#...#.#...#.#...#..
.#######.#.###.#.#.###.###..##.##..#.#.#.#.#.#.....###.#.#.#.#..
.#.......#.#.....#...#...#.#.......#...#...#.#...#.#.......#.#.#
.#..########.##..###.###.#.###.###.#.#..##.#.#.###.#.##.##.#.###
...#.#.......#.#.#.#.#...#...#.#...#.#.#...#.#.#.#.........#...#
####.#...###...#.#.#.#.####..#..#.##.#.#.#.#.#.#...#####.####..#
.......#.#...#...#.#.#.....#.#.........#.#.....#.....#.....#...#
.####..#...#...##..#.#.#.#.#.#...###...#.##.##..###..#.###...#.#
.......#...........#.#...#.......#...#.#...#.........#.#.#.#.#..
##.#.#.#..#####.##.#...###.###....####.###.#.###.####..#.#.#...#
.....#...#...#.....#.#.#.............#...#.#...........#........
.###.#.###.#.##..###.#.#.#.#.#.#.###.###.#.###.#####.#.#.##.##..
.#.....#...#.........#.#...#.#.#...#.....#.......#...#.#.#.....#
.#.###.#.########.########...#..#...######.#.###.#.#.#.#.#.#...#
.#.......#.....#.........#.#.#...#.#.......#...........#.#.#.#..
.....##.##.###...##.##.#.#.#.###..##..####.#.#.#.##.##.#.#.#.#.#
.........#...#.......#.#.#.#.#.......#.#...#.#.#...#.#...#.#...#
...#.#..##...##.####.#.#.#.#.##.##.#.#.#.#.#.#.#...#.#.###.#.###
.#.........#.......#.#.#.#.#.#...#...#.#.....#.#.#...#.....#...#
.###.##.##.#.#..##.#...#.#.#.#.#.#####.###...#.#.#.#.##.##.#....
...#.....#...#.......#.#.#.#...#...........#.#...#.#...#...#.#.#
#..##.##..##...#.#.###.#.#.#######.#......####..##.#.#.#.#####.#
.......#.....#.....#...#.#...........#.#.........#.#.#.#........
.###.#...#.#.#.#.#.#.#.#.#.#...###.###.#########.#.###.##....#.#
.....#.....#...#...#.#.......#.....#.............#...#.......#.#
##...#####..######.#.#.#.###.#####....###..###.....#.#.#..####.#
...#.....#.#.....#...#.#.......#...#.......#...#.....#.......#..
.#.#####.#.#.###.#.###...##..#.#.#....##.######.#..###.#.#.#.#.#
S#.....#.....................#.#.......#...#.........#.#.#......
##.###..######.##.....##.###.#.##..#...###.#.#.##.##.#.###..##.#
...#.#.............#.#...#...#.#.....#...#...#.#...#.#...#......
.###..#.#..#.####....#.###.###...#.#.##.....##.#.#.#.###.#####.#
.#.......#.#.#.....#...#.......#.#.....#.....#...#.....#.......#
.###.#.##..###.##.######..####.#..##.#...###..#..###.#.#.#.###.#
.......#...#...#...#.....#...#.#...#.#.#...#...#...#.#.#...#...#
#..#.##..#.#.##.##...##..#...#.#.#.###.###.#.#.####..#..####.##.
.........#.#.#.....#...#.....#...#.#...#...#.....#...#.....#...#
.#####..####...#####.#...###.#####...##..#.#.##..#.#.####.####.#
...#...#.....#.........#.#.....#.....#.......#.....#.........#.#
......##.#.#..##.###...#.#####.###.#.#.#.#.#.....##.##.###.#.#.#
.#.#.#...#.....#.#.#.......#.....#...#...#.#.....#.....#.......#
...###.#####.#.#.#..##..##.#####.##.####.#.#..##.#.#.#...##.#.#.
.#...#.......#.#.........#.....#.......#...........#.#.#.......#
.###.#..##.###..######.#.#.#.#.#####.#.#.#.#.#.#####.#.###.#.#.#
.#.#.....#...#...#.....#.#...#.#...#.......#...#...#...#.....#.#
.#.###.#.#.#.###.#.#####.###.#.#.#.#.###.#...#..##.#####.##..#.#
.......#...#.......#.............#.......#...#...........#.....#
##########.###.####.##..###.#####.#####.#.#####.###..####.####.#
