32
.....#...............#..........
##...#..#...#.....#....#.#..#..#
...........#.#...........#.....#
....##.##..#.#...#...###.#.###.#
.................#.........#....
..#....#.#.#..##.#....##.....#.#
.#.............................#
...#...###..##.###.#.#...###...#
...#...#...........#...........#
.#.#.#.#...#..####...#.#.....#..
...#.....#.....#...#......S.....
.....#...#.....###.#.#.#.#.#....
.............#.....#............
......##...#.....###.#..#......#
.....#.........#.#...#.....#...#
...#.#.#.#####.#.#.#...#.#.###..
...............#.#.#.....#......
.#.#..#..#.#..#..#.#.#...#...#..
.#...........#...#.......#......
.......###...#.#.#..#.##.#.###..
.#.....#.....#...#.....#.#.....#
.#...#.#...#...#.#.###.#.###.#..
.....#.#.......#...#...#.#.....#
...#.....#.#.........##......#.#
.#.#G..#...#...#...#.....#......
.....#.#.#.#.....#.#.#...#.##..#
.........#...............#......
..###..###.#.......#.###.###....
.......................#.....#..
...####..###...###.#...#.#.#.#.#
...........................#...#
....#..###.##.#####.#####...###.
