16
.........#S....#
..###.##.#####.#
.#...#.#.#...#..
...#.#...###.#..
...#.#.......#.#
.###.#.##.##.#.#
.#...#.#.......#
##.####..#######
...#...#...#...#
...#.#.###.#.#.#
.#.#.#...#...#.#
.#.#.#.##.##.#.#
..G#.#.......#.#
...#...#.###.#.#
.#...#.....#...#
.###############
