8
........
.#.....#
....S...
...#.#..
...#...#
.#.#.###
G.......
.#.#....
