32
................................
...#.#.#.#.##...####.#..##.#.#.#
.......#.................#.....#
.#.#.#.#.###.#...#...#.#........
...#...#.#...#.#.........#..G..#
...##....#.###.#..#....#...#.#.#
.......#...................#...#
.#.#####.#.#.##.##.###.....#....
.......................#.......#
.#...#.##..#.#.#...#.#.##...#...
.#.............#.#...#.........#
...#.....###.#.........#.##..#.#
...#.......#.#.....#...........#
.#.##..##..#.#..##..#....#.##..#
.#.#.#.......#...#.#...#.......#
...#.....#.#.#...#....##.##..###
...#...#.#.......#.#...#.#......
###..#...#.#.#####.#.###.#..##..
.....#...........#...#.........#
.###.##....##..#.#...#.#.#..#...
...#.....#.#.......#...#.#.#....
.......#####.......###...#.#....
.....#..S#...#...#.#.........#.#
.#.....#.....###.#.#.#.#...#....
.......#.............#.........#
..##...#....#..#.....##..##.....
.....#.......................#.#
.#....####..#..#####.#.#######.#
...#.#...........#.............#
.#.#.#.##...#....###...#....##..
...............#...............#
.#....####....#......#.##..#..##
