16
.....#........G#
.#.#.#.......#.#
.......#.#.#.#.#
.##.##..##......
...........#.#.#
.#.#..###....#..
...#...........#
.#.##........#.#
...#..S#.......#
.#...#.#.#....#.
.....#..........
.....#.....#.#..
.........#.....#
.....#...#.#.#.#
...............#
###.#..##.##...#
