8
........
#.#.....
S.......
.#...#.#
...#...#
.....#..
...#..G.
.#####.#
