32
...............#...#...........#
.#####.................#..##.#.#
.....#.....#.#...#...#.....#...#
..#.....##.....#...###...#.#...#
.#.#...#.........#...#...#.....#
...###.#.##.....#.......####.#..
.#.......................#......
...#.###..#....#...#..##.#...#.#
...........#.....#.#...#...#...#
#.##...#.......#..##.....##....#
.........#...#.#...#.#.......#.#
......#..#....#..#.#.#####.#.#.#
...#...#...#.........#.........#
....##.#..##.#.#.###.#.#.##....#
.....#.......#..S......#.......#
.#.#....##.##....#..##.#...#.#..
.......#.....#.........#........
.##..#.#..##.#.#.#.#.#..#...#..#
...#.......#...#...#.........#..
##.#####.........#...#...#.#.#..
.#.......#.#...#.........#.....#
.#...#.....##......#.......#....
.#.............#.......#........
.#.#.##....##.....##.#.#.#.#.#..
...#.#...#.....#.......#........
...#..#.##.........#.#..........
...........#.....#.....#.....#..
.....###.#....##.#..##...###.#..
................................
.#...#..#..#.......#.##.##...#.#
G....#.............#............
.#....#..####.########......##.#
