16
.....#...#.....#
.#.#.#.#.#.#.#.#
S#...#.#...#...#
...#.#.####..###
.#.#...........#
.###.#####.##..#
.#.....#...#...#
...##...####.#.#
...#.#...#...#..
###..###.#.###.#
...........#G...
.#####.####..#.#
...#...........#
##.#..####.#.#.#
.........#.....#
##.#####..######
