64
...............#...#...........................................#
..####.#.........#....##.##..#.###...#.....##.######.#.#..####..
.....#...#...#...#...#.......#.....#.#.................#........
.###..#.#..#.#.#.#..##.#..#####.##.#.#..##.##......#.#...###..##
.........#.#.........................#...#...#.........#........
.#.#.##....#...##.#.....#......#...#.#...###.##.##.###.#.#..#...
......G......#...#.......#.....#.#.......................#......
...#.###..#.##........##.......#.#.#####.#.#.#.#.#...#.......#.#
...#.......#.#.....#.....#.........#...#.................#...#..
.#..####.....#.##...#..#.....#.##....###.####..###..###..#...#..
...#.....#.#...#.......#.....#.#.#...............#.........#....
...........#.#.....#.#.#...#.#...#.#####.......#.#...###.#.....#
.#...#.....#.....#...#.......#...#.....#.#...#.........#........
.#...#........##...#.#..##....#......#..##.##..#.#.##....#.##.##
.............#...................#...#.....#...........#...#...#
...#.#.#....#..#.##.....#...##.##.##...####......#.#.#...#.#.#..
.....#.............#.#.#.........#...................#..........
...#.#.....#...#.#.#...##..#....##...##.#..#..####...#..#.##.#..
...#.#.....#.......#.#.............#.......#.........#.....#....
###.....#....##.#..##..#.....##..#.#...#..#.###.....#####.##.#..
.........#...............#...........#...........#...........#..
.....##....#.###..........##.#.#..###.##.#.#...#.#...#...###....
.....#...#...#.......#...........#...............#..............
........##.#....#.##..###...####.......#####...#...#...#.....##.
.#.#.#...#...........#...........#.........#.#.#...........#....
.#...#.#.#..##..##.#...#........##.#.....##..#...#.###.#..#..#..
...#.....#.......#.....#.....#.............#.......#...#.#.....#
.#.####.#.#..#...#..#..#...#...#.......#...#.#.###.#.##....#.#.#
.#.......................#...#.....#.....#...#.....#...#.....#..
.......##.###..#.#...##.##..##.###.#.....#######.###.....#.#..##
.#.#...#.....#.................#.......#.............#..........
...###.#.###.#.##.#....#......#...##.#..#..##.#.##.#...###.##..#
.#...#.......#.......................#.#.............#.#.......#
.#.#......##.#####.#...##..##....#.........##.#.##.#.#.#.#...#.#
...#.......#.....#...........#.....#.......#.....#...#.....#...#
#.......#......##..#.#.#......#..#...#.#...#..#..#..##.###.#.#.#
...#.#...#.................#.....#.#.#.#.#.......#.........#.#..
..........####........#.#..#.#.#.#...#.....#...###....###.......
.............#.........................#.....#.................#
....#.#..##....#.#.#.#.####..#..#..#.........#.#.#.##..#.#...#..
.....#.......#.......#...................#.......#.#...#.#.....#
.###.......#.#......#..###.....#.....#####...#...#.#.#...#...#.#
.#.............#...................#.......#...#S..#............
....####...#.#.###.#.##..#.#..###..#.#.....#.#........#......###
...........................#...........#.#.......#.#...........#
.....#.......##....#.##..#.#...#...#.......#.....#.#.#....#..#..
.......#.#...................#.......#...#.....#.......#.#......
..###..#.#...###....##.#..##......#......#.#.#####.###.#.......#
.#...........#...#.#.....#.....#...........#.............#.....#
.#.#.........#......#.##.#.##.##.....#........##.##..#...#.##.#.
.#.#.....#.................#.............#...........#.#.#......
.#...#.#.#....#..#.....#...#.......#...#.#...#.#.#.#..#...###..#
.#...#.........#...........#.#.......#.....#.................#..
.###.#.....#.#.#..##...##..#.#..##.#.#.#.#..#....#..##.#.#.#....
.....#.#.......#...#.......#.................#.#...#...#........
.........##..#.........#####....####.#.#.#.#.###...#..##...###.#
.#...#.....#...#...#.............#.....#...#.........#.........#
..#..#.##.##.###.#######.#...#.#.#.##.#..###...#.###...##..#.#.#
.............................#...............#...#...#...#.....#
...#.#.#####.#.#.#.#...#.##..#.#.......#.#.#...#.#...#...##.##.#
.......#.#.........#.#...............#...#.........#...#.......#
.#..........##.....#.##..##.#.#.#....###.#..##..##..####..#.##.#
.....#...................................#.....................#
..##.......#.##.##.##.#.#.######..##..##.#####.#.###....#.#.#..#
