32
.....#.....................#....
.#...##...#..........#...#.#...#
...#.....#.......#.........#.#.#
.#.#.##..#...#...#.#...###.#....
.#.#.............#.............#
.#.#......###.#.....###..#..#..#
.......#.....#.#...........#...#
#...#....#.....#..#.##....##.#..
....G..#.#.#.#.........#.....#..
.#.#..##.#.#.#.#...###...#.###..
.#.....#...........#.......#...#
.....#.......##....#..#.###.....
...#.#...#.....#.............#..
...#......#..###.##..#.#.#.#.#..
.....#...........#.............#
....###.##.#..#.##.#.#.##......#
.....................#...#...#..
.#..##.#.......#.#.#.#.#....##..
.......#...#...........#........
.##..#.#.......##.#......#.....#
...............#...#.....#.....#
..#..##..#...#...#..###....#...#
.....#.............#..S..#...#.#
..##...#.#.....##....#.#..#....#
.#.......#...#.#.......#........
..####.....#.#.#.....#..##.....#
.......#.........#...#..........
.#.#.#...#.......##.#..##..##.#.
...#...#.#.....#.....#..........
.#.#.#..##.........#...#....##..
...........#...........#.......#
##..#.#.#..#..##.###.#..#.#...#.
