8
S......#
.#.#...#
.....#G#
####.#..
.....#..
.#.#....
........
#...####
