32
.....#.........#...............#
.....#.#...###.#...#.#.#.#.###.#
...#...#.........#...#.#........
##...#.....#...###.#...#.#......
...#...#.#.....#.....#.#.#......
.......#.##..#.#.....#.....####.
...#...#.....#.#.........#......
.#..##...##..#.#.#...###.......#
...#...................#.......#
.#.....#.#####.....##....#.#...#
...........#.................#..
....#.#..#.#.##.##.#..#....#.#.#
.........#...#..S#.#.#.....#.#..
.#...#.#..#..#.##.......#..#.#.#
.............................#.#
...#.....#.#.#.#.........#...#..
.........#.......#.#............
.###.#.#.#...#.#.#.#...#...#....
.....#...#.#...........#.......#
#....#........#.#.##...#.###.#..
.........#.....#...#...#.......#
.....#.###..#..#.#..##.#.####..#
.#.....#.......#................
.#.###...#.....#...#.#...#.#....
.#.......#...............#.#....
.#.##..##....#.#.##.....##.###.#
...................#.......#....
..###.##.##.#.#..#.#...#...#.#..
.....................#...#......
.##...##..##.#.....#.......#....
...........#...........#...#..G#
..#.#####..#....##..###.#...#...
