8
G....#.#
..##.#..
...#....
.#...#.#
.#.....#
.#.##..#
..S.....
##..#..#
