64
...#...#...#...#.............#...........#S........#...#........
...#.#...#.#.#.#.#..##.....#.#...#.#####.#.##.####...#.#.###.###
.#.......#.....................#...#.....#...#.....#.#.....#....
.#####.###.#####.###.#.###.##..#.#.#.#..#....#..##.#.#.###.#.#.#
...............#.#...#.#.#.....#.#.#.......#.......#.....#.....#
##...#.#..####.#.#.#.#.......#...#.#####.#...#.#..##.#.#...#.#.#
.#...#.........#.#.#.#.#...#.......#.........#...........#...#..
.#####.#...#.#.#...##..##..###########.#..#.....##..##...#.###.#
.#.....#.#.#.#.....#...#...............#.....................#.#
...##.##.###...##..#.###.###.####..#.#.#.#####.#.###.#.##....#.#
.#.#...............#.....#...#.....#.....#.................#...#
.#.#..##.#.#.#..#.#.#.##.#.#.#.#.###.#.##..#.###.########...##.#
...#.......#.......................#.............#...........#.#
.#####...#.##..#.#.##.....#..##.##.#..##.##....#.#...#.....#....
.....#.......#.#...................#.#.......#.........#.......#
.###..##.#.#.#...###.#..#..#.#.#####.#.###.#.....#.##....#..#..#
.........#...#.#.......#.....#.#.........#...#.#.......#.......#
....###..#..#......#.#.#..##.#.#.#.#####.....#.#.###.##..###.#.#
.#.......#.#...#.#.......#...#.....#.....#.#...#.#.....#........
.##..#..##..#......#..#..#.####..#.#.#..##.#..#..#.#.#.##.......
.....#...#...........#...............#.......#.....#...#...#...#
.##.##.#.###.##..#.##..#..###..#..#..#.#.#.#.#.#.#.....#.##..#.#
.......#...#.#...#...#.#.....#.....#.......#.#...#.#.#...#...#.#
.##....#.#...#.###.#...#####.#..#..#.....#...#.....#.#..##.#....
.#.#...#.#.#.#.........#.#.......#...#.......#.......#.#...#...#
...###.#..#..#.##.####.#.#.###.###.###.##.##.#.#.#...#.#.#...#.#
.........#...#.#...............#...........#...#.....#.#.#.#.#.#
.#.###...#.#.#..#####..#.##.##...###.####....#.#####.#...#.##...
.#.....#...#.#.......#.#.#...#...............#.......#...#.....#
...###.#.#..##.#.###.#.#.#.#.#..###..#..#..###.#.#.##.###.##.#.#
.....#.#.#...#.#...#...#.....#.......#.........#.#.#...#...#....
..#....#.....#.#.#.##.##.#...####.##.#.....##..#.##....#.#.###.#
...........#.#.#.........#.............#.#.....#.#...#...#...#..
.#...#..#..#......###.##..######.###.....###.##..#.###.#.###.#.#
.#.#.......#...#.....#...#.....#.#...#.#.......#...............#
....##.#.#.#####.###.#.###.#...#.#.#.#.#.#########.#..##.#.#.##.
.#...#.#.#.......#...#.....#.....#.#.#.#...............#.......#
.#.#..##....#####....####.......##.#...#..####.##...##.###.##..#
.....#...#.......#.#.....#.........#...#...........#...........#
..#.##.###...#.#.#.#...#.#.###.#....#######..####.#..#.#.#...#.#
.#...............#.#...#.#...#.#.............#.......#..........
...#.#...#..##...#...#.#.#.#.####..#.#.#.#..#....#.###..####...#
.#.#.......#.......#...#...#.....#...#...........#...#.#.....#.#
.#...#.#####.###.#.#...##.##.#.#.#.#.#...#.#.#...#........##.#.#
.#.#.#.....#...#.#...#...........#...#...#...#.#.#.#.....#.....#
...#.#.#.....#.#....#..#.......##..#.#.#...###.#.#.#.######..#.#
.....#.#...#.....#.......#.........#.#.#.....#.....#...........#
.#.#.#.#.###.#.#.#.#.###.#.###....###...####...#.#.###.#.#.#.#..
...#.....#.........#.#.....#.#.#...............#...#............
.#...#.##.####...###.#.#.##..#.#.#.#..#..##....#.#.#.##.###..#.#
.#.............#.#...#.....#.#...#.....#...........#.....#.#...#
.#.#.#####.##..###.###...#.#.##.##...#.#..###.##.#...#...#.#.#.#
...#...............#.........#.....#...#..............G....#...#
##.#.##..#.#.##.#......###.#.#..##.....#.#.#.##.##..##.###.#..#.
.......#...#.........#.....#...#.....#.....#.......#...#.......#
.###.###.....###.#.#..######.##...#.##.###.#...#.#.#.#..#.####.#
...........#.........#.....#...#...........#...#.....#.......#..
.#..##.##.####.#.####..##..#...#.#.#.##......#...#####.#.###.#.#
.....#.............#.........#.#.#.#.......#.#.#.#...#.#.#.....#
##.###.#..##.#####.#..#.##.#.#...#.##.###..#.#...#.#.......##...
.......#.............#.....#.#.....#.....#.....#.#.....#.....#.#
.##.#....#####.#.#.###.#.....####..#..##.#.#.###.#.#...#.#.#...#
...............#.......#...............#...........#.....#.....#
#####..####.####.#.#.######.####.#.#.######...#####.####.#######
