8
...#S..#
.#.#.#.#
.#...#.#
.#.##..#
.....#..
####....
..G....#
##.####.
