8
..S....#
..##....
........
.#..#.##
...#...#
.....#.#
....G...
#...#.#.
