32
................................
.##..#...#.#.#....###.##........
..G........#.#.................#
........#....#.#.#.#.#.#.#.#....
.....#...#...#.#................
..####.#...#......#.##.#.#..##..
.........#.......#...#.....#...#
.#...#...#..##.........#.....#.#
.#.......#.....#.....#.......#.#
.#..#.....####.#.#...#....####.#
.#.....#...............#.#...#.#
.#.#.#...#.##....##....#....#..#
.#.#.#.........#...........#...#
.#.#.......#.#.#...###...#.#....
.........................#......
.#.###......#.#.##.#.###...#...#
.........................#...#..
#....#....#..#...#.#...#...#...#
...#.#...#...#.............#....
...#.##..#..######.#....##.#....
.#.#.....#.#.......#.........#.#
.......#.#..#......#...#...#...#
.#..............S....#.#.......#
.#...##....#.#.##.###......#..#.
.........................#.....#
....#.######.#.....###...###...#
.#.............................#
...#...#.....#...###.#..#..#.##.
.....#.................#...#....
##.#.###.#.#.....#.#.##..##....#
...#...........................#
##.#.#.#.#.#....#######.##.#.###
