8
.#.....#
...##..#
.#.#S...
.#..##..
...#....
...#.#.#
G....#..
##.#####
