16
...............#
.#.#...#..#..#..
..S....#.....#.#
.#.#..#....#.#.#
.#.....#...#....
.##..#...#.#.#.#
................
.##...#......#.#
.#.....#...#...#
...##..#.#.#.#.#
.#...........#.#
...#.#.#.#.#....
.#..............
....##.###.....#
...#..........G.
.#.#.#.#.##..#.#
