8
.......#
.####..#
..S....#
..##..#.
.....#.#
...###..
......G#
####..##
