16
...............#
.....#.#...#.#.#
.#.#...#.....#.#
.......#.#.##..#
................
.#.#.#.#.#..###.
S#.....#...#...#
..#......#.###.#
...#.#.........#
#...##.#...#....
.#...#.......#G#
.#.#.##..#.#.#.#
...#.......#.#..
.#.#.#.#.....#..
.#.........#...#
.#.#.####..#..##
