64
...................................#...........#.............#.#
....######.#.#.###.###...#.#.#...#...#.#.###...#.##..#.#.#.#.#.#
.#...#.....#...#...#...#.......#.#...#.....................#...#
.#.#...#.###...#.###.##..##.####.#..##..##.##.#######..#.#####.#
.........#.....#.......#.#...#...........#...................#.#
..##..####.#.....#.###.#.#.......#####.#....####.#.#.##..#..#..#
...#.#.....#...............#...#.....#...#...#...#.......#.#...#
.#..#..#...###.##....#.#.#.#.....#...#...#.###.#.#...#..#..#.###
...............#...#.........#.....#.#.#...#...#.#...#G....#.#.#
...##..#.#.###.#...##..##.##...#.#....##..##.##.##.#..####.#...#
.....#.......#.......#.#.....#.....#...#...#.............#.#...#
.#.#...#.###.#.#.#.#.##..#.#...#.#.#.#.##..#...####..###.#.###.#
.#.#.........#.....#.....#...#.......#.....#...#.......#.......#
##..#.##.#.#...#.#...#.###...##.#..#.########.##.#..####..##.#.#
.......#...#.#.#...#...#...#...........#...........#.........#..
.#.....#..#..#.###.##..#..####.#...##..###..##..#..#.#.#..##.#.#
.#...#...#.......#...#.#.#...#.#...........#...#.#...#...#.....#
.##....###.#.##..###...#.#.#......##.#..##.#.###.#.#.###.#...#.#
.....#.....#...#.#.#.#.#...#...#.#.#...#...#.......#...#.#...#.#
.#.#.#.#####...#.....#.##..#.#.....#.....#.#...#.###.###.....#.#
...#...#.........#.#...#...#.......#...#.#.#.#...#.......#.#...#
...###.#.#####.#...###.#.#.#..###.##...#.#.#.###....#..#.#.###.#
.#.#...#.#...#...#.#...#.....#.......#.#...#...#.#.#...#........
##.#.###.#..####.#.#.###.##.##.#...#.#...#...#...#.#.###...#.##.
...#.....#.......#...#.#.....#.#.........#.....#...#.#.....#.#..
.#####.###.######..#.#.....#.#...#.###.#..#.##...#...#.###...#.#
.........#.#.............#...#.#.#...........#.#.#...#...#.#...#
..###....#.#.#####.#.###.#.#.#...#....##.##..#.#.#.#.#####...#.#
.#.....#...........#.........#.....#.......#.#.#.#.........#...#
.#.###.#########...#.##..##..#...#.#....##.#...#.#.#.###.#.###.#
.....#...........................#...#.......#...........#...#..
.#.#.....#.####.####......#.##.##..###.#######.#.#.#.###...##..#
.#.................#...#.............#.......#.....#...#...#...#
.#.####..##.##.#.#.#####...###.#.#.#...#..##...#..####.#.#....##
.#.....#...#...#.......#.......#.#...#...#.#...#.......#.......#
..#...##.#.#.#...###...###...#.#...#.#####.#####.#.#.....###.#.#
.#.#.#...#...........#...#.#.............#.....#.......#...#....
.#.#.#.#.#.#.......#.###.#.####....##....###...#.##...##.#.#.#.#
.#.#.#.#.......#...#...#.......#.....#.#.......#.........#...#.#
.#.......#####.#.#..#..###.#..#..#...#.##.#.#..#######...###.###
.....#...#...#.#.#.......#...#...#.#...........#...........#...#
####.#.#.#.#.###.#.##.##..##.#.#..##.###.#.###.#.########......#
.........#.#.....#.................#.......#...#.....#.........#
.#.#...#.#..##.#.#.#.#.###.####.#..###.#...#..#..#.#.#.####..#.#
.#.#.....................#.#.....#.......#.............#.#.....#
.###.#.#..##...##.####.#.#.#.#.#.......#.#.#.#.###.###.#.#..#..#
.#...#.#...#.#.....#S#.#.#...#.#.#...#.......#...#...#...#.#.#.#
.#.##..###.#.##.##...##..#.###.#.#.#.#####.#.#.###.#.#####...#.#
.#.#.......#...#...#...#...#.#.#...#.#...#.#.......#.......#.#.#
.#...#....#....#.#..##.#.#.#.#.#####.#.#...#####.###.#.#...#.#..
...#.#...#...#...#...#.....#.#.....#.............#.#.....#...#.#
.#.#...#.####....#####...###...#.#..##.##..##.####.#.###..##.#.#
.#...#.#.......#.......#.#...#...#.....................#.......#
.#.#.#.#.####..######.##.#.#.....####.##..####.###.###.###..###.
.#.........#.#.....#...#.#.#...#.#.......#.....#.....#..........
.###.#####.#.#.###...#.#.###...#.#..###..#...###.###.##...##.#..
.#.#.#.........#...#...#...#.#.#.#.#...#...........#...........#
.#.#.###.#..#.##.##..#.###.#.#.#.#.#.#.#.#.#.#####.#.#.#.###....
...#...#.#.....#.#.........#.#.#.#.....#...#.....#...#.....#...#
.#.#...###.###.#.#...#####.#.#.#.###.#.###.#.###.###.....##.##.#
...#.......#...#.#.#.......#.........#...#...#.#...#.#.#.....#.#
...#.###.#.#.##..#.#####.#.#.#.##..#..##..#.##..##.###.#.###.#.#
...........#.....#.................#.............#.........#...#
#############..#..##.#.######..#..##..#.###.###.###########.####
