32
.#.............#.#...#.....#...#
.#.#######.###.#.#.#.#.#.###.#.#
...#...#...#.#.#...#...#.....#.#
.###.#.#.###.#.#.#############.#
...#.#.#...#...#.#.....#.#.....#
####.#.###.#.###.###.#.#.#.###.#
.....#.....#.#.......#...#...#.#
.###########.#######.#######.###
.#.....#...#.#...#...#.....#...#
.###.###.#.#.#.#.#####.###.###.#
...#.#...#...#.#.......#.#.....#
##.#.#.#######.#########.#####.#
...#.#.#.......#.#...........#.#
.###.#.#.#######.#.#######.###.#
...#...#.#.........#.....#.#..G#
.#.#.###.#.#########.###.#.#.###
.#.#.....#.....#...#.#...#...#.#
##.###########.#.#.#.#.#######.#
...#...#.....#...#.#.#...#.....#
.###.#.#.###.#####.#.###.#.###.#
.....#.#...#.....#.#...#.#...#.#
######.###.#####.#.###.#####.#.#
.....#.#...#...#.#...#.......#.#
.###.#.#.###.#.#####.#.#######.#
...#.#S#.....#.......#.#.#.....#
##.#.###.#############.#.#.###.#
...#.#...#.....#.......#.#.#...#
.###.#.###.###.#.#####.#.#.#.###
.#...#...#...#...#...#...#.#...#
.#######.#########.#.#####.###.#
...................#.......#...#
################################
