32
.#.....................#...#...#
.#.###############.###.#.#.###.#
.#.#.......#...#...#...#.#.....#
.#.#.#####.#.#.#.###.###.#####.#
...#.#...#.#.#...#.......#.....#
.###.#.#.###.#################.#
.#...#.#.....#...............#.#
.#.###.#####.#.#############.###
.#...#...#...#.......#.....#...#
.#.#.###.#.#########.#.#.#.###.#
.#.#.#...#.......#...#.#.#.#...#
.###.#.###########.#####.#.#.###
.....#...#S....#...#...#.#.#.#.#
####.###.#####.#.###.#.#.#.#.#.#
...#...#.....#.#...#.#...#.#...#
.#####.###.#.#.###.#.#####.###.#
.....#.#.#.#.#.....#.#...#.#.#.#
.#.#.#.#.#.#.#######.#.#.#.#.#.#
.#.#.#.#.#.#...#.#.....#.#...#.#
.#.###.#.#.###.#.#.#####.#####.#
.#.......#.#.....#...#...#...#.#
.#########.#.#######.#.###.#.#.#
...#.#.....#.#.......#.#...#...#
##.#.#.#######.#######.#.#######
.#.#.#.........#.....#...#.....#
.#.#.###########.###.#########.#
.#.#.....#.........#.#.......#.#
.#.#.#.#.#########.#.#.###.#.#.#
.#.#.#.#.....#...#.#.#.#...#.#.#
.#.###.#####.#.#.#.#.###.###.#.#
.......#.......#...#.....#....G#
################################
