8
......G#
.#####.#
.....#.#
####.#.#
..S#.#.#
.###.#.#
.....#.#
########
