8
.......#
.###.###
.#...#S#
##.#.#.#
...#.#.#
.#####.#
..G....#
########
