16
.......#.....#.#
.#####.#.#.#.#.#
.....#.#.#.#...#
####.#.#.#.###.#
...#.#...#.#...#
.#.#######.#.###
G#.......#.#...#
.#######.#.###.#
...#...#...#...#
.#.#.#.#####.###
.#.#.#.......#S#
##.###########.#
...#.......#...#
.###.#####.#.###
.........#.....#
################
