32
...#...................#...#...#
.###.#########.#######.#.#.#.###
...#.#.......#.....#.#...#.#...#
.#.#.###.#########.#.#####.#.#.#
.#...#...#...#.....#.....#.#.#.#
.#####.#.#.#.#.#########.#.###.#
.......#.#.#.#.........#.#.....#
####.#####.#.###.#####.#.#####.#
.#...#.....#...#.#...#.#...#...#
.#.###.#######.#.###.#.#.#.#.###
...#.#.#.#.....#...#.#.#G#...#.#
.###.#.#.#.#######.#.#.###.###.#
.#...#.#.#.....#...#.#...#...#.#
.#.#.#.#.#####.###.#.###.###.#.#
...#.#.#.....#...#.....#.#...#.#
######.#.#######.#.#####.###.#.#
.......#.#.......#.#...#...#.#.#
.#######.#.#########.#.###.#.#.#
...#.#...#.#.........#...#.#.#.#
##.#.#.#.#.#.###.#######.#.#.#.#
...#...#...#.#...#.#.....#.#.#.#
.###.#########.###.#.#####.#.#.#
..S#...#.......#.....#.....#...#
######.#####.###.#######.#####.#
.....#.#.....#...#.......#...#.#
.#####.#.#####.#####.#####.#.#.#
.......#.#...#.#...#.......#.#.#
.#######.###.#.#.#.#######.#.#.#
.#.........#...#.#...#...#.#.#.#
.#########.#.###.###.#.#.###.#.#
...........#.....#.....#.....#.#
################################
