8
G......#
.#.#####
.#.#..S#
##.#.###
...#...#
.#####.#
.......#
########
