32
.........#...#...............#.#
.#######.#.###.#########.###.#.#
.#.....#.#.....#.......#...#.#.#
.#.###.#.#####.#.#####.###.#.#.#
.....#.#.....#.#...#.......#...#
.#####.#####.#####.###########.#
.#...#...#.#...#...#...#.....#.#
##.#.###.#.###.#.###.#.#.###.#.#
...#...#.#.#...#...#.#...#...#.#
.#####.#.#.#.#####.#.#####.###.#
...#.#.#.#...#.....#.....#.#.#.#
.#.#.#.#.#.#####.###.#####.#.#.#
.#.#...#.#.#.....#...#.....#.#.#
.#.#.###.#.###.###.###.#####.#.#
.#.#.#...#.#...#.....#...#.....#
.#.#.###.#.#.###.#######.#######
.#.#.#...#.#.....#.......#.....#
##.#.#.###.#######.#######.###.#
...#...#.#.....#...#.....#.#.#.#
.#######.#####.#.#.#.###.#.#.#.#
.#..G#.......#...#.#...#.#.#.#.#
.#.#.#.###.#######.###.#.#.#.#.#
.#.#...#...#.........#.#.....#.#
.#####.#.###.#######.#.#######.#
.....#.#.....#...#...#.....#...#
.###.###.#####.#.###.#####.#.#.#
.#.#...#...#...#...#...#...#.#.#
.#.###.###.#.#####.#####.###.#.#
...#.#.#...#.#...#.....#...#.#.#
##.#.#.#####.#.#.#####.#.###.#.#
.....#.........#.....#...#S..#.#
################################
