32
...#...#.......#.........#.....#
.#.#.#.#.#######.#.#####.###.#.#
.#...#...#...#...#.#...#.....#.#
.#########.#.#.###.###.#######.#
...#.....#.#.#.#.#...#...#.....#
##.#.###.#.#.#.#.###.#.#.#.#####
...#...#.#.#.......#.#.#.#.....#
.#####.#.#.#########.#.#######.#
.....#.#.......#.....#.........#
.###.#.#########.#####.#########
.#.#...#.......#...#.#...#.....#
.#.#####.#####.###.#.###.#.###.#
.#.#.....#...#.....#...#.#.#...#
.#.#.#####.#.#######.###.###.#.#
...#.#.....#.........#...#...#.#
.###.#.#######.#####.#.###.###.#
.#...#.....#S#...#.#...#...#.#.#
##.###.#####.###.#.#######.#.#.#
...#.#.#.....#...#.......#.#.#.#
.###.#.#.#####.#####.###.#.#.#.#
...#...#...#.#.#.....#.#...#...#
##.###.###.#.#.#.#####.#####.###
.#...#.#...#.#...#...#.....#...#
.###.###.###.#####.#.#.###.###.#
...#.....#.....#...#.#.#...#.#.#
.#########.###.#.###.#.#.###.#.#
...#.........#...#.#...#.....#.#
.#.#.#######.#####.#.#########.#
.#.#.......#.....#...#...#.....#
.#.#######.#####.#####.#.#.#####
.#.............#.......#......G#
################################
