64
.....#.............#...........#...#.........#.....#...#.......#
.###.#.#######.###.#.###.#######.#.#.#.#######.#.#.#.#.#.#####.#
...#.#.#.....#.#...#.#...#...#...#...#.........#.#.#.#...#.#...#
.#.###.#.###.#.#####.#.###.#.#.#############.###.###.#####.#.###
.#.....#...#...#.....#...#.#.#...#.....#...#...#...#.....#.#...#
.#########.###.#.#######.#.#.###.#.#####.#.###.###.#####.#.###.#
.#.......#...#.#.#.....#...#.#...#.....#.#.#.....#.....#.#.#...#
.###.#######.###.#.###.#####.#.#######.#.#.#######.#####.#.#.#.#
...#.#.....#...#...#.#...#.#.#.......#.#.#.......#.#.......#.#.#
##.#.#.###.###.#####.###.#.#.#######.#.#.#######.#.#.#######.###
.#...#...#...#.........#...#...#.#...#.#.......#.#.....#...#...#
.###.###.###.#.#######.###.#.#.#.#.###.#######.#.#####.#.#.#.#.#
.......#...#.#.#.....#...#.#.#.#.#.#.......#...#...#...#.#.#.#.#
.#########.#.###.###.#.###.#.#.#.#.#.#####.#.#####.#####.#.###.#
.#...#...#.#.....#.....#...#.#...#.#.#...#.#...#.#.#.....#.#...#
.###.#.#.#.#############.###.###.#.#.#.#.#.###.#.#.#.#####.#.#.#
.....#.#...#...#...#...#.#...#...#.#...#.#...#.#.....#.#...#.#.#
######.#.###.#.#.#.#.#.#.#.#####.#.#.###.###.#.#######.#.###.###
.....#.#.#...#...#...#...#.....#.#.#...#.#...#.....#...#...#...#
.###.#.###.#######.###########.###.###.#.#########.#.#.###.#.#.#
.#.....#...#.....#.#...#.....#...#.#.#.#.........#.#.#...#.#.#.#
.#######.###.###.#.###.#.#.#.###.#.#.#.#########.#.###.###.###.#
.#...#...#...#.#.#...#...#.#.#.#...#...#.....#...#...#...#.#...#
.#.#.#.###.###.#.###.#.###.#.#.#########.###.#.#####.###.#.#.#.#
...#...#...#...#..S#.#...#.#...........#...#...#...#...#...#.#.#
########.###.#.#####.###.#.###.#######.###.#.###.#.###.#.###.#.#
.........#...#.....#...#.#...#.#...#.......#.#...#...#.#...#.#.#
.#########.#.###.#####.#.###.###.#.#########.#.#####.#.###.#.#.#
...#.....#.#...#.#.....#...#.....#.....#...#.#.#.#...#.#.....#.#
##.#.#.#.#####.#.#.#######.###########.#.#.#.#.#.#.###.#######.#
...#.#.#...#...#.#...#...#.#...#.......#.#.#.#.#.#.....#.....#.#
.#####.###.#.###.###.#.#.#.#.#.#.#########.#.#.#.###.###.###.#.#
.#...#.#...#...#...#...#.#.#.#.#...#.......#.#.#...#.#...#...#.#
.#.#.#.#.#####.#########.#.#.#.###.###.#####.#.#.#.#.#.###.###.#
...#...#.#.....#.....#...#...#...#...#...#...#.#.#.#.#.#.#.#...#
########.#.#.#.#.#.###.#########.###.###.#.###.#.###.#.#.#.#####
...#...#.#.#.#.#.#...#...#...#.#.#.#...#...#...#.....#.#.#.....#
.#.#.#.#.#.#.###.###.###.#.#.#.#.#.###.###.#.#########.#.#####.#
.#.#.#...#.#.#...#.#...#.#.#...#...#.#...#.#...........#.#.....#
.###.#######.#.###.###.#.#.#######.#.###.#.#############.#.###.#
...#.......#.........#...#...#.......#...#...#.....#.....#.#.#.#
.#.#######.#########.#######.#.#######.#####.#.#.#.###.###.#.#.#
.#.......#.......#.#.#.......#.#...#...#...#.#.#.#...#...#.#...#
.#######.#######.#.#.#.#.#####.###.#.#####.#.#.#.###.###.#.#####
...#.........#.#.#.#.#.#...........#...#...#.#.#.#.......#.....#
####.#######.#.#.#.#.#.###############.#.###.#.#.#######.#####.#
.....#.........#.#...#...#...#.........#.....#.#...#...#.#.#...#
.###############.#.###.###.#.#.###.#####.#########.#.#.#.#.#.#.#
.........#.......#...#.#...#...#.#.#...#.....#...#.#.#...#.#.#.#
.#######.#.#########.###.#######.#.#.#.#####.#.#.#.#.#####.#.###
.......#.#...#.....#.....#...#.....#.#.....#...#...#.#.....#...#
######.#.###.#.###.#########.#.#####.#####.#########.###.#####.#
.......#.....#.#.#.....#.....#.#.#...#...#.#.............#...#.#
.#############.#.#####.#.#.###.#.#.###.#.#.#.#########.###.#.#.#
.#.......#.#...#.......#.#.......#...#.#...#.#.....#...#...#...#
.###.###.#.#.#.#####.###########.###.#.#######.###.#####.#####.#
.#...#.....#.#.....#.#.......#.#.#...#...#.....#.#.......#...#.#
.#.#########.#####.#.#.#####.#.#.#.#####.#.#####.#########.#.#.#
.#...............#.#.#.#.....#...#...#.#...#.............#.#...#
.#.###############.#.#.#.#####.#####.#.#####.#####.#######.#####
.#...#...#...#.....#...#...#.....#...#.....#.#...#.......#...#.#
.#####.#.#.#.#.###########.#######.###.###.#.#.#.#######.###.#.#
.......#...#...#...................#.....#.....#G......#.......#
################################################################
