32
...#.............#...#.........#
.#.#.#########.#.#.#.#.#######.#
.#.#.....#.....#...#.#.#.......#
.#.#######.#########.#.#.#####.#
.#.........#.#...#...#.#...#...#
.###########.#.#.#.#######.#####
.#.....#.....#.#...#.....#.....#
.#.###.#####.#.#####.###.#####.#
.#.#.#.#..S#.......#...#...#...#
.#.#.#.#.#########.#.#.###.#.#.#
.#...#.#.....#.....#.#...#...#.#
.#.###.#####.###.#####.#.#####.#
...#.......#...#.....#.#.....#.#
####.#.#######.#####.#.#####.#.#
.....#.#.....#...#...#...#...#.#
.#######.###.###.#.#####.#.###.#
.........#.....#.#.#.....#.#...#
.#########.#####.#.#####.#.###.#
.#...#...#...#...#.....#.#...#.#
.#.###.#.###.#.#######.#.###.###
...#...#.....#.#.....#.#.#.#...#
####.###.#####.#.#####.#.#.###.#
.....#...#.....#.#.....#.#...#.#
.#########.#####.#.#####.#.###.#
.#.......#...#...#...#.....#...#
.#.#####.###.#.#.###.#.#####.#.#
.#.#...#...#.#.#.....#...#...#G#
.#.#.#.###.#.#.#########.#.###.#
.#...#.#.#.#.#.#.....#...#.#.#.#
.#####.#.#.#.#.###.#.#####.#.#.#
.........#...#.....#.......#...#
################################
