16
...#S..#.......#
.#.###.#######.#
.#...#.......#.#
.#.#.#######.#.#
.#.#.......#...#
.#.###########.#
.#.......#.....#
.#######.#.#####
.#.....#.#.....#
.#.#.#.#.#####.#
.#.#.#.#.#.....#
.###.###.#.#####
G....#...#.....#
####.#.#######.#
.....#.........#
################
