8
.#...#.#
.#.#.#.#
.#S#.#.#
.###.#.#
...#.#.#
.#.#.#.#
.#....G#
########
