16
.........#...#.#
.#######.#.#.#.#
.#.....#.#.#...#
.#####.#.#.#####
.#...#.#.#....G#
.#.#.#.#.#####.#
...#.#.........#
.###.#########.#
.#.#...#.....#.#
.#.###.###.#.#.#
.....#...#.#.#.#
####.###.#.#.#.#
...#.#...#.#...#
.#.#.#.###.#####
.#...#S#.......#
################
