32
.....#...#...#.....#.........#.#
.###.#.#.#.#.#.#.#.#.#######.#.#
.#...#.#.#.#...#.#...#.....#..G#
.#####.#.#.#####.###.#.###.###.#
.#...#.#...#.#...#...#.#.#.#...#
.#.#.#.#####.#.#######.#.#.#####
.#.#.........#.#...#...#.#.....#
.#.###########.#.#.#.###.#####.#
...#...#.......#.#...#.......#.#
.###.###.#####.#.#######.#.###.#
.....#...#.....#.......#.#.....#
####.#.#.#############.###.#####
.#...#.#.#.....#.....#...#.#...#
.#.###.###.###.#.###.###.#.#.#.#
...#.#...#...#...#.#.#...#...#.#
.###.###.###.#####.#.#.#######.#
.......#...#S#.....#.#...#.....#
######.###.#######.#.#.#.#.#####
...#...#.#.........#.#.#.#.#...#
.#.#.###.###.#####.#.###.#.#.#.#
.#.#...#...#.#.....#.....#...#.#
.#.###.#.#.#.#####.###########.#
.#...#.#.#.#.....#.........#...#
####.#.###.#####.###########.###
.....#.#...#...#.......#.....#.#
.#####.#.###.#.#######.#.#####.#
.......#.....#...#...#...#.....#
.#######.#####.#.###.#####.#####
.......#...#...#.#...#...#.....#
######.#####.###.#.#.#.#.#####.#
.............#.....#...#.......#
################################
