64
...#.#.........#.........#.......#.............#.......#.....#.#
.#.#.#.###.###.###.#.#####.###.#.#####.###.#.###.#####.#.#.#.#.#
.#...#.#.#.#.......#.#...#.#...#.#...#...#.#.#...#...#.#.#.#...#
.#####.#.#.###########.#.#.#.###.#.#.###.#.###.###.#.#.#.#.###.#
.........#...#.........#...#.#.#.#.#...#.#...#.....#.#...#.#.#.#
########.###.#.#############.#.#.#.###.###.#.###.#########.#.#.#
S......#.#.#...#.........#.#.#.....#.#...#.#.....#.........#...#
######.#.#.#####.#######.#.#.#######.###.#.#######.#########.###
.....#.#.....#.........#...#.......#.#...#.#...#...#.......#.#.#
.#.###.#####.#.#######.#.#####.###.#.#.###.#.###.###.###.#.#.#.#
.#...#.#...#.#.#...#...#.#...#...#.#.#.#.....#...#...#...#.#.#.#
.###.#.#.#.#.###.#.#.###.#.#.#####.#.#.#######.###.###.###.#.#.#
...#.#.#.#.#.#...#...#...#.#...#...#.#.......#...#...#.#.#.#...#
##.#.#.#.###.#.#######.###.###.#.###.#######.###.#####.#.#.###.#
.#.#...#...#.#.#.........#.#.#...#.#.......#...#.....#.#.....#.#
.#.#######.#.#.###########.#.#####.#.###.#####.#####.#.#######.#
...#.....#.....#...........#.......#...#.....#.......#.........#
.###.###.#######.#############.#######.###.###########.#########
.#...#.#.#.....#.#.#...........#.....#.#.#.#...........#.......#
.#.###.#.#.###.#.#.#.#####.#####.#.###.#.#.#.###########.#.###.#
...#...#.#.#.#...#.#.#...#.......#.......#.#.#.......#...#.#...#
####.###.#.#.#####.#.#.#.#################.#.#.###.#.#.###.#####
...#...#...#...#.#...#.#.......#...........#.#.#.#.#.#...#.....#
.#.###.#####.#.#.#.###.#.#####.#.###########.#.#.#.#.###.#####.#
.#.....#.....#...#...#.#...#...#...#.......#.#...#.#...#.....#.#
.#####.###.###.#####.#.###.#.#####.#.#####.#.#####.###.#####.#.#
.#.........#...#...#.#...#.#.#...#.#.....#...#.....#...#...#.#.#
.#############.#.#.#.###.#.#.#.#.#.#####.#####.#####.###.#.###.#
.............#.#.#...#.#.#.#.#.#.#.......#.#...#...#...#.#...#.#
.###########.#.#.#####.#.#.#.#.###########.#.#.#.#####.#.###.#.#
.#.......#...#.#.#.......#.#.#.....#.........#.#.#...#.#.#...#.#
.#.#####.#.###.#.#########.#.###.###.#######.#.#.#.#.#.#.#.###.#
.#.....#...#...#.#.........#...#.......#...#.#.#...#.....#.....#
.#####.#########.#.###########.#.#######.#.###.#########.#####.#
.#.#...#.........#.#.........#.#...#.....#.....#...#...#.#...#.#
.#.#.###.#########.###.#.#####.#####.#####.#####.#.#.#.###.#.#.#
...#.....#.#.......#...#.#...#.....#.#.....#.....#...#...#.#.#.#
##.#######.#.#####.#.#####.#.#####.#.#.#####.###########.#.#.#.#
...#.....#...#.....#.#.....#.......#.#...#...#.........#...#.#.#
.#####.#.#.###.#####.#.#############.#####.#####.#####.#####.#.#
.......#.#...#.....#...#...#.........#...#.....#...#.....#...#.#
########.###.#####.#.#####.#.#######.#.#.#####.###.#.#####.###.#
...#.....#...#.....#.....#...#.....#...#.#.........#...#...#.#.#
##.#.#########.###.#####.###.#.###.#####.#.#############.###.#.#
...#.#.........#...#...#...#.#.#.#.......#.#...#.........#...#.#
.###.#####.#########.#.###.###.#.#######.#.###.#.#########.###.#
.#...#...#.........#.#.#.......#.........#.#...#.#.....#.....#.#
.#.###.#.#.#######.#.#.#.#################.#.#.#.#.###.###.#.#.#
...#...#.#.#.....#.#.#.#.#...................#.#.#...#...#.#...#
.###.###.#.#.###.#.#.#.###.###########.#######.#.###.###.###.###
.....#.#.#.#...#...#.#.....#.........#.#.....#.#...#.#.#...#...#
######.#.#####.#####.#######.#######.###.###.#.###.#.#.###.###.#
.....#.#.....#.......#...#...#...#.#.....#...#.#...#.....#.#...#
.###.#.#####.#.#######.#.#.###.#.#.#######.#####.#.###.###.#.###
.#.#...#.#...#...#.....#.#.#...#.#.#.....#.....#.#...#.#...#.#.#
.#.###.#.#.#####.#.#######.#.#.#.#.#.#.#######.#.#####.#.###.#.#
.#.......#...#.....#.......#.#.#.#.#.#.....#...#.......#.#...#.#
.###.#######.#######.#######.#.#.#.#.###.#.#.#####.#####.#.###.#
...#...#...#.........#.....#.#.#...#.#.#.#.#.....#.#.....#.#...#
.#.#.###.#.###########.###.#.#.###.#.#.#.#######.###.#####.###.#
.#.#.#...#.#.....#..G..#...#.#...#.#...#.......#.....#...#.#...#
.#.###.###.#.###.#.#.#######.###.#####.#######.#######.###.#.#.#
.#.......#.....#...#...........#.............#...............#.#
################################################################
