32
.......#...#.............#.....#
.###.###.#.#.#.#########.###.#.#
.#.#.....#.#.#...#.....#...#.#.#
.#.#######.#.###.#.###.###.###.#
.#.......#.#.#.#.....#.#.......#
.#.#.#####.#.#.#######.#.#######
...#.#.....#.....#S#...#.#.....#
####.#.###.#####.#.#.#####.###.#
.....#.#.#.#.....#.#.......#.#.#
######.#.#.#.#####.#.#######.#.#
.......#...#.#...#.#...#.....#.#
.###########.###.#.###.#.###.#.#
.#.......#.......#.#.....#.#.#.#
.#.#####.#.#######.#######.#.#.#
.#.#...#...#.......#...#.....#.#
.#.#.#.#####.#######.#.#######.#
.#...#.#...#.....#...#.........#
.#####.###.#####.###.###########
.....#.#.....#.#.#...#.........#
.#####.#.###.#.#.#.###.#####.#.#
.#...#...#.#.#.#...#.#...#.#.#.#
.#.#.#####.#.#.#####.###.#.#.###
...#.#.......#.....#.....#.#...#
####.#.#######.###.#####.#.###.#
...#.#.#.....#...#.#...#.....#.#
.#.#.#.#.#.#.###.#.#.#.#######.#
.#...#.#.#.#.#...#...#.#.......#
.#####.#.#.#.#.#######.#.#####.#
.#...#.#.#.#...#...#...#.#...#.#
.#.#.#.###.#####.#.#.###.#.###.#
...#.......#.....#.......#....G#
################################
