16
.............#S#
.#########.#.#.#
.....#...#.#.#.#
####.#.#.#.###.#
...#.#.#.#.....#
.#.#.###.#######
.#.#.......#...#
.#.#######.###.#
.#....G..#...#.#
.#.#########.#.#
.#...#.....#.#.#
.###.#.###.#.#.#
.#.#...#...#.#.#
.#.#####.###.#.#
.......#.......#
################
