16
.......#.......#
####.#.#.#####.#
.....#...#..G#.#
.###########.#.#
.....#.....#.#.#
.###.#.###.#.#.#
...#.#...#.#...#
##.#.#.###.#.###
.#.#...#...#...#
.#.#####.#######
...#...#.......#
.###.#.#######.#
.....#...#...#.#
####.#####.#.#.#
.....#S....#...#
################
