8
G....#.#
.#.#.#.#
.#.#...#
##.###.#
...#.#.#
.###.#.#
..S#...#
########
