8
.....#.#
.###.#.#
.#S..#.#
.#####.#
...#...#
##.#.#.#
.....#G#
########
