32
.#.................#......G....#
.#.#########.#####.#########.#.#
...#.#.......#...#.......#...#.#
.###.#.#######.#########.#.#####
...#.#...#.............#.#.....#
##.#.###.#####.#######.#.#####.#
.#.....#.....#.......#.#.......#
.#####.#####.#.#######.#######.#
.......#.....#.#...........#...#
########.#####.#.###.#####.#.###
.........#...#.#.#...#...#.#...#
.###.#####.#.#.#.#####.#.#####.#
...#.#.....#.#.#.......#.....#.#
.#.###.#####.#.#############.#.#
.#.......#...#.#.....#.......#.#
.#########.#.###.###.#.###.###.#
...#...#...#.#...#...#...#.#...#
##.#.#.#.#.###.#####.###.#.#.###
...#.#...#.#S#.....#...#.#.#...#
####.#####.#.#####.###.#.#####.#
...#.#...#.#.....#...#.#.#...#.#
.#.#.#.###.#####.###.#.#.#.#.#.#
.#.#.#...#.#...#.....#.#...#...#
.#.#.#.#.#.#.#.#######.#.#######
.#...#.#.....#.......#.#.#.....#
.#####.###############.#.###.#.#
...#.....#.....#.....#.#.#...#.#
.#.#####.#.###.#.###.#.#.#.###.#
.#...#...#...#.#...#...#.#.#...#
.###.#######.#.###.#####.#.#.###
...#.........#.....#.......#...#
################################
