64
.....................#...........#...#.........#...#.......#...#
.#############.#.#####.#.#######.#.#.#.###.###.#.#.#.#####.#.#.#
.......#.....#.#.#.....#...#...#...#.#.#...#...#.#...#...#.#.#.#
######.#.###.#.###.#######.#.#.#####.###.###.###.#######.#.###.#
.#.......#.#.#...#.#.#...#...#.#...#.....#...#.....#.....#...#.#
.#.#######.#.###.#.#.#.#.#####.#.#########.###.###.#.#.#.###.#.#
...#.#...#.#.#.#.....#.#.......#.......#...#.....#.#.#.#.#...#.#
.###.#.#.#.#.#.#######.#########.#.#####.###.#####.#.#.###.###.#
.....#.#.#.....#.......#.#...#...#.......#...#.....#.#.#...#...#
####.#.#.#####.#.#######.#.#.#.###########.###.#.#####.#.###.#.#
.....#.#...#...#.#...#...#.#...#.#.........#...#.#...#.#.#...#.#
######.###.#.###.#.#.###.#.#####.#.#########.#####.#.#.#.#.###.#
.......#.#.#...#.#.#...#.#.#...#...........#.#...#.#.#.#.#...#.#
.#######.#.#.###.#.###.#.#.###.#.#########.#.#.#.#.#.#.#.#####.#
.#.....#.#.#.#...#.#.#.#.#...#.....#...#...#...#.#.#.#.........#
.#.###.#.#.###.###.#.#.#.###.#######.#.#########.#.#.#########.#
.#.#.#.#.......#...#.......#.#.......#.....#...#.#.#.......#...#
.#.#.#.#########.#.#######.#.#.###########.#.#.#.#.#######.#####
.....#...#.....#.#.......#.#...#.....#.....#.#.#.#.#.....#.....#
########.#.#.###.#######.#######.###.#.#####.#.#.#.#####.#####.#
...#...#.#.#.#...#.....#.......#...#.#.......#.#.#.#.........#.#
.#.#.#.#.#.#.#.###.###.#####.###.#.#.#########.#.#.#.#######.#.#
.#...#...#.#.#...#...#.#...#.....#.#.....#.....#...#.#.....#.#.#
.#########.#.###.###.#.#.#.#####.#.#####.#.#####.###.#####.#.#.#
.....#.....#.#...#...#...#.....#.#.#.....#...#.#.#...#.....#.#.#
.###.#.#######.###.#####.#####.###.#.#######.#.#.#.###.#####.#.#
.#.#.#.......#...#...#...#...#.....#.#...#...#.....#.......#.#.#
.#.#.#######.###.###.#####.#.#######.###.#.#########.#####.#.#.#
...#.......#.#...#.#.......#...#...#...#.#.......#.#.#...#.#.#.#
####.#####.#.#.###.###########.#.#.###.#.#######.#.#.#.###.#.#.#
..S#.#.#...#...#.....#.......#...#...#...#.#.....#...#...#...#.#
.###.#.#.###.#####.#.###.###.#######.###.#.#.#######.###.#####.#
...#...#.#.#.......#.....#.#.#.....#...#...#.#.....#.....#...#.#
##.#####.#.###############.#.#.###.###.#.###.#.###.#####.#.#.#.#
...#.....#.......#.........#...#.#.#...#.#...#...#.#.......#.#.#
.###.#####.#####.#.#.#####.#####.#.#.#####.###.#.#.#########.#.#
.....#.......#.#...#.#...#...#.....#...#...#...#.#.....#...#.#.#
######.#####.#.#.#####.#.#####.#######.#.#######.#####.#.#.#.#.#
.#...#.....#.#...#.....#.......#.......#.....#...#...#.#.#.#.#.#
.#.#.###.###.#.###.#############.#####.#####.#.###.###.#.###.#.#
...#...#.#...#.#...#.....#.....#...#.......#.#...#.#...#.....#.#
.#####.#.#.#####.###.###.#.#######.#.#####.#.###.#.#.#########.#
.#...#...#.....#.#...#...#...#.....#.#...#.#.....#.#.....#...#.#
.###.#########.#.#.###.###.#.#.###.###.#.#.#######.#####.#.#.#.#
...#...#.....#.#.#...#.#...#.#.#...#...#.#.............#.#.#.#.#
##.#.#.#.#.###.#.#.#.#.#####.#.#####.###.###.###########.#.#.#.#
...#.#...#...#...#.#.#.......#.#...#.#...#...#.........#...#...#
.#########.#.#######.#######.#.#.#.#.#.#.#####.#######.#######.#
.#.......#.#.......#.#.....#.#.#.#.#.#.#.#.....#.#...#.....#...#
.#.#####.#.#.#####.#.#####.#.#.#.#.#.#.###.#####.#.#.#.#####.###
...#.#...#.#.#...#...#.....#.#...#...#.....#...#...#.#.....#...#
####.#.#####.#.#.#####.#####.###############.#.#.###.#####.###.#
.....#.....#.#.#.....#.......#.......#.#.....#.....#.....#.....#
.#########.#.#.###.###.#######.#####.#.#.#########.###.#########
.#.........#.#...#...#.#.......#...#.#...#...#...#.#.#.....#...#
.#.#########.###.###.#.#####.###.#.#.#####.#.#.#.#.#.###.#.#.###
.#...#.......#...#...#.....#...#.#.........#...#.#.#.#...#.#..G#
.###.#.###.###.###.#######.#.#.#################.#.#.#.###.###.#
...#.#...#.#.....#.#.....#.#.#.........#...#.....#...#.#.#.....#
##.#.#####.#.#####.#.###.#.###.#######.#.#.#.#######.#.#.#####.#
...#.#.....#...#...#...#.#...#.#...#...#.#...#.....#.#.#.#...#.#
.###.#.#######.#.#####.#.###.###.#.#.###.#######.#.###.#.#.#.#.#
.......#.......#.......#.........#...#...........#.....#...#...#
################################################################
