16
.#..G..........#
.#.#####.#.#####
...#...#.#.....#
####.#.#.#####.#
...#.#.#.#.#...#
.#.#.#.#.#.#.#.#
.#...#.#...#.#.#
.#####.#####.#.#
...#.........#.#
.#.#####.#####.#
.#...#...#S#.#.#
.###.#####.#.#.#
...#.....#.#...#
##.#####.#.#.###
.......#...#...#
################
