32
.........#...........#...#.....#
.#####.#.#.#######.#.#.#.#.#.###
.#.....#.#.#.....#.#...#.#.#...#
.#.#####.#.#.#.###.#####.###.#.#
.#...#...#...#.#...#...#..G#.#.#
.###.#.#######.#.###.#.###.###.#
.#...#.#.....#.#...#.#...#.....#
##.###.###.#.#.###.###.#######.#
...#...#...#.#.#.#...#.........#
.###.###.###.#.#.###.#.#########
.#.#.....#...#...#.#.#...#.....#
.#.#######.#####.#.#.###.#####.#
.#.............#...#...#.......#
.#.###########.#####.#.#######.#
.#.#.......#...#...#.#.......#.#
.###.#####.#.###.#.#########.#.#
.....#...#.#.....#...........#.#
.#######.#.###################.#
.#.....#.#...#.#...#.......#...#
.#.#.#.#.###.#.#.#.#.#.###.#.###
.#.#.#.#.#...#...#.#.#...#.#...#
.###.#.#.#.###.###.#.###.#.###.#
.#...#...#.#...#...#.#...#...#.#
.#.#####.#.#####.###.#.#######.#
.#.....#.#.#...#.#...#.......#.#
.###.#.###.#.#.#.#.#########.#.#
...#.#...#...#.#.#.....#...#...#
##.#.###.#####.#.#####.###.#####
...#...#.....#.#.#.....#.......#
.#######.###.#.#.#.#####.#####.#
.........#...#S#.........#.....#
################################
