8
G#.....#
.#.###.#
...#.#S#
.###.###
.#.....#
.#####.#
.......#
########
