64
.......#...........#...........#...........#...#...........#...#
##.#.###.#######.#.#########.#.#.###.#####.#.#.#.#.#######.#.#.#
...#.#...#...#...#.......#...#.#...#...#.#.#.#.#.#...#...#.#.#.#
.#####.###.###.#########.#.#######.###.#.#.#.#.#.###.#.#.###.#.#
.#...#...#...#...#.........#.......#.#.#...#.#...#.#...#.....#.#
.#.#.###.###.###.#.#######.#.#######.#.#.###.#####.###########.#
.#.#.....#...#.#.#...#...#.#.....#...#.#.#..G#.#.....#.........#
.#.#######.#.#.#.#####.#.#.#####.#.#.#.###.###.#.###.#.#######.#
.#.#...#...#...#.......#.#.#.....#.#.#.....#.....#...#.#...#...#
.#.#.#.#.#####.#########.#.#.#####.###############.###.###.#.###
...#.#...#.........#...#.#.#.....#...............#.#...#...#...#
.###.#############.#.###.#######.#.#########.###.#.#.###.#####.#
.#.#.....#.....#...#...#.......#.#.#...#...#.#.....#...#.....#.#
.#.#.###.#.###.###.###.#####.###.#.###.#.#.#.#####.###.#.#.###.#
.#.....#...#.#...#...#.....#.....#.....#.#.#...#.#...#.#.#.....#
.#####.#####.###.###.#.###########.#####.#.###.#.###.#.#.#######
...#.#.#.......#...#...#.......#...#.....#...#.#.....#.#.......#
##.#.#.#######.###.#####.###.###.###.#######.#.#######.#######.#
...#...#.........#.........#.......#...#.....#...#.....#...#...#
.#####.#.#####.#####.#########.#######.###.#####.#.#####.#.###.#
.....#.#...#...#...#...#.....#.#.....#...#.......#.......#...#.#
####.#.###.#####.#.#.###.###.###.###.#.#.###################.#.#
.#...#.#...#.....#.#.#...#.......#...#.#.........#...........#.#
.#.###.#.#.#.#####.#.#.###.#######.###.#########.#.###########.#
.#...#...#.#.#...#.#.#...#.#.....#...#.......#...#...#.#.......#
.###.#######.#.#.#.###.#.###.###.###.#######.#.#####.#.#.#####.#
...#.........#.#.#...#.#.#...#.#...#.#...#...#.....#.#...#...#.#
##.###.#######.#####.###.#.###.###.#.#.#.#########.#.###.#.#.###
.....#.#...#.......#.#...#...#...#.#...#.#.......#.#...#.#.#...#
.#####.#.#.###.#.#.#.#.#####.###.#.#####.#.#####.#.###.###.###.#
.......#.#...#.#.#.#.#.....#...#...#...#...#...#.#...#.....#...#
.#######.###.#.#.###.#####.###.#.###.#.#####.###.#.#########.#.#
...#.....#.#.#.#.............#.#.#...#.#.......#.#.........#.#.#
##.#.#####.#.#########.#######.#.###.#.#####.#.#.###.###.###.#.#
...#...#...........#...#.......#...#.#.....#.#.#...#.#...#...#.#
.#####.###########.#####.#########.#.#####.#.#.###.#.#####.###.#
.#...#.#.....#.........#.#.......#.#.#.#...#.#...#.#.#.....#...#
.#.#.#.#.###.#########.#.#.#####.#.#.#.#.###.#.###.#.#.#######.#
.#.#.#...#.#.........#...#.#...#.#...#...#...#.....#.#.......#.#
.###.#####.#######.#.#####.#.#.#######.#########.###.#####.#.###
.............#...#.#.#.....#.#.....#.#.........#.....#...#.#...#
##.###########.#.###.#.###.#.###.#.#.#########.#######.#.#.###.#
...#...#.......#.....#.#.#.....#.#.........#...#...#...#.#...#.#
.###.#.#.#############.#.#######.###.#######.###.#.#.###.###.#.#
...#.#...#.........#.....#...#...#...#...#...#...#.#.#.#.#...#.#
##.#.###.#.#######.#.#####.#.#.###.###.#.#.#####.#.#.#.#.#####.#
...#.#...#.#...#.#.#...#...#.#...#...#.#...#.....#...#.#.....#.#
.###.#.###.#.#.#.#.#####.###.#.#.#####.#####.#########.#####.#.#
.#...#...#.#.#.#.........#...#.#.....#.#.....#.#.............#.#
.#.###.###.#.#.#####.#####.###.#####.#.###.###.#.#############.#
.#...#.#...#.#...#...#...#.#.......#.#.....#...#.....#.........#
####.###.###.###.#####.#.#.#######.#.#######.#.#####.#########.#
.....#...#...#.#.....#.#S#...#.....#.....#...#.....#...#...#...#
.###.#.###.###.#####.#.#####.#.#######.###.###.#######.#.#.#.#.#
...#.#.....#.#.....#...#...#.#.#.....#.#...#...#.....#...#...#.#
.#.#########.#.###.#####.###.#.###.###.#.###.###.###.#########.#
.#...........#.#.#...........#.....#...#.#...#...#.....#...#...#
.#######.#####.#.#################.#.###.#.###.###.###.#.#.#.###
...#...#...#...#...#.............#.#.....#.#.....#...#.#.#...#.#
##.#.#.###.#.###.#.#.#######.#####.#######.#.#######.#.#.#####.#
.#...#.#...#...#.#.#.#.....#.....#.......#...#.......#.#.#...#.#
.#####.#.#####.#.###.#####.#####.#######.#####.#########.#.#.#.#
.......#.......#...............#.............#.............#...#
################################################################
