64
...............#.........#...#.....#...............#.......#...#
.###.#########.#######.#.#.#.#.###.#.###########.#.#.#####.###.#
.#...#.......#.#.....#.#...#.#.#...#.#.........#.#.#...#.#.#...#
.###.#.#####.#.#.###.#.#####.#.#.#####.#######.###.###.#.#.#.#.#
...#.#...#.#.#...#.#.#.#.....#.#.......#.....#.......#S#.#...#.#
.#.#####.#.#.#####.#.#.###.###.#########.#####.#########.#####.#
.#.......#.#...#...#.#...#.....#.#.............#.........#.....#
######.###.###.#.#.#.###.#######.#.#############.#####.###.#####
.....#...#.#...#.#.#...#.#...#.....#...........#.....#...#.....#
.###.###.#.#.###.#.###.#.###.#.#####.#########.#####.###.#####.#
.#.....#...#...#.#...#.#...#...#.#...#.....#.......#.#.#.....#.#
.#####.#######.#.#.###.###.#.###.#.###.###.#.#######.#.###.###.#
.....#.........#.#.........#.....#.....#.#.#...#...#...#.#.....#
####.###.#######.###############.#######.#.###.#.#.###.#.#######
.....#...#...#...#...#.............#.....#...#...#...#.#.#.....#
.#########.#.#####.#.#############.#.###.###.#####.#.#.#.#.#.###
...#.......#.......#.#...........#.#.#.#.....#...#.#.#.#...#...#
##.#.###############.#.#########.###.#.#######.#.#.###.#######.#
...#.#.....#.......#.#...#.....#...#...#...#...#.#...#.....#...#
.###.#####.#.###.#.#.###.#.###.###.###.#.###.###.###.#####.#.###
.....#...#.....#.#.#...#.#...#.#.#...#.#.......#...#...#...#...#
.#####.#.#######.#####.#.###.#.#.###.#.#.#########.###.#.###.#.#
.......#.......#.#.....#.....#.....#.#.#.#...........#.#...#.#.#
##############.#.#.###.###########.#.#.#.#.#########.#.###.###.#
.......#.......#.#...#.....#.......#...#.#.#.........#.....#...#
.###.#.#.#######.###.#####.#.#############.#########.#######.#.#
.#...#.#.#.........#.....#.#.#...#.........#.......#.#.......#.#
.#.#####.#######.#.#####.#.#.#.#.#.#####.#.#.#####.###.#####.#.#
.#.#.....#.......#.#.#...#.#.#.#.#.#...#.#.#.#...#...#.#.....#.#
.#.#.#####.#######.#.#.###.#.###.#.#.#.#.###.#.#####.#.#.#####.#
.#...#...#.....#.#...#...#.#...#...#.#.#.....#.....#...#.#...#.#
.#####.###.###.#.###.###.#####.#.###.###########.#.#####.#.###.#
.#.........#...#...#...#.......#...#.#...........#.....#.#.....#
.#.#########.###.#.###.###########.#.#.#.#######.#######.#.#####
.#.....#...#...#.#...#.#.........#.#...#.#...#.#.#.......#.....#
.#####.#.#####.#####.#.#########.#.#####.#.#.#.#.#.###########.#
...#...#.....#.#.....#.........#.#.....#...#.#.#.#.#...........#
##.#.#####.###.#.#############.#.#####.#####.#.#.#.#.###########
.#.#.#.....#...#.......#...#...#...#...#...#.#.#.#.#.#.........#
.#.#.###.#.#.#####.#.#.#.#.#.#####.#.###.#.#.#.#.#.###.#######.#
.#.#.....#.#.....#.#.#...#.#.#...#.#.#...#.#.#.#.#...........#.#
.#.###.#########.#.#.#####.#.#.#.#.#.###.#.#.#.#.#############.#
...#...#.........#.#....G#.#.#.#.#.......#...#.#.......#...#...#
.#######.#########.#####.#.#.#.#.#############.#.#######.#.#.#.#
.......#.#.......#.#...#.#.#...#.....#.....#.....#.....#.#.#.#.#
######.#.#.#######.###.#.#.#########.#.#####.#####.###.#.#.#.#.#
.....#...#...#...#.....#.#.....#.....#.......#.....#...#.#.#.#.#
.###########.#.#.#####.#.#######.#####.#######.#####.###.#.#.#.#
.............#.#.......#.#.......#.#...#.....#.#.......#.#.#.#.#
.###.#.#####.#.#########.#.#######.#.###.###.#.#######.#.#.#.###
.#...#.#...#.#.#.......#.#.#.#.....#...#.#...#...#...#...#.#...#
.#.#.###.#.###.#.#####.#.#.#.#.###.###.#.###.###.#.#.#####.###.#
.#.#.#...#.#...#...#...#...#...#...#...#...#.#.#...#.#.....#...#
.#.#.#.###.#.###.#.###.#####.###.#.#.#####.#.#.#####.#.#####.###
.#.#.#...#.#.#...#...#.....#.#.#.#.#.......#.....#...#.#...#...#
.#.#####.#.#.#####.#.#####.#.#.#.###.###########.#.###.#.#.#.#.#
.#...#...#.#.....#.#.#.#...#...#.....#.....#.....#.#.#.#.#...#.#
.###.#.###.#####.#.#.#.#.#############.###.#######.#.#.#.#####.#
.#.#...#...#.#...#.#.#.#.#.............#.#.........#.#.#.....#.#
.#.#####.#.#.#.#####.#.#.#.#############.###########.#.#######.#
.#...#.#.#...#.......#.#.#.#.#.....#...#.........#...#...#.....#
.#.#.#.#.#############.#.#.#.#.#.###.#.#.###.#####.#.###.#.###.#
...#...#...................#...#.....#.....#.......#.......#...#
################################################################
