8
.#.....#
.#.###.#
.#..S#.#
.#####.#
.#...#.#
.#.#.#.#
G..#...#
########
