8
G......#
.#####.#
...#...#
.#.#.###
.#.#.#.#
.#.#.#.#
.#S#...#
########
