8
.....#G#
.###.#.#
...#...#
##.###.#
...#...#
.###.###
S#.....#
########
