8
.#....G#
.#.#.#.#
...#.#.#
##.#.#.#
S#.#.#.#
.###.#.#
.....#.#
########
