32
...............#........G......#
.#.#######.#####.#######.#####.#
.#.......#.#.....#.....#.#...#.#
.#######.#.#.#########.#.#.#.#.#
.#.....#.#.#.#.........#.#.#...#
.#.###.#.#.#.#####.#####.#####.#
.#.#.#.#.#.#.#...#.....#.....#.#
.#.#.#.#.#.#.#.#.#####.#####.###
...#.#.#.#.#...#.........#.#...#
####.#.#.#####.#########.#.###.#
.#.....#.....#.#.......#.....#.#
.#.#########.#.#.#####.#####.#.#
.#.#.......#.#.#.#.......#...#.#
.#.#.#.###.#.#.#.#######.#####.#
...#.#.#...#...#.#...#.........#
.#####.#######.#.#.#.###########
.....#...#...#.#...#...#.......#
####.###.#.#.###.#####.#.#####.#
.#.......#.#...#.....#...#...#.#
.#.#######.###.#########.#.#.#.#
.#.#.#.......#.#.......#.#.#...#
.#.#.#.#######.#.#####.#.#.#####
...#.#.#.#..S#...#...#.#.#.....#
.###.#.#.#.#######.#.#.#######.#
.....#.#.#.#.......#...#...#...#
####.#.#.#.###.#########.#.#.#.#
...#.#.#.#.....#.....#...#...#.#
.###.#.#.#########.#.###.#####.#
.....#.#...#...#...#...#...#.#.#
.#####.#.#.#.#.#.#####.###.#.#.#
.....#...#...#...#.........#...#
################################
