16
...#...#...#...#
.###.#.#.#.#.#.#
...#S#...#.#.#.#
.#.#######.###.#
.#.#.....#.....#
##.#.#.#######.#
...#.#.....#...#
.###.#####.#.###
.........#.#...#
.#########.###.#
...#.......#...#
##.#.#.#####.###
...#.#.#...#...#
.###.###.#.###.#
...#.....#G....#
################
