8
.....#S#
##.###.#
G..#...#
.#.#.###
.#.#...#
.#####.#
.......#
########
