32
.#.......#.............#...#...#
.#.#.#####.#######.###.#.#.###.#
...#.......#...#.#.#.....#.....#
.###########.#.#.#.#####.#####.#
.#...#G......#...#.#...#.#...#.#
.#.###.#.#######.#.#.#.###.#.#.#
.#.....#.#.......#...#.....#.#.#
.###.###.#.#################.#.#
...#...#.#...#...........#...#.#
##.#.###.###.#########.###.###.#
...#.#...#.......#...#.#...#.#.#
.###.#.#########.#.#.#.#.###.#.#
.#...#.......#.#.#.#...#...#.#.#
.#######.###.#.#.#.###.###.#.#.#
...#...#.#...#.....#...#.#.#.#.#
##.#.#.#.#.###########.#.#.#.#.#
.#...#.#.#...#.......#...#.#.#.#
.#####.#####.#.#####.#####.#.#.#
.............#.#...........#...#
.#####.#######.#########.###.###
.#...#.#.......#...#...#.#S#.#.#
##.#.#.#.###.###.#.#.#.###.#.#.#
...#.#.#.#...#...#...#.....#...#
.###.###.#.###.###############.#
...#...#.#.#...#.#.........#.#.#
.#.###.#.###.###.#.#.#####.#.#.#
.#...#.#.#...#...#.#...#.....#.#
.###.#.#.#.###.###.###.#.#####.#
.#...#...#.#.#...#...#.#.#...#.#
.#.#######.#.#.#.###.#.###.#.#.#
.#.........#...#.....#.....#...#
################################
