64
...............#.........................#.....#.......#...#...#
##########.###.#.#######.#.#############.#.###.#.#.#####.#.###.#
...........#...#.#.......#.#.....#.#...#.#.#.#.#.#.#.....#.#...#
.###########.#####.#######.#.###.#.#.#.#.#.#.#.###.#.#####.#.###
...........#.#.....#.......#.#.#.#...#.#...#.#.#...#...#.#.#...#
##########.#.###.###.#######.#.#.#.###.#####.#.#.#.###.#.#.###.#
.....#.....#...#.#.#.....#.#.#...#.#.#.....#...#.#.#.#.#.#.....#
.###.#.#######.#.#.#####.#.#.#.###.#.#.#####.###.#.#.#.#.#####.#
...#...#.....#...#.#.......#.#...#...#.....#.#...#...#.#...#...#
.#.#######.#######.#.#######.###.###.#####.#.#.#######.#.#.#.###
.#.....#...#.......#.#...#...#.#.#.#.#...#.#...#...#...#.#.#.#.#
.#####.#.###.###.###.#.#.#.###.#.#.#.###.#.###.#.#.#.###.#.#.#.#
...#...#.....#.#...#.#.#...#.#...#.......#.....#.#...#...#.#...#
##.#.###.#####.###.#.#.#####.#.#########.#######.#####.###.###.#
.#.#.#.......#...#.#.#.#.#.....#...#...#...#...#.#.#...#.#.....#
.#.#.#######.#.#.#.#.#.#.#.#####.#.#.#.###.#.###.#.#.###.#######
...#.#...#.#.#.#.#.#.#.#.#...#...#.#.#...#...#...#.#...#.......#
.###.#.#.#.#.#.#.#.#.#.#.###.###.#.###.#.#.###.###.###.#.#####.#
...#.#.#.#.....#.#...#.#.........#...#.#...#...#.....#.#.#...#.#
##.#.#.#.#######.#####.#############.#######.###.#####.#.#.###.#
...#.#.#.#...#.....#.#...........#.#...#.....#.#.....#.#.#.....#
.###.#.#.#.#.#####.#.###########.#.###.#.#####.#.###.#.#.#.#####
...#...#...#.#...#.......#.#.....#.....#.#.....#.#.#.#...#.#...#
##.#########.#.#.#######.#.#.#####.#####.#####.#.#.#.#####.###.#
.#.#.......#...#...#.......#S#...#.#.........#.....#.....#...#.#
.#.#.#.###########.#.#########.#.#.#.#######.#.#######.#####.#.#
.#.#.#.....#...#...#.....#...#.#.#.#.......#.#...#.....#...#...#
.#.#.#####.#.#.#.#####.###.#.#.#.#.#######.#.#.###.#####.#.###.#
.#.#.#...#...#.#...#...#...#...#.#.#.....#.#.#.#...#...#.#.#...#
.#.###.#.#####.###.#####.#######.#.#.###.###.#.#.###.#.#.#.#.###
.#.#...#...#.....#.......#.....#.#...#.#...#.#.#...#.#...#.#...#
.#.#.#####.#.#################.#.#####.###.#.#####.#.#####.###.#
...#.#...#.#...........#.......#.#.......#...#...#.....#...#.#.#
.###.###.#.#.#######.#.###.#####.#.#.###.#####.#.#######.#.#.#.#
.#.....#...#.......#.#...#.#...#...#...#...#...#.......#.#...#.#
.#####.#.#####.#####.###.#.#.#.#.#####.###.#.#.#######.#.#####.#
.#.....#.#...#.#.....#.#...#.#.#.#.....#.#.#.#.....#...#.#.....#
.#.#####.#.#.###.#####.#.###.#.###.#####.#.#.#####.###.#.#.#####
...#.....#.#.#...#.....#.#...#.....#...#...#.#...#...#.#.#.#...#
####.#####.#.#.###.#####.#.#####.###.#.#####.#.#.###.#.#.#.###.#
.....#.....#...#.#.....#.#...#.#.#...#.......#.#.#.#.#...#...#.#
.#######.#######.#.###.#.###.#.#.#.###########.#.#.#.#######.#.#
...#...#...#.........#.....#.#...#.#...........#.#.#.........#.#
##.#.#.###.#.###############.#.###.#.###########.#.###########.#
.#...#.....#.....#.........#.#.#...#.#...#.......#.#.....#.....#
.###############.#.#######.#.###.###.#.#.#.#######.#.#.###.#.###
.......#...#.#...#...#...#.#...#.#...#.#.#.#...#.....#.....#...#
.#####.#.#.#.#.#####.###.#.#.#.#.#.###.#.#.#.#.#######.#######.#
.#...#...#.#.#.....#...#...#.#.#.#...#.#.#...#.......#...#.....#
.#.#.#####.#.###.#####.#.#####.#.###.#.#.###########.#.###.###.#
.#.#.....#.....#.#.....#.....#.#...#.#.#.....#...#...#.#...#.#.#
.#.#####.#######.#.#########.#.###.#.#.#####.#.#.#.#####.###.#.#
.#.#...#...#...#.#...#...........#...#.#...#.#.#...#.....#.....#
.#.#.#####.#.#.#.###.#####.###########.#.###.#.#######.###.#####
...#.....#...#.....#.....#...#.........#.....#.......#.#.....#.#
.#######.###############.#.###.#####.###############.#.#####.#.#
...#.........#...........#.#...#...#.#...........#...#...#.#...#
##.#.#######.#.#######.#####.###.#.#.#.#########.#.###.#.#.###.#
...#...#.#...#.#.....#.#.......#.#...#.....#...#.#.#...#.#...#.#
.#####.#.#.###.#.###.#.#.#######.#########.###.#.#.#.###.#.#.#.#
.......#...#...#.#...#.#.#...#...#.......#...#.#.#.#.#...#.#G#.#
########.###.###.#.#####.###.#.###.#####.###.#.#.#.###.###.###.#
...........#.....#...........#.........#.......#.......#.......#
################################################################
