64
...#.............#.........#...#.....#...................#.#...#
.#.#.###########.#.###.###.#.###.###.#######.#.#########.#.#.#.#
.#...#.........#...#...#.#...#...#.#...#...#.#.#.....#...#...#.#
.###########.#.#####.###.###.#.###.###.#.#.#.#.#####.#.#####.#.#
.#.....#.....#.....#...#...#.#.#.....#...#.#.#...#...#.....#.#.#
.#.###.#.#####.#######.#.###.#.#.#########.#####.#.#######.###.#
...#.#...#.....#.......#...#.#.#.........#.......#.....#.#.....#
####.#####.#####.#######.#.#.#.#####.#.#.#########.#.#.#.#####.#
.....#...#...#.#.#.......#...#.....#.#.#.....#.....#.#...#...#.#
####.#.#.###.#.#.###.#############.###.#######.#####.#####.#.#.#
...#.#.#.......#...#...#.....#...#...#...........#...#...#.#...#
.#.#.#.###########.###.###.#.#.#.#.#.#####.#######.###.#.#.#####
.#.#.#...#...#.....#.#...#.#.#.#.#.#.....#.....#...#...#.#.#...#
.#.#.###.#.###.#####.###.#.###.#.#####.#.#.#####.###.###.#.#.#.#
.#...#.#.#...#.....#.#.....#...#.....#.#.#.#.....#...#...#...#.#
.###.#.#.#.#.#####.#.#.#####.#######.###.###.#####.###.#.#####.#
.#.#...#.#.#.....#.#.#.#.#...#.#...#.....#...#...#.#...#...#.#.#
.#.###.#.###.###.#.#.#.#.#.###.#.#.#######.###.#.#.#.#####.#.#.#
.#.....#...#.#.#.#.#.....#.#.#...#...#.........#...#.#.......#.#
.#########.#.#.#.#.#####.#.#.#.#####.#.#############.#########.#
.#.........#...#.#.....#.#.#.#...#.#.#.#.......#...#.........#.#
.#.#############.#####.#.#.#.###.#.#.#.#.#####.#.#.#########.#.#
.#.#.........#.....#...#.#S#.......#.#.#.#...#...#.#.......#...#
.#.###.#.###.#.###.#.###.#########.#.#.#.#.#.#####.###.###.#####
.#...#.#.#.#...#...#.#.#.#.....#...#.#...#.#.....#...#...#.....#
.###.###.#.#####.###.#.#.#.###.#####.#########.#.###.#####.###.#
...#...#.#.....#.#.#.#.....#...................#...#.......#...#
##.###.#.###.###.#.#.###.#########################.#########.###
...#...#...#.#...#.#...#.#.......#.....#...#.....#.#.......#...#
.#.#.#####.#.#.###.###.###.#####.#.###.#.###.###.#.#.###.#.###.#
.#.#.#...#.#...#.....#.#...#...#.#...#.#.....#...#.#...#.#.#...#
.#.#.#.#.#.#.###.#.###.#.###.###.###.#.#######.#.#.###.#.###.###
.#.#...#...#.#...#.#...#.....#.....#.#...#...#.#.#...#.#.....#.#
.###########.#.###.#.#####.###.###.#.###.#.#.#.#####.#.#######.#
...........#.#.#...#.#...#.#...#...#...#...#.#.......#.......#.#
.###.#######.#.#.###.#.#.#.#.###.#####.#####.###############.#.#
.#...#.....#...#.#.#...#...#...#.#...#...#...#.........#...#.#.#
.#.###.###.#####.#.###########.#.#.#.###.#.#.#.#####.#.#.#.#.#.#
.#.#...#.#.......#.........#...#...#.#...#.#.#.....#.#.#.#.#...#
.#.#.###.###########.#####.#.#.#####.#.###.###.#####.#.#.#.###.#
.#...#.....#.........#.....#.#.#...#.#...#.....#.....#...#.#...#
.#######.#.###.#############.###.#.#####.#######.#######.###.###
.#.......#.....#.....#.....#.....#.#.....#.....#.....#.#.#...#.#
.#.#########.###.###.#.###.#.#####.#.#####.#########.#.#.#.###.#
.#.#.........#...#.#.#...#.#.#...#.#.#.#.........#...#.#.#...#.#
.#.###########.###.#.###.#.###.#.#.#.#.#.#####.###.###.#.###.#.#
...#...#...#...#...#.#...#.#...#...#.#...#.....#...#.....#.#...#
.###.#.#.#.#.###.###.#.###.#.###.###.#####.###.#.###.#####.###.#
.#...#.#.#...#.......#.#.#...#...#...#.....#...#...#.......#...#
##.###.#.#.#########.#.#.#####.###.###.#####.#####.###.#####.###
...#.....#.#.......#...#.....#.#.#.#.....#...#...#...#.#.....#.#
.###########.#####.#######.###.#.#.#####.#.###.#.###.###.#####.#
.#...#.......#...#.......#.....#.#.#.....#...#.#...#.....#.#...#
.#.#.#.#######.#.#.#####.###.###.#.#.#######.#.#.#########.#.#.#
...#.#...#.#...#.#.#...#...#.#...#...#...#...#.#.........#...#.#
.###.###.#.#.###.###.#.###.#.#.#.#####.#.#.#######.#####.#####.#
.#...#...#.#...#.#...#.....#...#.....#.#...#.......#...#....G#.#
.#.###.###.###.#.#.###########.#######.#######.#####.#.#####.#.#
.#.#...#.....#.#...#.........#.#.......#.....#.#.....#...#.#...#
##.#.###.#####.#####.#######.#.#.#########.#.#.#.#######.#.###.#
...#...#...#...#...#.#.....#.#.#.....#.....#.#.#.......#...#...#
.#####.###.#.###.#.#.#.###.#.#######.#.#####.#.#.#####.#####.###
...........#.....#.....#...#...........#.......#.....#.........#
################################################################
