64
.#.....#.....#.........#G..........#.....................#.#...#
.#.#.#.#.###.#.#####.#.#####.#####.#.###############.###.#.#.#.#
...#.#.#.#.#...#...#.#.......#...#.#.......#.....#...#.#.#...#.#
.###.#.#.#.#####.###.#########.###.#######.#.###.#.###.#.#.###.#
...#.#.#.#.#.....#...#.....#...#...#...#...#...#...#...#.#.#...#
.###.#.#.#.#.###.#.###.###.#.#.#.###.###.#####.#####.#.#.###.#.#
.#...#.#.#...#...#.....#.#.#.#...#...........#.#...#.#.#.....#.#
.#.#####.#.###.#.#######.#.#.#####.#####.#####.#.#.#.#########.#
.#.....#.#.#...#.........#.#...#.#.#...#.#.....#.#.#.........#.#
.#####.#.###.###########.#.###.#.#.#.#.###.#####.#.#.#######.#.#
...#...#.#...#.........#.#...#.#...#.#...#.#.....#.#.#.....#...#
####.###.#.#########.#.#.###.#.#####.###.#.#.#####.#.###.#.#####
.....#...#.#.....#...#.#.#.#.#.....#...#.#...#.....#...#.#.....#
.###.#.###.#.###.#.###.#.#.#.#####.#.#.#.#####.#######.#.#.###.#
.#...#.#...#.#.#...#...#...#...#...#.#.#.#...#.#.#.....#.#...#.#
.#.###.#.#.#.#.#####.#####.###.#.#####.#.#.#.#.#.#.#####.###.###
.#.#.#.#.#.#.#.....#.....#.#...#...#...#...#...#.#.#...#...#...#
.#.#.#.###.#.#.###.#####.#.#.#####.#.###########.#.###.#.#####.#
.#...#.....#.#...#.#...#.#.#...#.#...#.#...#.....#...#...#...#.#
.###.#######.#.#.###.#.#.#.###.#.#####.#.#.#.#.#####.#.###.#.#.#
.#...#.......#.#.....#...#...#.#.......#.#.#.#...#...#.#...#...#
.#.###.###.###.#############.#.###.#.###.#.#.###.#.#####.#####.#
.#.#.....#.#.#...#.......#...#...#.#.....#...#...#.#.....#.#...#
.#.###.###.#.###.#.#####.#.#####.#####.#######.#.#.#.#####.#.###
.#...#.#...#.....#.....#...#...#.....#.#...#...#.#.#...#.#...#.#
.###.#.#.#####.#######.#####.#.#####.###.#.#.#####.#.#.#.#.###.#
.#.#.#.#.....#.#.....#.....#.#.....#.#...#.#.#.....#.#.#.#.#...#
.#.#.#.#####.#.#.#########.#####.###.#.###.#.#.#####.#.#.#.#.#.#
.#.#.#...#...#...#.....#...#...#...#.#...#...#.#.....#.#.....#.#
.#.#.#.###.#####.#.###.#.###.#.###.#.###.#####.#######.#######.#
.#...#.#...#.....#...#...#...#.....#.#...#...#.......#.......#.#
.###.###.###########.#####.#.#######.#.###.#.#######.#######.#.#
...#...#.#.........#.......#.#...#...#.....#.....#...#.......#.#
.#.###.#.#.#######.#########.#.#.#.###.#####.#.###.###.#######.#
.#...#...#...#.#.....#.......#.#...#.......#.#.#...#...#.....#.#
.###.###.###.#.#.#####.#######.#############.###.###.###.###.#.#
.#.#.#.....#...#.#...#.......#...#.....#...#.........#.#...#...#
.#.#.#.#######.#.#.#.#######.###.#.###.#.#.#.#########.###.#####
...#.#.#.......#.#.#.......#...#.#...#...#.#.#...#.#.......#...#
##.#.#.#.#######.#.#####.###.###.###.#####.#.#.#.#.#.#######.#.#
.#.#.#.#.....#...#...#.#.....#.....#.#...#.#.#.#.#.#.#...#...#.#
.#.#.#.#####.#.#####.#.#####.#.#####.#.###.###.#.#.#.#.#.###.#.#
...#.#.#.....#.........#...#.#.#.....#...#.....#.#.....#.....#.#
.###.###.###############.#.###.#.#######.#######.#.###########.#
.#.#.#...#...#.......#...#...#.#.#.........#...#.#.#.....#.#...#
.#.#.#.###.###.#####.#.#####.#.#.#.#######.#.#.#.###.###.#.#.###
...#...#.....#...#...#.....#...#.#.#.......#.#.#.......#.#.#.#.#
##.#########.###.###.#.###.#####.#.#.#########.#########.#.#.#.#
.#.#.......#...#...#.#...#.....#...#.#.........#.....#...#...#.#
.#.###.###.#.#.###.#.#########.#####.#.###.###.#.###.#.###.###.#
.#.#...#.#...#.#...#.......#.....#.#.#.#...#.#.#...#...#...#...#
.#.#.###.#####.#.#########.#.###.#.#.###.###.#.###.#######.#.#.#
...#...#.#.....#.......#.#.#...#...#...#...#.....#.#.....#...#.#
.#####.#.#.###########.#.#.#.#.###.###.###.#######.#.###.#######
...#...#.#...#.......#.#.#.#.#.#.....#.....#.......#...#.#S....#
##.#.###.###.#.#####.#.#.#.###.#####.#####.#.#####.###.#.#####.#
.#.#.#.....#.#.....#...#.......#...#...#...#.#.....#...#.....#.#
.#.#.#.#.###.#####.#############.#.###.#.###.#####.#.#####.###.#
.#...#.#.#...#...#...#.......#...#...#.#...#.....#.#...#...#...#
.#####.#.#.#####.###.#.#####.#.#####.#.###.#####.#####.#.###.###
.......#...#...#.#...#.#...#.#.#.#...#.#...#...#...#...#.#...#.#
.###########.#.#.#.###.###.#.#.#.#.#####.#####.###.#.###.#.###.#
.............#...#.........#.....#...............#.....#.......#
################################################################
