8
.......#
.#.###.#
.#.#..G#
##.#.###
S..#...#
######.#
.......#
########
