8
....G..#
.#####.#
.#...#.#
.#.#.#.#
...#.#.#
.#####.#
.#S....#
########
