8
.#S..#.#
.###.#.#
.....#.#
.#####.#
...#...#
##.###.#
......G#
########
