64
.#.....#.......#.........#.....#.....#.......#.....#.....#.....#
.#.#.###.#.###.#.#########.###.#.#.###.###.###.#.###.###.#####.#
...#...#.#.#...#.#.......#...#.#.#...#...#.....#...#.#.....#...#
.#####.#.#.###.#.#.#####.#.###.#.###.###.#########.#.#####.#.#.#
.....#.#.#...#...#.....#...#...#...#.....#.#.....#.#...#.#...#.#
######.#.###.#########.#####.#####.#######.#.###.#.###.#.#####.#
...#...#.#.#...........#...#.....#.......#...#...#...#.#.....#.#
.#.#.###.#.#############.#.###.#########.#####.#####.#.#####.#.#
.#...#...#.#.............#.#.#.................#...#.#.....#...#
.#.###.###.#.#######.#####.#.#################.#.#.#.#####.#.###
.#.#...#...#.#...#.#.#.............#.........#.#.#.#...#...#...#
.#.#.###.###.#.#.#.#.###.###########.#######.#.#.#.#.#.#.#####.#
.#.#.#.#.......#...#...#.#.#.....#...#...#...#.#.#.#.#.#S#.#...#
.###.#.#.#########.###.#.#.#.###.#.###.#.###.###.#.###.###.#.###
.....#.......#...#...#.#...#.#.....#...#...#.....#.........#...#
.#######.#####.#.###.#.#####.#######.#####.#####.#######.#####.#
.#.....#.#.....#...#.#.....#.........#.#...#...#.#...#...#.....#
.###.#.###.#######.#.#####.###########.#.#.#.#.###.#.#####.#####
...#.#...#.#.......#...#...#.......#...#.#.#.#.....#.....#.#...#
##.#.###.#.#.#########.#.#.###.###.#.#.#.#.#.###########.#.###.#
.#...#.#.#.#.....#.....#.#.#...#.....#.#.#.#.#.........#.#...#.#
.#####.#.#.#####.#######.#.#.#########.#.#.#.#.#####.###.###.#.#
.......#...#...#.#.......#.#.....#.....#.#.#.#.#.#...#...#...#.#
##.###.#####.#.#.#.#######.#.###.#######.#.#.#.#.#.###.#.#.###.#
...#.....#...#.#.#...#.....#.#.#.....#...#.#...#...#...#.#.....#
.#########.###.#.###.#.#####.#.#####.#.#########.###.#########.#
.#...#...#.#.#...#...#...#.....#...#.#.........#...#.........#.#
.#.#.#.#.#.#.#####.#####.#####.#.#.#.#######.#.###.#####.#####.#
...#.#.#...#.......#...#...#.#...#.#.....#.#.#.#.......#.#.....#
.###.#.###########.#.#.###.#.#####.###.#.#.#.#.#.#######.#.#####
...#...#...........#.#...#.#.#.....#...#...#.#.#.#.#...#.#.#...#
##.#####.#.#########.#.###.#.#.#####.#####.#.#.#.#.#.#.#.#.#.#.#
.#.....#.#.#.......#.#...#.#.......#.#.....#.#.#.#.#.#.#.#...#.#
.#####.###.#.###.#.#.###.#.#########.#######.###.#.#.#.#.#####.#
.....#.....#...#.#.#.#.#.#.......#...#.....#...#...#.#.#.....#.#
.###.#######.###.###.#.#.#######.#.###.###.###.###.#.#.#####.#.#
.#.#....G#...#...#...#.#...#.....#...#.#.#...#.....#.#.#.....#.#
.#.#####.#.###.###.###.#.###.#####.#.#.#.###.#######.#.#.###.#.#
.#.......#.#.#...#.#...#.....#.#...#...#.#...#.#.....#...#.#.#.#
.#########.#.###.#.#.#.#######.#.#######.#.#.#.#.#########.#.#.#
.#.....#...#...#.#...#.#.......#.#.....#.#.#...#...#.........#.#
.#.###.#.###.#.#.#####.#.###.###.#.###.#.#.#.#####.###########.#
...#...#.#...#.#.......#...#.......#.#...#.#.#...#.......#.....#
.###.#.#.#.###.###########.#########.###.#.###.#.#######.#.#####
...#.#.#...#.#.#...#.....#...#.....#.#...#.....#.......#...#...#
.###.#.#####.#.#.###.#.#.#####.###.#.#.###############.#######.#
.#...#.#.....#.#...#.#.#...#...#...#.#.#.#...............#.....#
.#.#####.#.#.#.###.#.#.###.#.###.###.#.#.#.#######.#######.#.###
.#.......#.#.#...#...#...#...#.#...#.#...#...#.....#.......#...#
.#########.#####.#######.#####.###.#.###.###.#######.#########.#
.#.......#.#...#.....#...#.......#.#...#.#.#.#.......#.#.....#.#
.###.#####.#.#.#####.#.###.#####.#.#.#.#.#.#.#.#######.#.###.#.#
.....#.....#.#.....#.#.#.#...#...#.#.#.#...#...#.......#...#.#.#
####.#.#####.###.###.#.#.###.#.###.###.###.#########.#####.#.#.#
...#.#.#.....#.#.#...#.#...#.#...#...#...#...#.....#.....#.#...#
.#.#.#.#.#####.#.#.###.#.#.#.###.###.#.#####.#.###.#.#.###.###.#
.#.#.#.#.#.....#...#...#.#.#.#.#.....#.....#.#.#.#.#.#.#...#...#
##.#.#.#.#.###.#######.#.###.#.#######.###.#.#.#.#.###.#.###.###
...#.#.#.#.#.#.#.....#.#.....#.....#.....#...#.#.#...#.#.#.#.#.#
.###.#.#.#.#.#.#.###.#.#####.#.#####.#######.#.#.###.#.#.#.#.#.#
.....#...#.#...#.#...#.....#.#.......#.....#...#.......#.#...#.#
.#########.#.###.#.#######.#.#########.###.#############.#.###.#
...........#.....#.........#...........#.................#.....#
################################################################
