8
....G#.#
.###.#.#
...#.#.#
##.#.#.#
S#.#.#.#
.#.#.#.#
...#...#
########
