64
.......#...#.........#.......#.............#.#.......#....G#...#
.#####.#.#.#.#######.#.###.###.#.#########.#.#.###.###.#.###.#.#
.#...#...#...#.....#.#...#.#...#.#.....#.....#.#.#.....#.....#.#
.#.#.#########.#####.###.#.#.###.#.###.#####.#.#.#############.#
.#.#.#.....#.........#.#.#...#...#...#...#...#...#.......#.....#
.###.#.#.###.#########.#.#####.#.###.###.#.#####.###.#####.#####
...#.#.#.....#.......#...#.#...#.#...#...#.....#...#.#...#.....#
.#.#.#.#######.#.#####.###.#.#####.###.#######.###.#.#.#.#.###.#
.#.#.......#...#.#...#.#...#.#.......#.#.#...#.#.#.#.#.#.#.#...#
.#.#######.###.#.#.#.#.#.###.#.#######.#.#.#.#.#.#.#.#.#.###.###
.#.......#...#.#...#...#...#...#.......#...#...#.#...#.#...#...#
.#######.###.#######.#####.#####.#######.#######.###.#.###.###.#
.#...#...#.........#...........#...#...#...#.......#.#.#.......#
.#.#.#.###.#######.###########.###.#.#.###.#.###.###.#.#######.#
.#.#.#...#.#.....#.......#...#...#.#.#...#.#...#.#...#.......#.#
.###.###.###.###.#######.#.#.#####.#.###.#.###.#.#.#####.###.###
...#...#.....#.#...#...#.#.#.......#.#.#.#...#.#.#.#...#...#...#
##.###.#######.###.#.###.#.#######.#.#.#.###.#.###.#.#.#######.#
.....#...........#.#.#...#...#...#.#.#.#...#...#...#.#...#...#.#
####.#.#.#######.#.#.#.###.#.#.#.#.#.#.###.###.#.###.###.#.#.#.#
...#...#.#S..#...#.#...#...#...#.#.#.#.#...#...#.#.#.#.#.#.#...#
.#.#####.###.#.###.#.#####.#####.#.#.#.#.#######.#.#.#.#.#.#####
.#...#...#...#...#.#.#...#...#...#.#.#.#.........#.#.#...#.#...#
.###.#####.#######.#.#.#.###.#.###.#.#.###########.#.#.###.#.#.#
.#.#...#...#.....#.#...#...#.#.#...#.#...#.#...#...#.#.#.....#.#
.#.###.#.###.###.#.#######.#.#.#####.#.#.#.#.#.#.#.#.#.#######.#
.....#...#...#.#.#.......#.#.#.....#.#.#.#...#...#.#.#.........#
####.#######.#.#.#.#####.#.#.#####.#.#.#.###.#####.#.###########
.#...#.....#.#...#.#.....#.#.#...#.#...#...#.#...#.#.......#...#
.#.###.###.#.#.#####.#####.###.#.#.#######.#.#.#.#.#######.#.#.#
.#...#.#.....#.#.....#.#...#...#...#...#...#.#.#.#.......#...#.#
.###.#.#######.#.#####.#.###.#.#####.#.#.###.#.#.#.###########.#
...#.#...#...#...#.#.....#...#.#.....#.#.#.#...#.#...#.........#
.###.###.#.#.#####.#.#####.#.#.#.#####.#.#.#####.###.#.#######.#
.....#...#.#...#...#.#.....#.#.#.#.....#.#.......#...#.....#...#
.#####.###.###.###.#.#######.###.#.#####.#.#######.#######.#.###
.#...#...#.#.#...#...#...#...#...#.......#.#.....#.....#...#.#.#
.#.#.#.#.#.#.###.###.#.#.#.###.###########.###.#####.#.#.###.#.#
.#.#...#.......#...#.#.#.#.#...#...#.....#...#.....#.#.#.#.#...#
.#.#############.#.#.#.#.#.#.#####.#.#.#.###.#####.#.#.#.#.###.#
.#.#...........#.#.#...#...#.#.....#.#.#.#.........#.#.#.#...#.#
.###.#########.#.#.#.#######.#.#.###.#.#.#######.###.#.#.###.#.#
.#...#.......#.#.#.#.#.......#.#.....#.#...#.....#...#.#.#...#.#
.#.#######.###.#.#.###.###########.###.###.###.###.#.###.#.#.#.#
.#.#.......#...#.#.....#.........#.#...#.#...#.#...#.#...#.#.#.#
.#.#.#####.#.#####.#######.#####.#.#.###.###.#.#.###.#.###.###.#
...#.....#.#.....#.........#.#...#.#...#.#...#.#...#.#.#.#.....#
########.#######.###########.#.#######.#.#.###.###.###.#.#.#####
.#.....#.......#.#.....#...#...#.....#.#...#.#.#...#...#.#.....#
.#.#.#.#.#.#####.#.###.###.#.#####.#.#.#.###.#.#.#.#.###.#####.#
...#.#.#.#...#...#...#.#...#...#...#.#.#...#...#.#.#.#.#.......#
.###.#.#####.#.#####.#.#.#####.#.###.#.###.#####.#.#.#.#.#######
...#.#.......#.#...#.#.#.........#.....#...#.....#.#.#.#.#...#.#
.###.#######.#.#.#.#.#.###########.#####.###.#####.#.#.#.#.#.#.#
.#...#...#...#...#.#.#.....#.....#.#...#.....#.....#.#.#.#.#...#
.#.#.#.#.#########.#.#####.#.###.###.#.#########.###.#.#.#.###.#
.#.#.#.#.........#.#.....#...#.#.....#.#...#...#.#...#.#...#...#
.#.###.#########.#.#####.#####.#######.#.#.#.#.###.###.#####.###
.#.#...#.....#.#...#.....#.....#.....#...#...#...#.#...#...#.#.#
##.#.###.###.#.#####.#####.#####.###.###########.#.#.###.#.#.#.#
...#.....#...#.......#.....#...#.#.....#.......#.#.#...#.#.#.#.#
.#########.###.#######.#####.#.#.#.#####.###.###.#.#.#.#.#.#.#.#
...............#.............#...#.........#.......#.#...#.....#
################################################################
