16
..G....#.......#
##.###.#######.#
...#...........#
.###.###########
...#...#...#...#
.#.#.###.#.#.#.#
.#.#.#...#...#.#
.#.###.#######.#
.#...#.......#.#
####.#######.#.#
.......#.....#.#
.###.###.#####.#
.#...#...#S..#.#
.#####.#####.#.#
...........#...#
################
