8
S..#...#
##.#.#.#
.#.#.#G#
.#.#.#.#
.#...#.#
.#####.#
.......#
########
