8
.....#.#
.#.#.#.#
.#.#.#G#
##.#.#.#
...#...#
.#####.#
..S#...#
########
