64
...#.........#...........#.....#...#.........#.....#.......#...#
.###.###.#####.#######.#.#.###.#.#.#.#######.#.###.#.###.#.###.#
...#.#.#.#...#...#.#...#.#.#.....#.#...#...#.#.#...#.#...#...#.#
.#.#.#.#.#.#.###.#.#.###.#.#######.###.#.#.#.#.#.###.#.#####.#.#
.#...#.#...#.#...#.#.#.#.#.....#.#...#...#.#...#...#.#...#.#.#.#
.#####.#####.#.###.#.#.#.#####.#.###.#####.#######.#.###.#.#.#.#
.#.......#.#.#.#...#.#.........#.#...#.....#...#...#.#...#...#.#
.#.#####.#.#.#.#.###.#.#########.#.###.#####.###.###.#.###.###.#
...#...#...#.#.#.#...#...#.....#...#.....#...#...#.#.#...#.....#
####.###.###.#.#.#.#.#####.###.#####.###.#.#.#.###.#.###.#####.#
.....#...#...#.#.#.#.#.....#...#.....#S#...#.#.#...#...#...#...#
.###.#.###.###.#.#.#.#.#####.###.#####.#####.#.#.#.###.###.#.###
.#...#...#...#...#.#.#...#.#...#...#...#...#.#.#.#.......#.#...#
.#.#.###.###.#.###.#.###.#.###.#.###.###.#.###.#####.#####.###.#
.#.#...#...#...#...#...#...#.#...#...#...#.....#...#.#...#...#.#
.#.#######.#####.###.#####.#.#####.#####.#######.#.###.#.#.#.#.#
.#.......#.....#.#...#...#...#...#.......#.....#.#.....#.#.#.#.#
.#######.#.#####.#####.#.###.###.###########.#.#.#######.###.#.#
...#.....#.#.....#...#.#...#.........#.......#...#.....#...#.#.#
##.#.#####.#.###.#.#.#.###.#########.###.#.#######.#######.#.#.#
...#...#...#...#.#.#...#.#...#...#.#...#.#...#...........#.#.#.#
.#####.#.#####.###.#####.#.#.#.#.#.###.#.###.#######.#.###.#.#.#
...#.#.#.....#...#...#...#.#...#.....#.#...#...#...#.#.......#.#
##.#.#.#.#######.###.#.###.#####.#####.###.###.#.#.###########.#
.#...#...#.....#...#.#...#...#...#...#.#.#.#.#...#.#.......#...#
.###.#####.###.#.#.#.#.#.###.#####.#.#.#.#.#.#####.#.#####.#####
.....#...#...#...#.#.#.#...#.#.....#...#.#...#...#.#.#...#.....#
.#####.#.###.#######.###.###.#.#########.###.#.#.#.#.###.#####.#
...#...#.....#.....#.#...#...#...#.....#...#...#.#.#.....#...#.#
##.#.#########.###.#.#.###.#####.#.###.#.#######.#.#####.###.#.#
...#.........#.#.#...#...#.......#...#.#.....#...#...........#.#
.###########.#.#.#####.#.#########.#.#.#.#.###.###############.#
.....#.....#...#.#.....#...#...#...#.#.#.#.....#...#.....#.....#
####.#.###.#####.#.#####.#.###.#.###.#.#######.#.#.#.#.###.###.#
.#...#...#.#...#.....#...#...#.....#.#...#...#...#.#.#.#...#...#
.#.###.#.#.#.###.#####.#####.#####.#.###.#.#.#####.###.#.###.###
...#.#.#.#.#.......#...#...#...#...#...#.#.#.#...#.#...#.#...#.#
.###.#.#.#.#########.###.#.###.#######.#.#.#.#.#.#.#.#.#.#.###.#
...#...#.#.#.......#.....#...#.#.....#.#...#...#.#...#.#.#...#.#
##.#.###.#.#.#####.#########.#.#.###.#.###.#####.#######.###.#.#
.#.#.#...#.#...#.#.......#...#.#.#.....#...#...#.....#...#.#.#.#
.#.#.#.###.#.#.#.#######.#.###.#.###########.#.#####.#.###.#.#.#
.#.#.#.#...#.#.#.......#...#.#.#.......#.....#.#.#...#.#.....#.#
.#.###.#.#####.#.###.#.#####.#.###.###.#.#####.#.#.###.#.#####.#
.#.....#.#.....#.#.#.#.......#...#.#.#.......#.#.#.....#...#...#
.#######.###.###.#.#.#######.###.#.#.#########.#.#########.###.#
.......#...#...#...#.#.......#...#.....#.......#...#.....#.....#
.#########.#.#.#####.#.#######.#########.#######.#.#.###.#####.#
...#...#...#.#.#.....#.#.....#.....#.....#...#...#.#.#.#...#...#
.#.#.#.#.#####.#.#####.#.###.#####.#.#######.#.###.#.#.#.#.#.###
.#...#...#...#.#.#...#.#...#.....#.#.#.....#.....#.#...#.#.#.#.#
.#########.#.#.#.###.#.###.#####.#.#.###.#.#######.###.#.###.#.#
.#....G....#.#.#...#...#...#...#...#.#...#...........#.#...#.#.#
.#####.#.###.#.#.#.###.#.###.#######.#.#########.#####.###.#.#.#
.....#.#.#.#...#.#...#.#...#.....#...#.#.........#.....#.#...#.#
####.###.#.#####.###.#.###.#.#.#.###.#.###.#######.#####.#####.#
...#.#...#.#...#...#.#...#.#.#.#...#.#...#.#.#...#.........#...#
.###.#.###.#.#.###.#.###.#.###.###.#.###.#.#.#.#.#########.#.#.#
.....#.#...#.#...#.#...#.#...#.#...#.#...#...#.#.#.....#...#.#.#
.#####.#.#.#.###.#.###.#.###.#.#.###.#.#######.#.#.###.#.###.#.#
.#...#.#.#.#...#...#.#.#.#...#.#.#...#...#...#.#...#.#.#...#.#.#
.#.#.#.#.#####.#####.#.###.###.#.#.###.#.#.#.#.#####.#.###.#.#.#
...#...#.............#.........#...#...#...#.........#.......#.#
################################################################
