64
...#.........#.....#.....#.......#.......#.........#.....#.....#
.###.#####.#.#.###.###.#.#.###.#.#####.###.#####.###.###.###.###
.#...#.....#...#.....#.#.#...#.#.......#.....#...#...#.#...#...#
.#.###.#############.#.#.###.#.#########.#####.#.#.###.###.###.#
...#.#.......#...#.....#...#.#.............#...#.#.#.....#.#...#
.###.#######.#.#.#########.#.###############.###.#.###.#.#.#.#.#
...........#...#...#...#...#.#.........#.....#...#...#.#.#.#.#.#
.###########.#####.#.###.#####.#######.#.#####.#####.#.###.#.#.#
.#...#.....#.#...#.#...#.#.....#...#...#.#.....#.....#.......#.#
##.#.#.###.###.#.#.#.#.#.###.###.###.###.#####.#.#####.#######.#
...#.#...#.....#.#.#.#.....#.#...#...#.......#.#.#.......#...#.#
.###.###.#######.#.#######.#.#.#.#.###.#####.#.#.#######.#.#.#.#
.#.......#...#...#.....#.....#.#...#...#.....#.#.#.....#.#.#.#.#
.#.#######.#.#.###.###.#######.#####.###.#####.#.#.###.###.#.#.#
.#.#.....#.#.#.#.....#...#.#...#.....#...#.....#.....#.....#.#.#
.###.###.#.#.#.#########.#.#.#########.#####################.#.#
.....#...#.#.#.......#...#...#.........#.......#.....#.......#.#
.#####.#####.#######.#.###.#####.#######.#####.#.###.#.#######.#
...#.#.....#.....#.#...#.#.......#.......#.....#.#...#.#.....#.#
##.#.#####.###.#.#.#####.#####.###.#######.#####.###.#.#.###.#.#
...#.....#.#...#...#...........#...#.....#.....#...#...#...#...#
.#####.#.#.#.#.#####.###########.###.###.#####.###.#######.#####
.......#.#.#.#.#.....#.....#...#.#...#.....#...#.#.....#.#.#...#
##.#######.#.###.#########.#.#.#.#.#######.#.#.#.#####.#.#.#.#.#
...#.....#.#...#.#.......#.#.#...#.......#.#.#...#.#...#...#.#.#
.###.###.#.###.#.#.#.###.#.#.###########.#.#.###.#.#.###.###.#.#
...#.#.#.#...#...#.#.#.....#.#.....#.....#.#...#.#.#S#.#.#.#.#.#
##.#.#.#.###.#.#####.#####.#.#.###.#.#####.###.#.#.###.#.#.#.#.#
...#.#.......#.....#...#...#...#.#.#...#...#...#...#.....#.#.#.#
.###.#############.###.#.#######.#.#.#.#.###.#####.#.#####.#.#.#
.#.#...#.........#.#...#.....#.....#.#.#...#...#...#.#.......#.#
.#.###.#.###.#####.#.#########.#####.#.###.###.###.#.#.#######.#
...#.#.#.#...#...#.#...#...#...#.#...#.#...#.#...#.#.#.....#...#
##.#.#.###.###.#.#.###.#.#.#.###.#.###.#.###.###.#.#.#.#####.###
.#...#...#.....#.......#.#...#.......#.#.......#.#.#.#.#...#...#
.###.###.#########.#####.#############.#########.###.#.#.#.###.#
.....#.#.........#.#.....#.........#...#...#...#...#.#.#.#...#.#
.#####.#########.#.#.#######.#####.#.###.#.#.#.###.#.#.#.###.#.#
.....#.....#...#.#.#.#.......#.......#...#...#.#...#.#.#...#...#
####.###.#.#.#.#.###.###.#####.#######.#######.#.#.#.#.###.###.#
...#.....#...#.#.....#...#.....#...#...#.........#.#.#.#...#...#
.#############.#######.#####.###.#.#.###.###########.#.#.###.###
.............#.#.......#...#.#...#.#.#.#.#.....#.....#.#.#.#.#.#
.#.###########.#.#####.#.#.#.###.###.#.#.#####.#.#######.#.#.#.#
.#...............#.....#.#.#.....#...#...#...#.#.........#...#.#
.#######################.#.#######.#####.#.#.#.###########.###.#
...#.......#...#.........#.....#...#...#...#...#.......#...#...#
##.#.#####.###.#.#####.#######.#.#.#.#.#######.#######.#.#####.#
.#...#.#...#...#.#.#...#.....#.#.#.#.#...#.............#.......#
.#####.#.###.###.#.#.###.###.#.#.#.#.###.#############.#######.#
.....#...#...#...#.#...#...#.#...#.#...#...........#.#.#.....#.#
.#.#.#.###.###.###.#.#####.#.#########.###########.#.#.###.###.#
.#.#.#.#...#...#.....#.....#...........#.....#.....#.#.#...#...#
.#.###.###.#.#.#######.#################.#####.#####.#.#.#.#.###
.#...#.#...#.#.#.....#.#.........#...#.....#...#.........#.#...#
####.#.#.###.###.###.#.#######.#.###.#.###.#.###.#############.#
.....#G#...#.#...#...#.......#.#...#...#...#.#.......#.......#.#
.#.###.###.#.#.###.#########.#.###.#.###.#.#.#########.#####.#.#
.#.#...#...#...#.#.......#...#.#.#.#...#.#.#.........#.#.#...#.#
.###.###.#.#####.#######.#.###.#.#.#####.#.#########.#.#.#.###.#
...#.#...#.#...#.#.......#...#.#.#.#.....#.#...#...#...#.#.....#
.#.#.#.###.#.#.#.#.#########.#.#.#.#.#####.#.#.#.#.#####.#######
.#.....#.....#...#.............#.....#.......#...#.............#
################################################################
