8
.#..G..#
.#.#.#.#
...#.#.#
.###.#.#
.#...#.#
##.###.#
S..#...#
########
