32
.....#.................#...#...#
.###.#.#############.#.#.#.#.#.#
.#.#...#.............#.#.#.#.#.#
.#.#####.###########.###.#.###.#
.......#.#.#.........#...#.....#
####.###.#.#.#########.#######.#
.....#...#.#.#...#.#S#.#...#...#
######.###.#.#.#.#.#.#.#.#.#.###
...#...#...#...#...#...#.#.#...#
.#.#.###.###.###########.#.###.#
.#...#.......#.......#...#.....#
.#####.#######.#####.#.#########
.#.....#.....#.....#.#.....#...#
.#.#####.###.#####.#.#####.###.#
.#.#.......#...#.#.#.....#.....#
.#.#.#####.#.#.#.#.###.#.#####.#
.#.#.#...#.#.#...#.#.#.#...#...#
.###.#.#.###.###.#.#.#.###.#.###
.#...#.#.....#...#...#.#...#...#
.#.###.#############.#.#.#####.#
.....#.....#.....#...#.#.#.#...#
.#########.#.###.#.###.#.#.#.###
.#.........#...#...#...#...#.#.#
##.#######.###.#####.#.#####.#.#
...#.........#...#...#.#.....#.#
.###############.#.###.#.#####.#
.#.............#.#.#...#.#.....#
.#.###########.#.#.#.###.#####.#
...#....G....#.#.#.#...#.......#
.#########.#.#.#.#.###########.#
...........#.#...#.............#
################################
