16
...#...........#
.#.#.#.#########
.#...#.....#G..#
.#########.#.#.#
...#.....#...#.#
##.#.#.#####.#.#
.#...#.#...#.#.#
.#.#####.#.###.#
...#.....#.#...#
####.#####.#.#.#
..S#.#...#...#.#
.###.#.#######.#
.#...#...#.....#
.#.###.#.#.#####
...#...#.......#
################
