16
.....#S#.......#
.###.#.#.#####.#
...#.#.#...#.#.#
.###.#.###.#.#.#
.#...#.....#.#.#
.#.#.#######.#.#
.#.#.....#...#.#
.#.###.###.#.#.#
.#...#.#...#.#.#
.###.###.###.#.#
.#.#...#.#...#.#
.#.###.#.#.#.#.#
.....#...#.#.#.#
####.#####.###.#
..G......#.....#
################
