8
S......#
######.#
.....#G#
.#.###.#
.#...#.#
.###.#.#
...#...#
########
