64
...........#.....#.....................#.......#G......#.....#.#
.#######.#.#.###.###.#####.#.#########.###.###.#####.#.#.###.#.#
.#.......#...#.#...#.#...#.#.....#.........#...#...#.#.#.#...#.#
##.###########.###.#.#.#.#####.#.###########.###.#.#.#.#.#.###.#
...#.#.......#.....#.#.#.#...#.#.........#.......#.#.#...#...#.#
.###.#.#.#.###.#######.#.#.#.#########.#.#.#######.#.#######.#.#
.#...#.#.#.#...#.......#...#.........#.#.#.#.#...#...#.....#.#.#
.#.#.#.#.###.###.###########.#######.###.#.#.#.#.#####.#.#.#.#.#
.#.#...#...#...#.#...#.....#.#...#.#...#.#...#.#.#.#...#.#.#.#.#
.#########.###.#.#.#.###.###.#.#.#.###.#.#####.#.#.#.###.#.#.#.#
.#.......#...#...#.#...#.....#.#.#...#...#.....#.#.#.#.#.#.#...#
.#.#####.#.#####.#.###.#######.#.#.###.###.#####.#.#.#.#.#####.#
.#.#.#...#.......#.#.#...#.....#.#.#...#...#...#.#.#...#.#.....#
.#.#.#.###########.#.###.#.#####.#.#.###.###.#.#.#.###.#.#.#####
.....#.#...........#...#...#.#...#...#.#...#.#.#.#.....#...#...#
.#####.#.###########.#.#####.#.#####.#.###.#.#.#.#.###########.#
.#.....#.....#.....#.#.......#.....#...#...#.#...#...#.......#.#
##.###.#####.###.###.#.#####.#####.#####.###.#######.#.#####.#.#
...#.......#...#.....#.....#.....#.#.....#...#.....#.#.#.....#.#
.#########.###.###.#######.#######.#.#####.#######.#.#.#.#####.#
.....#...#...#...#.#.....#.......#...#.#...#.....#.#...#.......#
####.#.#####.###.#.#.#.#.#######.#####.#.###.###.#.###.#######.#
.....#.......#...#.#.#.#.......#.....#.#.#...#.#.#.#...#.....#.#
.#####.#######.###.###.#######.#.###.#.#.#.###.#.#.#.###.###.###
.#...#.....#...#.#.....#.....#.#.#.#.#.#.#.#...#.#.#.#.#...#...#
.#.#.###.###.###.###.###.###.###.#.#.#.#.#.###.#.#.#.#.###.###.#
.#.#...#.#...#.......#...#.#.....#.....#.#...#...#.#.....#.#...#
.#.###.#.#.###.#######.###.#.###########.#.#.#.###.#####.#.#.#.#
...#.#.#.#...#...#.....#.....#.........#.#.#.#.......#...#.#.#.#
.###.#.#####.###.#.#.#######.#.#######.#.#.#.###.#####.###.#.###
.....#.......#.#.#.#.#.....#.#.#.....#...#.#...#.#.....#...#...#
####.#########.#.#.###.###.#.#.#.#.#######.###.###.#####.#####.#
...#.......#.....#.#...#...#.#.#.#.......#.#.#.....#...#.#.#...#
.#.#######.#######.#.###.###.#.#.#######.#.#.#########.#.#.#.###
.#.......#.......#...#.#.#...#.#.......#...#...#.......#...#...#
.#######.#######.#.###.#.#.###.#####.#####.#.#.#.#########.###.#
.#.....#.#.....#.#...#.#.#...#...#...#...#...#...#.....#...#.#.#
.#####.#.#.#.###.###.#.#.#######.#####.#.#######.#.###.#.###.#.#
.....#...#.#.....#.#...#...#...#.......#.....#...#.#.#.#.....#.#
.###.#.###.#######.###.###.#.#.###########.#.#####.#.#.###.###.#
.#...#.#.#.....#.#...#.#.#...#.......#...#.#.#...#.#.#.....#...#
.#.###.#.#####.#.#.#.#.#.#####.#.###.#.#.###.#.#.#.#.#######.###
.#...#...#.....#...#.....#...#.#.#.#.#.#...#.#.#...#.....#.#...#
.###.###.#.#########.#####.#.###.#.#.#.###.#.#.#####.###.#.###.#
...#.#.#.#...#.....#...#...#.....#...#...#...#.#.......#...#...#
##.#.#.#.###.#.#.#.#####.#.#############.###.#.#####.#.#####.###
...#.#...#...#.#.#.....#.#.#.............#...#.....#.#.....#...#
####.#####.#####.#####.#.#.#.###########.#########.#######.###.#
.....#...#.#.....#.....#.#.#...#.....#...#.......#.......#.#...#
.###.#.#.#.#.#####.#####.#####.#.###.#.###.#####.#######.#.#.###
...#.#.#...#.#...#...#.......#...#.#.#...#.....#...#.....#.#...#
##.#.#.#####.#.#####.###.#.#######.#.#########.#.###.#####.###.#
...#.#...#...#.....#...#.#.......#.#...#.......#.............#.#
.###.###.#.###.#.#####.#.#####.#.#.###.#.#######.#############.#
.#...#...#...#.#.#.....#.....#.#...#...#.#.....#...#...........#
.#####.#####.#.#.#.#########.#.###.#.###.#.###.#####.#########.#
.....#.....#.#.#.........#...#.#...#...#.#...#.#...#...#...#...#
.###.#####.#.#.#########.#####.#.#####.#.###.#.#.#.###.#.#.#.###
.#.#...#...#.#.#...#..S#.......#.#...#...#...#...#.....#.#.#.#.#
.#.#.###.###.#.#.###.#######.#####.#.#####.#############.###.#.#
.#.#...#.....#.#...#.#.....#.#.....#.....#...#.#.........#...#.#
.#.###.#######.###.#.###.#.###.#########.###.#.#.#.#######.###.#
.....#.............#.....#.....#.............#...#.............#
################################################################
