64
...........#.#.........#.........#.............................#
.###.#####.#.#.###.#####.#.#####.#.#########.#######.#########.#
.#...#...#...#...#...#...#...#.#.#...#...#...#.....#.#.....#...#
##.###.###.#####.###.#.#####.#.#.###.#.###.###.###.###.###.#####
...#.#.....#.....#.#...#.....#...#.....#...#...#.#...#...#.....#
.###.#.#####.#####.#####.#####.###.#####.#.#.###.###.###.#####.#
...#.#.#.#...#.....#...#.#.....#...#.....#.#.....#.....#.#...#.#
##.#.#.#.#.###.###.###.#.#######.###.#########.###.#.###.#.###.#
...#.#.#.#.....#.#.....#.......#...#.......#...#...#.#...#.#...#
.###.#.#.#######.#####.#######.###.#######.#.###.###.#.###.#.#.#
.#...#.#.........#...#...#...#.....#.....#.#.#.#.#...#.....#.#.#
.###.#.#.#.#####.###.###.#.#.#######.###.#.#.#.#.#########.#.###
.#...#.#.#.#...#...#...#.#.#.#...#.....#.#.#...#.#.........#...#
.#.###.#.#.#.#####.###.#.#.#.#.#.#####.###.#.###.#.###########.#
.#.....#.#.#.....#.#...#...#.#.#.......#...#.#...#.....#.....#.#
.#####.###.#.#.#.#.#.#.#####.#.#######.#.#.#.#.#.#####.###.#.#.#
.....#.....#.#.#.#...#.#...#.#...#...#.#.#.#.#.#.....#...#.#.#.#
.###.#.#####.#.#.#####.#.#.#.###.###.#.#.###.#.#########.#.#.#.#
.#.#.#.#...#.#.#...#...#.#.#...#...#.#.#.....#.........#.#.#.#.#
.#.#.#.#.#.###.#####.###.#.###.###.#.#.###############.#.#.###.#
...#.#.#.#.#...#.........#...#...#.#...#.....#.#.....#...#.#...#
####.###.#.#.###.###############.#.#.#####.#.#.#.#.#######.#.#.#
...#...#.#.#.......#...........#.#.#.......#.#...#.........#.#.#
.#.###.#.#.#.#######.#######.#.#.#.#########.#######.#######.###
.#.....#.#.#...#.........#...#.#...#.#.....#.......#.......#...#
.#######.#.#####.#######.#.###.#####.#.#.#########.#.#####.###.#
.........#...#...#.#...#.#.#.....#.....#...#.......#.#.......#.#
.###########.#.###.#.#.###.#####.#.#######.#.#######.#.#.#####.#
.#.......#...#.#...#.#...#...#...#.#.....#.#.#.....#.#.#.#.....#
.#######.#.#.#.#.###.###.###.#.###.#.###.#.#.###.#.###.#.#.###.#
.....#...#.#.#...#...#.#.....#.#...#...#.#.#.....#.#...#.#.#...#
####.#.###.#####.#.###.#######.#.#####.#.#.#######.#.###.#.#####
...#.#...#.....#.#...#.......#.#.#.....#.......#...#...#.#.....#
.###.###.#####.#.###.#######.#.#.#.#####.#######.#####.#.#####.#
.....#...#.....#...#.#.....#...#.#.#.....#.....#...#...#...#S#.#
.#####.#.#.#######.#.#.###.#.###.#.#####.#.###.###.#.#####.#.#.#
.......#.#.........#...#.#.#.#...#.#...#.#.#...#...#...#.#.#...#
########.###############.#.#.#.###.#.#.#.#.#.#.#.#####.#.#.#####
.......#.#.......#.......#.#.#.#.#...#.#.#.#.#.#.......#.#...#.#
.#####.#.###.#.###.#.###.#.###.#.#####.###.#.#.#########.###.#.#
.....#.#...#.#.#...#...#.#...#.#.....#.....#.#...#.....#...#...#
.#####.###.#.###.#####.#.###.#.#.###########.###.#.###.#.#.###.#
G#.....#.#.#.......#...#.#...#.#.........#...#.....#...#.#...#.#
##.###.#.#.#######.#.#####.###.#.#######.#.#########.###.#.###.#
...#...#.#.....#...#...#...#...#...#.#...#.....#.#...#...#.#...#
.###.###.#####.###.###.#.###.#####.#.#.#.#####.#.#.###.#####.###
.#.#.....#...#...#.#.#.#...#.#.....#.#.#.#.....#...#...#.....#.#
.#.#####.#.#.###.#.#.#.###.#.#.#####.#.###.#####.###.#.#.#####.#
.#.........#...#.#...#...#...#.#.....#...#...#.......#.#...#...#
.#######.#######.###.###.#####.#.###.###.###.#############.###.#
.#.....#.#.....#.#...#.......#.#...#...#...#.#.......#...#.#...#
.#.###.#.#.###.#.#.###.#####.#.#.###.#####.#.#.#####.#.#.#.#.###
...#...#.#...#...#.#...#...#.#.#.#...#.....#...#...#...#.#.#...#
.###.#######.#####.#.###.#.###.###.###.###.#####.#.#####.#.###.#
.#.#.........#.#...#.....#.........#...#...#.....#.#.....#.#...#
.#.###########.#.###################.###.###.#.#####.#####.#.#.#
.#.........#...........#.....#.......#.#.#...#.#.....#...#...#.#
.#.#####.###.#########.#.###.#.#######.#.#####.#.#####.#.#####.#
.#.#...#.....#.....#.....#...#.....#.#...#...#.#...#...#.......#
.###.#.#.#####.###.#.#############.#.#.###.#.#.###.#.###########
.....#.#.....#.#.#.#.#...#.......#.#...#...#.#.#...#.#.....#...#
######.#######.#.#.###.#.#.#####.#.#.###.###.#.#.###.###.#.#.#.#
...............#.......#...#.......#.....#.....#.........#...#.#
################################################################
