32
.....#.......#.....#...#.....#.#
.#.###.#.###.#.#.###.#.#.###.#.#
.#.....#.#...#.#.#...#.#.#.#.#.#
.#######.#.###.#.#.###.#.#.#.#.#
.#...#...#.#...#...#...#.#...#.#
.###.#.#####.#######.###.#.###.#
...#.#.#.....#...#S..#...#.#...#
##.#.#.#.#####.#######.###.#.#.#
.#.#.#...#.....#...#.....#...#.#
.#.#.#####.#####.#.#.###.#####.#
...#.........#...#.#.#...#.....#
.#######.###.#.###.#.#.###.#####
.......#.#.#.#...#...#.#.#.#...#
######.#.#.#.###.#####.#.#.###.#
.......#...#.....#.....#.....#.#
.#############.###.#########.#.#
...#.........#...#.........#...#
##.#.###.###.#######.#####.###.#
.#.#.#...#.#.......#.#...#...#.#
.#.###.###.#######.#.#.#.###.#.#
...#...#...#.....#.#.#.#...#.#.#
.###.###.#.#.#.#.#.#.###.#.#.###
.#...#...#.#.#.#.#.#...#.#.#...#
.#.#.#####.#.#.#.#.###.#.#####.#
.#.#.....#.#.#.#.#...#...#...#.#
.#.#####.#.#.#.#####.###.#.#.#.#
.#...#...#...#.....#...#.#.#...#
.#####.#########.#.###.###.###.#
......G#.........#.#...#...#.#.#
########.###########.###.###.#.#
.........................#.....#
################################
