8
.#....G#
.#.###.#
...#...#
.###.#.#
...#.#.#
##.#.#.#
...#S#.#
########
