32
.......#.......#...............#
##.###.#.#####.#.###.#.#########
...#...#.#...#.#...#.#.#.......#
.###.###.#.#.#.#####.###.#####.#
...#...#.#.#.#.....#.....#...#.#
.#.###.#.#.#######.#.#####.#.#.#
.#...#...#.......#.#...#...#.#.#
####.#####.###.###.###.#.###.#.#
.....#...#.#...#...#...#.#.....#
.#####.#.#.#.###.###.###.#####.#
.#...#.#...#.....#...#.#.#...#.#
.###.#.###########.###.#.#.#.#.#
...#...#G......#.....#.#...#.#.#
.#.###.#####.#.#####.#.#####.#.#
.#...#.......#.....#...#...#.#.#
.###.#############.#.###.#.#.#.#
.#...#...#...#...#.#.#...#.#.#.#
.#.###.#.###.#.#.#.###.###.#.#.#
.#.....#...#...#.......#.#...#.#
.#####.###.#############.#####.#
.#...#.#...#.......#...........#
.#.#.###.#.#.#####.#.#####.#####
.#.#.....#.#...#...#.#...#.....#
.#.#######.###.#.#####.#.#####.#
.#...#.#...#...#...#...#...#...#
.###.#.#.###.#####.#.#####.###.#
.#...#.....#.#...#...#...#..S#.#
.#.#########.###.#####.#.#####.#
.#.....#...#...#...#...#.#.....#
.#####.#.#.###.#.###.#.###.#####
.....#...#.....#.....#.........#
################################
