8
G......#
##.#.###
...#.#S#
.#.###.#
.#.#...#
.###.###
.......#
########
