8
......G#
.#####.#
...#.#.#
##.#.#.#
...#.#.#
.###.#.#
..S#...#
########
