16
.#....S#.......#
.#.#####.#####.#
.#.#.......#...#
.#.#.#####.#.###
.#.#...#...#.#.#
.#.#####.###.#.#
...#...#...#.#.#
.###.#.###.#.#.#
.....#...#.#.#.#
########.#.#.#.#
...#...#...#...#
.###.#.#######.#
.....#.........#
.###############
....G..........#
################
