16
...............#
.#############.#
...#....G....#.#
##.#.#######.#.#
...#.#.....#...#
####.#.###.###.#
.....#.#...#...#
.#####.#.###.###
...#...#.#...#.#
.#.###.#.#.###.#
.#...#.#.#.#...#
####.#.###.#.#.#
S#...#.#...#.#.#
.#.###.#.###.#.#
...#.........#.#
################
