32
.......#...................#...#
.#.###.###.#############.###.#.#
.#...#...#.....#.......#.#...#.#
.###.###.#######.#####.#.#.###.#
.#.#.#.........#.#.....#...#...#
.#.#.#########.#.#.#####.###.###
.#.#...#.....#...#.#...#.#G#...#
.#.###.#.###.#####.###.#.#.###.#
.....#.#.#.#.....#...#.#.#.#...#
.#####.#.#.#####.###.#.#.#.#.#.#
.#.....#.#.....#.....#.....#.#.#
.#.#####.#.###.#############.###
.#.#.....#.#...#.......#...#...#
.#.#####.###.#.#.###.#.#.#.#.#.#
.#.....#.....#.#...#.#...#.#.#.#
######.#######.###.#.#####.###.#
.....#...#.....#...#.....#.#...#
.###.###.#.#####.#######.#.#.#.#
.#.#.#...#...#.#.#.....#.#...#.#
.#.#.#.#####.#.#.###.###.#.#####
.#.....#.....#.......#...#.#...#
.#######.#############.#####.#.#
...#.....#...........#.....#.#.#
##.#.#####.#.#######.#.###.#.#.#
...#...#...#.#.....#.#.#.#...#.#
.#####.#####.#####.#.#.#.#####.#
.....#.....#.....#...#...#...#.#
####.#####.#.###.#.###.###.#.#.#
...#S#.#...#...#.#.#...#...#.#.#
.#.###.#.#######.#.#####.###.#.#
.#...............#.......#.....#
################################
