32
.#...#.......#.............#...#
.#.#.#.#####.#.###.#######.#.#.#
.#.#...#.....#.#.#...#...#...#.#
.#.#####.###.#.#.###.#.#.#####.#
.#.#.....#.#.#.#...#...#...#...#
.#.#.#####.#.#.###.#######.#.###
G#.#.#...#...#...#.#.......#...#
.#.#.#.#.#.#####.#.#.#########.#
.#.#.#.#...#...#...#...#.......#
.#.#.#######.#.###.###.###.#####
.#.#...#.....#.#...#.#...#...#.#
.#.###.#.#####.#.###.###.###.#.#
.#.#.#...#...#...#...#...#...#.#
.#.#.#####.#.#####.###.###.###.#
.#.......#.#.#.......#.#.......#
.#######.#.#.#.#####.#.#######.#
...#...#...#.#.#...#.#.......#.#
.###.#.#####.###.#.#.#######.###
.#...#.....#.#...#.....#...#...#
.#.#####.#.#.#.###.###.#.#####.#
...#.....#.#.#.#...#S#.#.....#.#
.###.#####.#.#.#####.#.###.###.#
.#.#...#...#...#.....#...#...#.#
.#.###.#######.#.#######.###.#.#
...#...#.......#.......#...#.#.#
##.#.#.#.#############.###.#.#.#
.#.#.#.#.#...........#.#.#.#.#.#
.#.#.###.#.#####.#.###.#.#.#.#.#
...#.#...#.#...#.#...#.#.....#.#
.###.#.#####.#.#####.#.#######.#
...#.........#.......#.........#
################################
