8
G......#
.#####.#
...#...#
####.###
.....#S#
.#####.#
.......#
########
