8
...#...#
.#.#.#.#
.#.#S#.#
.#.###.#
.#...#.#
.#####.#
G......#
########
