8
.....#S#
.#####.#
.#.....#
.#.#####
.#G..#.#
.###.#.#
.......#
########
