8
..G....#
.#.#####
.#.#...#
.#.#.#.#
.#.#.#S#
.#.#.###
.#.....#
########
