64
.....#...........#...........#.........#.#.........#.......#...#
.#####.#.#######.#######.###.###.#####.#.#.#.#.#####.#.###.#.#.#
.#.....#...#.............#...#...#.......#.#.#.#.....#...#...#.#
.#.#######.###############.###.###########.#.###.#######.#####.#
.#...#...#.#.........#.....#.........#...#.#.....#.#.....#.....#
.###.#.###.#.#######.#.###########.#.#.#.#.#######.#.#####.#####
...#...#...#...#...#.#.#...#.....#.#...#...........#...#.#...#.#
.###.###.###.###.#.#.#.#.#.#.###.#.###########.#######.#.###.#.#
.....#...#...#...#...#...#...#...#.#...#.....#.#.....#.#...#.#.#
.#####.###.###.###############.###.#.#.#.###.###.###.#.#.###.#.#
.....#...#...#...#...#...#.....#...#.#...#...#...#.#.#.#...#.#.#
####.###.###.###.#.#.#.###.#########.#####.###.###.#.#.###.#.#.#
...#.#.#...#.#...#.#...#...........#.#...#.....#...#.#...#.....#
.#.#.#.#.###.#.###.###.#.#########.#.#.#.#######.#.#.#.#.#####.#
.#.#.#.#.#...#.#.....#.#.#...#...#.#.#.#.....#...#.#.#.#.....#.#
.###.#.#.#.###.###.#.###.#.#.###.#.#.#.#####.#.###.#.###.###.#.#
...#.#.#.#.#.#...#.#.#...#.#...#.....#.#.#...#.#.#.#...#.#...#.#
.#.#.#.#.#.#.###.#.#.#.###.###.#.#####.#.#.###.#.#.###.#.#.#####
.#.....#.....#...#.#...#.#.#.#.#.#..S#.#.#...#...#...#.#.#.....#
.#############.###.#####.#.#.#.###.###.#.###.#.#####.#.#.#####.#
.#.....#.......#.#.#.....#...#.....#...#.....#.#.....#.#.#.....#
.#.###.#.#######.#.#.#.#####.#######.###.#####.#.#####.###.###.#
.#.#.#...#.......#.#.#.....#.#.#...#...#...#.#.#.#...#.....#...#
##.#.#####.#####.#.#######.#.#.#.#.#.#.###.#.#.#.#.#.#######.###
...#.........#.#.#.........#.#.#.#.#.#.#...#...#...#.......#...#
.###.#######.#.#.#########.#.#.#.#.#.#.#.#######.###.#.#######.#
.#.#...#.#...#.#...#.......#.#...#...#.#.#.....#.#...#.#.......#
.#.###.#.#.###.###.#.#######.#########.#.#.###.#.#.#####.#######
.#.......#.#.......#.#.....#...........#...#.#.#.#.......#.....#
.#######.#.#########.###.###################.#.#.#########.###.#
.#...#...#.....#...#...#.........#.........#.#.#.........#.#.#.#
.#.#.#####.###.#.#.###.###.#####.#.###.###.#.#.#########.#.#.#.#
...#.....#...#...#.......#.#...#.#.#...#.....#.....#.#...#.#...#
########.###############.#.#.#.#.#.#.#############.#.#.###.#.###
.....#.#.........#...#.....#.#...#.#.#.......#...#.#.#.....#...#
.###.#.#####.###.#.#.#####.#######.#.#.#####.#.#.#.#.#########.#
...#...#...#.#...#.#.#...#.#...#...#...#...#...#...#.#.......#.#
##.###.#.#.###.###.#.#.#.#.#.#.#.#########.#########.#.###.#.#.#
...#...#.#.#...#...#...#.#.#.#...#.#...............#.#.#...#.#.#
.#.#####.#.#.###.#####.#.###.#####.#.#.###########.#.#.#.###.#.#
.#.#...#.#.#.#...#...#.#.#...#.......#.....#...#...#.#.#...#.#.#
.#.#.#.#.#.#.#.###.#.###.#.###############.#.#.#.###.#.###.###.#
.#.#.#...#...#.#...#.....#.#.........#.....#.#...#...#.#.#...#.#
.#.#.#######.#.#.###.#####.#.#######.#.#####.#####.###.#.###.#.#
.#.#.......#.#.#.#...#.....#.......#...#...#.......#...#...#.#.#
.#########.###.#.#####.#####.#####.#####.#.#.#######.#####.#.#.#
.........#.....#.......#.....#.....#.....#...#...#...#.....#...#
.#######.#####################.###.#########.#.#.#.###.#########
...#...#.....#.................#...#.......#.#.#...#.....#.....#
.###.#.#.###.#.#########.###.#######.#####.###.#####.###.#.###.#
.#...#.#...#.#...#.....#...#.#.......#...#...#.#.......#...#.#.#
.#.###.###.#.###.#.###.###.###.#########.###.#.#######.#####.#.#
.#...#.....#...#.#...#...#...#...#.......#.#...#.....#.......#.#
.###.###.#######.#####.#.###.###.#.#####.#.#####.###.#.#######.#
...#...#.#.....#.......#.#.#.....#...#.#.#.......#.#.#.#.......#
##.###.#.#.###.#########.#.#########.#.#.###.#####.#.###.#####.#
.#.#.#.#.#.#.........#...#...#.......#.#.#...#.....#...#.....#G#
.#.#.#.###.#.#######.#.###.#.#.#######.#.#.#######.###.#.###.###
.#...#.....#.......#.#.....#.#...#.....#.#.#.....#...#.#...#...#
.###.#############.#########.###.#.#####.#.###.#.#.#.#.#######.#
...#...#.........#.........#...#.#...#...#...#.#...#.#.#...#...#
.#.###.#.#######.#####.#######.#.#.#.#.#####.#.#######.#.#.#.#.#
.#.......#...........#...........#.#.........#...........#...#.#
################################################################
