64
...........#...#...#.......#...........#.....#.................#
##.#######.#.#.#.###.#.#####.#######.#.#.#.###.#####.#.#########
...#.....#...#.#.#...#.......#.......#...#.#...#...#.#.#...#...#
.###.###.#####.#.#.###########.#############.###.#.#.###.#.#.#.#
.....#.#...#.#.#.#.#...#...#...#.....#.......#...#.#...#.#...#.#
.#####.###.#.#.#.#.#.#.#.###.###.###.#.#######.#######.#.#####.#
.#.......#.#.#.#...#.#.#...#.#...#.#...#.....#.#.....#.......#.#
.###.#####.#.#.###.#.#.###.#.#.###.#####.###.#.#.###.#########.#
.....#.....#.#...#.#.#.#...#.#...#.......#.#.#.#.#.#.....#.....#
######.#####.###.#.#.#.#.###.###.#######.#.#.#.#.#.#####.#.###.#
.......#...#.....#.#.#...#...#...#.......#.#.#.#.#.......#.#...#
.###.#####.#.#####.#.###.#.###.###.#######.#.#.#.###.#####.#.###
...#.#...#.#.#.......#.#.#.#...#...#.......#...#...#...#...#.#.#
.#.###.#.#.#.#########.#.#.#.###.#####.###.###.###.###.###.#.#.#
.#.....#.#.#.....#.....#.#...#...#...#.#.#.......#.#.#.....#.#.#
########.#.#####.###.###.#####.#.#.#.#.#.#########.#.#######.#.#
.....#...#.....#...#...........#.#.#.#.......#.....#.....#...#.#
.###.#.###.#######.#.#############.#.#######.#.#####.###.#.###.#
.#.....#...#.......#.#.............#...#...#.#.#.....#.#...#...#
.#######.#.#.#######.#.###############.#.#.###.#####.#.#######.#
.......#.#...#.#.....#.#...#.........#...#...#.....#...........#
######.#####.#.#.#####.#.#.#.#######.#######.#####.###########.#
...#...#...#.#.......#.#.#.#.#.....#...#...........#...#.......#
.#.#.###.#.#.#######.#.#.#.#.#.###.###.###.#####.###.#.#.#######
.#...#...#.#.....#...#.#.#...#.#.....#...#.#...#.#...#.#.#.....#
.###.#.###.#####.#####.#.#######.###.###.#.#.#.###.###.#.#.#####
.#...#.#.#...#...#.....#.#.......#.....#.#.#.#.#...#...#...#...#
.#####.#.###.#.###.###.#.#.#######.#####.###.#.#.###.###.###.#.#
.........#...#.#.....#.#...#.#...#.#...#.....#.....#...#.#...#.#
.#########.###.#.###.#.#####.#.#.#.#.#.#.#############.###.###.#
.#...#.....#...#.#...#...#.....#...#.#.#.#.......#.....#...#...#
.#.#.#.#####.###.#.#####.#.#########.#.###.#####.#.#.###.#####.#
.#.#.#.#...#...#.#.....#.#.#.......#.#.....#.......#.#...#...#.#
.#.###.#.#####.#######.#.#.###.#.###.###.#########.###.###.#.#.#
.#.#...#.......#.......#.#...#.#.#...#...#.....#...#...#...#S#.#
.#.#.###.#######.#######.###.###.#.###.###.###.#.###.#.#.#####.#
...#.#...........#.....#...#...#.#.#.....#.#...#.#...#.#.#.#...#
##.#.###.#########.#.#####.###.#.#.#.#####.#.###.#.#####.#.#.###
...#...#.#.....#...#.....#.#.#...#.#...#...#.#.#.#.......#.#...#
.#####.###.###.#.#####.###.#.###.#.#####.###.#.#.#########.###.#
...#...#...#.#.#.#...#.....#.#...#.....#...#.#...........#...#.#
.###.###.###.#.#.###.#######.#.#######.###.#.###########.#.###.#
.#...#...#...#.#.............#...#...#.....#.....#.......#.#...#
.#.###.#####.#.#########.#######.#.#############.#.#######.#.###
.#.....#.....#.....#...#.#.....#.#.....#.......#.#...#...#.#.#.#
.#######.###.#####.#.#.###.###.#.#.#.###.#.###.#.###.#.#.#.#.#.#
.....#...#.......#.#.#...#.#.#...#.#.....#...#.#.#.....#.#.#.#.#
####.#.###########.#.###.#.#.#########.#####.###.#######.#.#.#.#
...#.#.#.........#.#.#...#...........#.....#.#...#...#.#...#...#
.###.#.#.#######.#.#.#.#.###########.#####.#.#.###.#.#.###.###.#
.....#.#...#.#...#...#.#.....#...#.#.....#.#.#.....#.#.......#.#
.#####.###.#.#.#####.#.#####.#.#.#.#####.###.#######.#########.#
.........#.#.......#.#.#...#...#.......#.#.....#...#.#.......#.#
########.#.#######.###.#.#.#########.###.#.###.#.#.#.#.#####.#.#
...#.....#...#.........#.#.....#...#.#...#.#...#.#...#.#...#...#
.#.#.#######.#################.#.#.#.#.###.#####.#####.#.#.#####
.#.#...#...#...#...........#...#.#...#.#.......#.....#.#.#...#.#
.#####.#.#####.#.#########.#.###.#####.#######.#####.#.###.#.#.#
.#...#.#.....#.#G#.....#.#.#.......#.#...#...#.....#.#...#.#...#
.#.#.#.#.#.#.#.#.###.#.#.#.#######.#.###.#.#.#.#.###.###.#.###.#
.#.#.#.#.#.#.#...#...#...#.#...#.....#...#.#.#.#.#...#...#.#...#
.#.#.#.###.#.#####.#####.#.#.#.#######.###.#.###.#.###.###.#.###
...#.......#.......#.....#...#.............#.....#.........#...#
################################################################
