64
.....#...........#.........#...............#.#.........#.......#
.###.#.#####.###.#.#######.#.###.#########.#.#.###.#####.#.###.#
...#.#.#.....#...#.....#...#.#.#.....#...#...#.#...#.....#.#.#.#
.#.#.###.#####.#######.#.#.#.#.#####.#.#.###.#.#.#.#.#####.#.#.#
.#.#...#.#.#.....#...#.#.#.#.#.....#...#.#...#.#.#.#...#...#.#.#
.#.###.#.#.#.#####.#.#.#.###.#.#.#######.#####.#.#####.#.###.#.#
.#...#.#.#.#...#...#...#.....#.#.......#...#...#...#...#...#...#
.###.#.#.#.###.#.###############.#####.###.#.#####.#.#####.###.#
.#...#...#.#...#.#.....#.......#.....#...#.#.#.#...#...#.#...#.#
.#.#######.#.###.#.###.#.#####.#######.#.#.#.#.#.#####.#.###.#.#
.#...#.......#...#...#...#...#.#.....#.#.#.....#.#.....#...#.#.#
####.#.#######.###.#.#######.#.#.###.#.#.#######.#.#####.###.#.#
.....#.#...#...#...#.#.......#...#.#...#.#...#...#.#.....#...#.#
.#####.#.#.#.#######.#.###.#######.#####.#.#.#.###.#.#####.###.#
.#...#.#.#.#.....#...#.#...#...........#...#.#...#...#...#.#...#
.#.###.#.#.#####.#.###.###.#.#######.#######.###.#.###.#.#.#.###
.#...#...#.#...#.#.#.....#.#...#...#.........#...#.#...#...#...#
.###.###.###.#.#.#.#.###.#####.###.###########.#.#.#.#.#########
...#.#...#...#.#...#...#.......#...#.........#.#.#.#.#.#...#...#
.#.#.#.###.###.#######.#########.###.###.###.#.###.#.###.#.#.#.#
.#.#...#...#...#.....#.....#...#.....#.#...#.#.#...#.#...#.#.#.#
.#.#.###.###.#.#.#########.###.#.#####.###.#.#.#.###.#.###.#.#.#
.#.#...#.#...#.#...#.......#...#.#.....#...#.#.#...#...#.#...#.#
.#.#.###.#.###.###.#.#######.###.#####.#.###.#.###.#####.#####.#
.#.#.#...#.#.#.#...#...#...#.#...#...#.#.#.#.#.#...#.......#...#
.#.###.###.#.#.#.#####.#.#.#.#.###.#.#.#.#.#.#.#.#####.#.###.#.#
.#...#...#.#.#.#.#.....#.#...#...#.#...#.#.#.#.#.....#.#.#...#.#
.###.###.#.#.#.#.#.#####.#######.#.###.#.#.#.#.#####.###.#.#####
...#.....#.#.....#.#...#.......#.#.#.#.#.#...#.....#...#.#.....#
##.#######.#.#####.###.#.#####.#.#.#.#.#.#########.###.#.#####.#
...#.....#.#.#...#...#...#...#.....#...#.....#.....#.#.#.....#.#
.###.###.#.#.#.#.###.#.#####.###########.###.#.###.#.#.#.#.###.#
.#.#.#.#.#.#.#.#.#...#.......#...#.....#.#.#.#...#...#.#.#...#.#
.#.#.#.#.#.#.#.#.#.#######.###.#.#.###.#.#.#.###.#####.###.#.#.#
.#.....#.#G#.#.#...#.....#.#...#...#.#.#...#...#.....#...#.#.#.#
.#.#####.#.###.#####.#####.#.#######.#.#####.#.#####.###.#.#.#.#
.#...#...#...#.#...........#.#.......#.......#.....#...#.#.#.#.#
.###.#.#.###.#.###.#########.###.#####.###########.#.###.###.#.#
.#.#.#.#...#.#...#.#.........#...#...#.#.......#...#...#...#.#.#
.#.#.#.#####.###.###.#########.###.#.#.#.#####.###.###.###.#.#.#
.#...#.#.......#...#.#.....#.....#.#...#.#...#...#.#...#.#.#.#.#
.#####.#.#########.#.#####.#.###.#.#####.#.#.###.#.#.#.#.#.#.#.#
.......#.........#.#.....#...#.#.#.#.#...#.#.#.#.#.#.#...#...#.#
######.#########.#.#####.#.###.#.#.#.#.###.#.#.#.###.#.###.###.#
...#...#...#.#...#.....#.#.#...#.....#.#...#.#.#.....#.#...#...#
.#.#.###.#.#.#.#######.#.#.###.#######.#.###.#.#######.#.###.###
.#.#.....#...#.....#.#.#.#...#...#...#.#.#.....#...#.#.#...#...#
.#.#.#####.#####.#.#.#.#.###.#.#.#.#.#.#.#####.#.#.#.#.###.###.#
.#...#...#.#.....#...#.#.#.....#.#.#...#.#...#...#...#...#.#...#
.#####.#.###.###.#####.#.#######.#.#####.#.#.###.#####.###.#.###
...#.#.#.#...#...#.....#...#.....#...#.....#.#...#.....#...#...#
##.#.#.#.#.#####.#.#####.#.#########.#####.#.#####.#####.#####.#
...#.#.#...#...#.#.#...#.#.#.......#.....#.#...#...#.....#...#.#
.###.#.#####.#.#.#.#.#.###.#.#####.#####.###.#.#.###.#####.###.#
.....#...#...#.#.#...#.....#.#...#.....#...#.#.#.#...#...#...#S#
##.#####.#.###.###########.#.###.#####.###.###.#.#.###.###.#.###
...#.....#.#...#.....#.....#...#.#...#.....#...#.#.#.......#...#
.###.###.#.#.###.#.###.#######.#.#.#.#######.###.#.#########.###
...#.#...#.#.....#.#.....#...#.#...#.............#.....#...#...#
##.#.#####.#######.#.#####.#.#.#####.#################.#.#.###.#
...#...#...#.....#.#.#.....#...#...#.#...#.......#...#.#.#.#...#
.#####.#.#######.#.#.#.#########.#.###.#.#.#####.#.#.#.#.#.#.#.#
.....#...........#...#...........#.....#.......#...#.....#...#.#
################################################################
