8
.......#
.###.#.#
.#...#.#
.#.#####
.#.#..S#
.#.#.###
G#.....#
########
