16
.#.......#...#.#
.#.###.#.#.#.#.#
...#...#.#.#...#
####.#####.###.#
.....#.....#.#.#
.#####.#####.#.#
...#S..#.....#.#
.#.#######.#.#.#
.#.........#.#.#
.#.#########.#.#
.#.#.....#...#.#
.#.#.###.#.###.#
.#.#...#...#...#
.#.#########.###
.#............G#
################
