16
.......#.......#
.#######.#####.#
.#...#...#.#...#
.#.#.#.###.#.###
...#..G....#...#
.#############.#
.....#...#.....#
####.#.#.#.###.#
...#.#.#...#...#
.#.#.#.#####.###
.#...#.#...#...#
######.#.#.###.#
.....#.#.#.#...#
.###.#.#.#.#.###
S#.....#.#.....#
################
