8
.....#.#
.###.#.#
.#G#...#
.#.###.#
.#.....#
.#######
......S#
########
