16
S#.........#...#
.###.#####.#.#.#
.#...#...#...#.#
.#.###.#.#####.#
.#...#.#.#.....#
.#.#.#.#.#######
.#.#...#.......#
.#.###########.#
.#.#.........#.#
.###.#######.#.#
...#.#...#...#.#
##.#.#.###.###.#
.#..G#.....#...#
.#####.#######.#
...............#
################
