8
..S#...#
.###.#.#
.#...#.#
.#.###.#
.#.#..G#
.#.#.###
...#...#
########
