32
.#...............#...#...#.....#
.#.#.###########.#.#.#.#.#.###.#
.#.#.#.....#.....#.#.#.#...#...#
.#.#.#.###.#.#####.#.#.#####.#.#
.#.#.....#.#...#...#.#.#.....#.#
.#.#######.###.###.#.###.#####.#
...#.......#.#.....#.....#.....#
.###.#######.#############.#####
.#.#.....#.....#.....#.....#...#
.#.#####.###.###.###.#.#####.###
.#.....#...#.#...#.#.....#.....#
.#.#######.#.#.###.#####.#.###.#
.#...#.....#...#...#..S#.#.#...#
.###.#.#####.###.###.###.#.#.#.#
.#...#.#.....#...#...#.#.#.#.#.#
.#.#.#.#.#######.#.###.#.###.#.#
...#.#.#.....#...#.#...#...#.#.#
######.#####.#.#.#.#.#.###.#.#.#
.......#...#.#.#.#.#.#.#...#.#.#
.#######.###.#.###.#.###.###.#.#
...#...#.......#...#...#.....#.#
.#.#.#.#.#######.#####.#######.#
.#...#.#...#.....#...#.#.......#
.#####.#.###.#####.#.#.#.#######
.#...#.#.#...#.#...#...#.#.....#
.###.#.###.###.#.#.#####.###.#.#
.....#.#...#.....#.#...#.#...#.#
####.#.#.###.#####.#.#.#.#.#####
.#...#.#...#.#...#...#...#.....#
.#.###.###.#.#.#.#############.#
....G#.....#...#...............#
################################
