16
.......#...#...#
.#####.#.#.###.#
.#.....#.#.#...#
##.#####.#.#.###
...#.....#.#...#
.###.#####.#.#.#
...#....S#.#.#.#
.#.#######.###.#
.#.......#...#.#
.#####.#.###.#.#
.#.#...#.#...#.#
.#.#.###.#.###.#
.#.#...#.#.#...#
.#.###.###.###.#
G....#.........#
################
