16
...#.....#...#.#
.###.#.###.#.#.#
.....#.....#S#.#
.#############.#
.#.......#.....#
.#.#####.#.###.#
.#.#...#...#...#
.###.#.#####.###
.....#.....#...#
##########.###.#
.........#.....#
.#######.#####.#
.#....G#.....#.#
.###.#.#####.#.#
.....#.....#...#
################
