8
.......#
.#####.#
.....#S#
####.###
...#.#.#
.###.#.#
G......#
########
