8
G......#
.#######
.#.....#
.#.###.#
.#..S#.#
.#####.#
.......#
########
