64
...#...........#...#.......................#.#.....#...........#
.#.#######.###.###.#.###.#################.#.#.#.#.#.###.#######
.#.......#.#.......#...#.........#.#.....#.#...#.#.#...#.......#
.#######.#.#########.###########.#.#.#.###.#####.###.#########.#
.#.........#.....#...#...........#...#.....#.....#...#.......#.#
.###.#######.###.#.###.###########.#########.#####.###.#####.#.#
...#.....#...#...#.#.#.......#...#.....#...........#...#.......#
##.#####.#.###.#.#.#.#######.#.#.#####.#############.#########.#
...#.....#...#.#.#.#...#.....#.#.....#...#.....#...#...#...#...#
.###########.#.###.#.###.#####.#########.#.###.#.#.###.#.#.#####
.....#.......#.....#...#.#...#...........#.#.#...#.....#.#.....#
.###.#.###############.#.#.#.#####.#######.#.###.#######.#####.#
.#...#.#...............#...#.....#.........#.....#.....#.#...#.#
##.#.#.#########.#.###########.#.###########.#####.###.#.#.#.#.#
...#.#.#.........#.#.........#.#.......#...#...#.#.#.#...#.#.#.#
.#####.#.#########.#.#######.#.#######.#.#.###.#.#.#.#######.#.#
.#.....#.#...#.....#.#S..#...#...#.#...#.#...#...#.#.......#.#.#
.#.#####.#.#.#.#####.###.#.#####.#.#.###.#.#####.#.#.#####.#.#.#
.#.#.....#.#.#.#.#...#.#.#.#.......#.#...#.....#.#...#...#...#.#
.#.###.###.###.#.#.###.#.#.#########.#######.#.#.#####.#.###.#.#
...#...#...#...#.#...#.#.#.#.......#.......#.#.#.#.....#...#.#.#
.###.###.#.#.###.###.#.#.#.#.#####.#####.#.#.###.#.###.#.###.#.#
...#.#...#.........#.#.#...#.#...#.#...#.#.#.....#.#.#.#.#...#.#
##.#.#.#############.#.#####.#.#.#.#.#.#.#.#######.#.#.###.###.#
.#.#.#.#...#.......#.#.......#.#.#...#.#.#.#...#.....#.....#...#
.#.#.#.#.#.#.#####.#.#.#######.#######.###.#.#.#.#######.###.###
.#...#.#.#.#...#.#...#.#...#.#.......#...#...#...#.....#...#...#
.#####.###.###.#.#####.#.#.#.#.#.###.###.#########.###.#######.#
.#...#.......#.#.....#...#.#...#...#...#.....#.....#.#...#.....#
.#.#.#######.#.###.#.###.#.#######.###.#####.#.#####.###.#.###.#
...#.......#.#.#...#...#.#.......#.#.....#...#.#...#.....#...#.#
####.#####.#.#.#.#####.#.#######.#.#####.#.###.###.#.#######.#.#
.....#...#.#.#...#.....#.......#.#.....#.#...#.#...#.#.......#.#
.###.#.#.###.#####.#####.#####.#.#.###.#####.#.#.###.#.#.#######
.#...#.#...#...#.#...#...#...#.#.#...#.....#...#...#.#.#.......#
.#####.###.###.#.###.#####.#.###.###.#####.#####.#.#.#.#######.#
...#...#...#.#.....#.....#.#.#...#...#.....#...#.#...#.#.....#.#
##.#.###.#.#.#####.#####.#.#.#.###.###.###.#.#.#.#####.#.#####.#
...#...#.#...#.....#.#...#.#...#.#.#...#.#...#.#.#...#...#.....#
.#####.#.#####.#####.#.###.#####.#.#.###.###.###.#.#####.#.###.#
.#.....#.#...#.#.....#.....#...#...#.#.......#...#.......#.#...#
.#.#####.#.#.#.#.#.###########.#.###.#.#######.###########.#####
...#...#...#.#.#.#.........#...#...#.#...#...#...........#.....#
.#####.#####.#.#.#####.###.#.#####.#.#####.#.###########.#####.#
...#.......#...#.....#.#.....#.....#.#...#.#...........#..G....#
##.#.#####.#########.#.###.###.#####.#.#.#.###.#######.#########
...#...#.#.#.......#.#...#.#...#.....#.#.#.#...#...#.#.#.......#
.#####.#.#.#.#####.#####.###.###.#####.#.#.#.###.#.#.#.#####.#.#
.#...#.#.....#...#.....#.#.....#...#...#...#.#...#...#.....#.#.#
.#.#.#.#######.#######.#.#.#######.#.#######.#.#####.#####.#.###
.#.#.#.......#...#.....#...#...#...#.#...#...#.#...#.#.....#...#
.#.#.#.#####.#.#.#.#####.###.#.#.###.#.#.#.###.###.#.#.#######.#
...#.#...#...#.#...#...#...#.#.#.....#.#.#.#...#...#.#.#.....#.#
####.#####.###.#####.###.###.#.###.#####.#.#.###.###.#.###.#.#.#
...#.#.....#.#.#.........#...#...#.......#.#.#.......#.....#...#
.#.#.#.#####.#.#.#########.#####.#######.#.#.#################.#
.#.#...#.....#.#...#.......#...#.......#.#.#.....#...........#.#
.#.#####.#####.#.###.#########.#######.###.#####.#.#######.#.#.#
.#.#...#.......#.#...#.........#.....#...#.#.....#.#.....#.#.#.#
.#.#.#.#.#########.###.#.#####.#.###.###.#.#.#####.###.#.#.###.#
.#...#...#.......#...#.#.#...#.#...#...#...#...#...#...#.#.#...#
.###########.###.###.#.###.#.#####.#.#######.#.#.###.###.#.#.###
.............#.......#.....#.......#.........#.......#...#.....#
################################################################
