8
.....#.#
.#.#.#.#
G#.#.#.#
.#.#.#.#
.#.#...#
.#.###.#
.#..S#.#
########
