8
G......#
.#.#####
.#.#...#
.#.#.#.#
.#.#S#.#
.#.###.#
.#.....#
########
