64
.........#.....#.........#.......#.......#.......#...#.....#...#
.#########.###.#.###.#####.###.#.#####.#.#.#####.#.#.#.#.###.#.#
.........#...#.#.#...#.....#.#.#.......#.#.#...#...#...#.....#.#
.#######.###.#.#.#.###.#####.#.###########.###.###############.#
.#.#...#.....#...#...........#...................#.....#...#...#
.#.#.#.#########################.###############.###.#.###.#.#.#
.#...#.........#.....#.........#.....#.......#.#.....#...#.#.#.#
.###.#####.#.###.###.#.#######.#####.#.#####.#.#########.#.#.#.#
...#.#...#.#.#...#.#...#.....#.#...#.#.....#.#.#.......#...#.#.#
##.#.#.###.#.#.###.#########.#.#.#.#######.#.#.#.#.#.###.###.#.#
...#...#...#.#.....#.........#...#.....#...#.#...#.#.#...#...#.#
.###.###.###.#####.###.#############.###.###.#.###.###.###.###.#
...#.#...#.......#...#.........#...#.....#.#.#...#.....#...#...#
##.###.#########.###.#.#######.#.#.#######.#.###########.#####.#
....G..#.......#.#.#.#.......#...#.........#...#...#.....#...#.#
########.#####.#.#.#.#########.###########.###.#.#.#.#####.#.###
.........#...#.#.#.#.#...#...#...#...#.....#.#...#.#.#.....#...#
.#########.#.#.#.#.#.#.#.#.#.#####.#.#.###.#.#####.#.#.#######.#
.........#.#.#.#...#...#...#.......#...#.....#...#.#.#...#.....#
########.###.#.#########################.#####.#.#.#.###.#.###.#
.#.......#...#.............#.........#.#...#...#.#.#.....#...#.#
.#.#######.#.#########.#####.#.#####.#.#.###.###.#.#####.###.###
.#.#.#.....#...#.....#.....#.#.....#...#.#...#.#.#.....#.#.#...#
.#.#.#.###.###.#####.#####.#.#####.###.#.#.###.#.#####.#.#.###.#
.#.#.....#.#...........#...#...#.#.#...#.#.#...#.......#.....#.#
.#.#####.#.#########.###.#.###.#.#.#.###.#.###.###############.#
.#...#...#.....#...#.#...#...#...#.#...#.#...#.......#.......#.#
.###.#########.#.#.#.#.#######.###.#####.###.#####.###.#.###.#.#
...#...#...#...#.#.#.#...#.....#...#.....#.#.....#.....#.#.....#
.#####.#.#.#.#####.#.###.#.#####.###.#####.#####.#.#####.#####.#
.#...#...#...#.....#.#.#...#...#...#.#.#.....#.#.#.....#...#...#
.#.#.###########.#.#.#.#####.#####.#.#.#.#.#.#.#.###.#####.###.#
...#.............#.#.#...........#...#.#.#.#...#.#...#...#...#.#
.#######.#######.###.#.#######.#######.#.#.#####.#.###.#.###.#.#
.#...#.#.#.....#.#...#.#.....#.#.......#.#...#...#.#...#...#.#.#
.#.#.#.#.#.###.###.#####.###.#.#.#.#.###.###.#.###.#.#####.#.#.#
.#.#...#.#.#.#.....#.....#.#.#...#.#.#.....#.#.#...#.#.#...#.#.#
.#.###.#.#.#.#########.###.#.###.#.###.#####.#.#####.#.#.###.###
.#...#.#...#...........#...#...#.#...#.#...#.#...#...#.#.#.....#
.###.#######.###.#######.#####.#.###.#.#.#.#.###.#.###.#.###.#.#
...#...........#.#...#.........#...#...#.#.....#.#...#.....#.#.#
##.#.###########.###.#.#########.#######.#######.#.#.#####.###.#
.#.#.#.........#.#...#.#.........#.......#.......#.#...#.......#
.#.###.#######.#.#.#.#.###.#######.#####.#.###########.#########
.#.....#.....#...#.#.#...#...#.#...#.#...#.#.....#.....#.......#
.#######.###.#####.#.###.###.#.#.###.#.###.#.###.#.###.#.#####.#
.........#.........#.#.#.#.#...#.#.....#...#.#.#...#...#.#...#.#
####.#####.#########.#.#.#.###.#.#######.###.#.#.#######.#.#.#.#
...#.#.....#...#...#...#.#.#...#.....#S#.#...#...#.........#.#.#
.#.###.#####.###.#.#.###.#.#.#######.#.#.#.#######.#########.#.#
.#.#...#.....#...#.#.#...#.....#...#.#...#...........#...#.#.#.#
.#.#.###.#.###.###.#.#.###.#####.#.#.#####.#########.#.#.#.#.#.#
.#...#.#.#...#...#...#...#.#.....#...#.#...#...#...#.#.#.#...#.#
.#####.#.###.###.#######.#.#.#######.#.#.###.#.#.#.###.#.#####.#
.#...#...#.#...#.#.....#.#.#.#...#...#...#...#.#.#.#...#.......#
.#.###.###.#.###.#.###.#.#.#.#.###.###.###.###.#.#.#.#########.#
.#.#...#...#.#...#.#.#...#.#.#.......#.....#...#.#...#...#...#.#
.#.#.###.###.#.###.#.#######.#######.#######.###.#####.#.#.#.#.#
.#.......#...#...#...#.....#.......#.......#...#.#.....#...#.#.#
.#######.#.#####.###.#.###.#.#####.#######.#.###.#.#########.#.#
.....#...#.........#...#.#.#.....#.#...#...#.#...#.#.....#...#.#
.###.###################.#.#######.#.#.#.#####.###.#.###.#.###.#
...#...............................#.#.........#.....#...#.....#
################################################################
