64
.........#.............#.....#.............#...#...#.........#.#
.#.#.#####.#######.#.#.###.#.#.#.#########.#.#.#.###.###.###.#.#
.#.#.#.....#.#...#.#.#...#.#...#.#...#...#...#.#.......#...#...#
##.#.#.#####.#.#.#.#.###.#.#####.#.#.#.#######.#######.###.#####
...#.#.#.....#.#.#.#.#.#...#.....#.#.#.....#...#...#.....#.....#
.#####.###.###.#.#.#.#.#####.#####.#.#####.#.###.#.#####.#####.#
.....#.#...#...#.#.#.#.....#.#...#.#.#.....#.#...#.....#.#.....#
.###.#.#.###.###.###.#.###.#.#.#.#.#.#.###.#.###.#####.###.###.#
...#...#...#.#.......#.#.#.#.#.#.#.#S#.#...#.....#...#...#.#.#.#
##.#######.#.#########.#.#.#.#.#.#.###.###########.#####.#.#.#.#
.#.#.......#...#.....#...#.#.#.#.#...#.#...#.........#...#.#...#
.#.#.###.#.###.###.#####.#.#.#.#####.#.#.#.#.#######.#.###.#.###
...#...#.#...#...#...#...#...#.....#.#.#.#...#...#...#.....#...#
.#######.#######.###.#.#########.#.#.#.#.#####.#.#.#.#.#######.#
...#...#.#.......#...#.....#.....#.#.#.....#...#...#.#.#.....#.#
##.#.#.#.#.#######.#######.#.#######.#######.#.#####.#.#.###.#.#
...#.#...#.#.............#.#.....#...#.......#.#...#.#.#.#.#.#.#
.###.#.###.#####.#####.###.#####.#.###.#########.#.###.#.#.#.###
.#...#.#...#...#.....#.....#...#.#...#.#...#...#.#.....#.#.#...#
.#.#.###.#.#.#.###########.#.#.#.###.#.#.#.#.#.#.#######.#.###.#
.#.#.#...#.#.#.#.........#...#.....#.#...#...#.......#...#...#.#
.#.###.###.#.#.#.#######.#########.#.#######.#########.###.#.#.#
...#...#...#.#.#.#...#.#.........#.#.#.....#.#.......#...#.#...#
.###.#.#####.#.#.#.#.#.#########.#.#.#.###.#.#.#####.###.#.#####
.#...#.#.....#.#...#.#.........#.#.#.#.#...#.#.#...#.....#...#.#
##.###.#.#####.#####.#####.#####.###.#.#.#####.#.###########.#.#
...#.#.#...#.#.....#.....#.....#.....#.#.#.....#.....#.....#.#.#
.###.#.###.#.###.#######.#####.#######.#.###.###.###.#.###.#.#.#
.#.....#...#...#.......#.#...#.........#.....#.#...#.#.#...#.#.#
.###.###.###.#.#######.#.#.#.###.#############.#.###.#.#.###.#.#
...#.#...#...#.#.#...#.#...#.#...#.......#.......#...#.#.....#.#
##.#.#.###.###.#.#.#.#.#####.#.#########.#.#######.#.#.#######.#
...#.#.#.....#.#...#.#.....#.#.....#...#.....#.....#.#.#...#...#
.###.#.#.###.#.#####.#####.#.#.###.#.#.#######.#.#####.#.###.#.#
.#.#.#.#...#.#...........#...#...#.#.#...#.....#.#.....#.....#.#
.#.#.#.#.###.###########.#########.#.###.#.#.#####.###########.#
.#.#.#.#.#...#...#.....#.....#.....#...#.#.#.#...#.........#...#
.#.#.#.###.###.#.#.###.#####.#.#####.#.#.#.###.#.#########.#.###
.#...#.....#.#.#...#.......#.#.#.....#.#.#.....#.#.....#.#.#...#
.###.#######.#.#####.#####.#.#.#.#####.#.###.###.#.#.#.#.#.###.#
...#...#.....#...#.#.#...#.#...#.#.....#...#...#...#.#...#.#...#
.#.###.###.#.###.#.#.#.#.#######.#.#######.###.#####.#####.#.#.#
.#...#...#.#...#...#...#.......#.#.....#.#.#.....#...#.....#.#.#
.###.###.#.###.###.#########.#.#######.#.#.###.###.#.#.#####.###
.#...#G....#.#...#.#.....#...#.......#.#.#...#.#...#.#.#.......#
##.#########.#.###.#.#.#.#.#########.#.#.###.###.###.#.#.#####.#
...#.....#.....#...#.#.#.#.#.......#...#...#.....#...#.#.#.....#
.###.###.###.###.###.#.###.#.#####.#######.#.#####.###.###.#####
.#...#.#...#.#.#.#...#...#.#.#...#.#.....#...#...#.#.#...#.....#
.#.###.###.#.#.#.#######.#.#.#.###.#.###.#####.#.#.#.###.#.###.#
...#.....#.#...#.....#...#.#.#...#...#...#.....#.#.....#.#...#.#
.###.###.#.#########.#.###.#.###.#####.#.#.#####.#######.###.#.#
.#.....#.#.....#...#...#...#...#...#...#.#...#.#.....#...#...#.#
.#####.#.#####.#.#.###.#.#.###.#.#.#.###.###.#.#####.#.###.###.#
.#.....#...#.#...#...#.#.#...#.#.#.#.#.....#.#.....#.#.#...#...#
.#.#######.#.#####.###.#.#####.#.#.#.#######.###.#.#.#.#####.#.#
.#.#.#...#.#.....#.#...#...#...#.#.#.....#...#...#.#.#.....#.#.#
.#.#.#.#.#.###.###.#.#####.#.#####.#####.#.###.###.#.#####.#.###
.#.#...#...#...#...#.#...#.#.......#...#.#...#...#.#.....#.#...#
.#.###.#####.#.#.###.###.#.#######.###.#.###.###.#.#####.#.###.#
.#...#.#...#.#.#...#...#.#.......#...#.#...#.....#.#...#...#...#
.###.#.#.#.#.#.###.###.#.###.#######.#.###.#######.###.#####.#.#
.....#...#...#...#.........#.............#...................#.#
################################################################
