64
.........#.............#.......#.........#...................#.#
.#######.###########.#.###.###.#.#.###.###.#########.#######.#.#
...#...#.............#.#...#.#.#.#...#.#...#.#.....#.#.........#
##.###.###############.#.###.#.#.###.###.###.#.#.###.#########.#
...#...#.........#.....#...#...#.#.#...#.#.....#...#.#...#...#.#
.###.###.###.###.#.#######.#.###.#.###.#.###.#####.#.#.#.#.#.#.#
...#.......#.#...#.........#.#.......#.#...#.#...#.#...#...#.#.#
.#.#.#######.###.###########.#.#######.###.###.#.#.#########.#.#
.#.#...#...#...#.#.......#...#...#...#...#.....#...#.........#.#
##.###.#.#.###.###.###.###.#######.#.###.#########.#.#########.#
...#...#.#...#.......#...#.#.......#.#.......#.....#...#.......#
.#######.###.###########.#.###.#####.#.#####.#.#######.#.#######
.#.....#.#.#.......#...#.#.....#...#.#...#...#.....#...#.....#.#
.#.###.#.#.#######.#.#.#.#######.#.#.###.#######.###.#######.#.#
.#...#...#.......#.#.#.........#.#.#...#.#.......#...#.....#.#.#
.###.#####.###.#.#.#.###########.#.###.#.#.#######.#######.#.#.#
...#.#.....#...#.#.#...#...#.....#...#.#.....#.....#.......#.#.#
.###.#####.#.###.#.###.#.#.#.#######.#.#####.#.#####.#######.#.#
.#...#...#.#.#...#...#.#.#...#...#...#...#...#.#...#...#...#.#.#
.#.###.#.#.#.#.#####.#.#.#####.#.#.#####.#.###.#.#.###.#.#.#.#.#
.#.#...#.#.#.#.....#.#...#...#S#.#.#...#.#.#...#.#.....#.#...#.#
.#.###.#.###.###.###.#.###.#.###.#.#.#.#.###.###.#####.#.#####.#
.#.#...#.....#...#...#.#...#.#...#.#.#...#...#...#.....#.......#
.#.#.#########.###.###.###.#.#.###.#.#####.#####.#############.#
.#...#.....#.#.#.#...#.#...#.#.#...#.......#...#.#.........#...#
.#####.#.#.#.#.#.###.#.#.#####.#.#.#########.#.#.#.#######.#.###
.....#.#.#...#.....#.#...#.....#.#...........#...#.#.....#.....#
.###.###.###.#####.#.#####.#####.#.#######.#####.#.#####.#######
...#.....#.#...#...#.#...#.....#.#.......#.#...#.#.....#...#...#
##.#######.#.###.###.#.#.#####.#.#######.#.#.#.#######.#.#.#.#.#
...#.......#.#.....#...#.....#.#...#...#.#.#.#...#.......#.#.#.#
.#.#######.#.#.###########.#.#.#####.#.#.#.#.###.#.#####.###.#.#
.#.#.....#...#.#.#.........#.#.#.....#...#.#.#.#...#...#.#...#.#
.###.###.#####.#.#.#######.###.#.###.#######.#.#####.#.###.###.#
.......#.....#...#.#...#...#...#.#...#.....#.....#...#.....#...#
.#######.###.###.#.#.#.#.###.###.#####.###.#.#####.#########.###
...#...#...#.....#.#.#.#...#...#.#.......#...#.....#...#...#...#
.###.#.#.#####.###.#.#.###.###.#.#.###########.#####.#.#.#.###.#
.#...#.#.#...#.#...#.#...#...#.#.....#...#.....#.#...#...#...#.#
##.###.###.#.###.###.###.###.#.#####.#.#.#.#####.#.#.###.#####.#
...#.#.#...#.....#...#.....#.#.#...#.#.#...#...#...#.#.#.#.....#
.###.#.#.#########.###.#####.#.#.#.###.#####.#.#.###.#.#.#.#####
...#.#.#...#.....#...#.#.....#...#...#...#...#.#.#...#...#...#.#
##.#.#.###.#.#.#.#####.#.###########.###.#####.#.#.###.#####.#.#
...#.......#.#.#.#.....#.......#.....#...#.....#.#.#.......#.#.#
.#############.#.#.#####.#######.#####.###.#####.#.###.#####.#.#
.....#.........#...#...#.#.....#.#.......#.#.....#...#.#.....#.#
.###.#.#.###########.#.#.#.###.#.#######.#.#.#######.#.#.#####.#
.#...#.#.#.....#...#.#...#.#...#...#...#.#.#.#...#...#.#.#.....#
.#.###.###.###.#.#.#.#####.#.#####.#.#.#.#.#.###.#.#####.###.#.#
.#.#...#...#.#...#.#.#.#...#.....#...#...#...#...#.......#...#.#
.#.#.#.#.###.#####.#.#.#.#####.###########.###.###########.###.#
.#.#.#...........#.....#.#.....#...#...#...#...#...........#...#
.#.#######.#############.#.###.#.#.#.#.#.###.#.#.#####.#########
.#...#...#.#...#...#.....#.#.#.#.#...#.#.#.#.#...#...#.#.......#
.###.#.#.###.#.#.#.#.#####.#.#.#.#####.#.#.#.#####.#.#.#.#####.#
.#.#.#.#...#.#...#.#.#...#.#.#.#.#...#...#.....#...#.#...#.....#
.#.#.#.###.#.#####.#.###.#.#.#.#.###.###########.###.#####.###.#
...#...#...#...#.#...#...#.#...#.........#.......#...#...#.#...#
##.#####.#.###.#.#####.###.#############.#.#######.###.#.#.#.###
.#...#...#.#...#.....#.#...#.....#.....#.#...#...#.#...#.#.#G#.#
.###.#.#####.###.###.#.#.###.#.###.###.#.###.#.#.#.###.#.#.#.#.#
.....#...........#.....#.....#.......#.......#.#.......#...#...#
################################################################
