32
.............#.....#...........#
.#########.#.###.#.#######.#.#.#
.....#.....#.....#.#.....#.#G#.#
####.#.###########.#.###.#.#.###
.....#.#.........#...#...#.#...#
.#####.#.#############.###.###.#
...#...#.#.............#.#...#.#
##.#.###.#.#############.###.#.#
.#.#...#.....#...............#.#
.#.###.#####.#######.#########.#
.#.#.#...#.#.......#...#.......#
.#.#.###.#.#######.#.###.#####.#
.....#...#.....#.#.#.#...#...#.#
####.#.#####.#.#.#.###.###.###.#
...#.#.....#.#...#.....#.#.....#
.#.#######.#.###########.#.#####
.#.........#.......#...#...#...#
.###########.###.###.#.#.###.#.#
........S#...#.#.....#...#...#.#
##########.###.#############.#.#
.......#...#.................#.#
.#######.#############.#########
.#...#...#.....#.....#.#.......#
.#.#.#.###.#.#.#.###.#.#.#####.#
...#...#...#.#...#.#.#.#.....#.#
.###########.#####.#.#.###.###.#
.#...........#.#.....#.#...#...#
.#######.#####.#.#####.#.###.#.#
...#.....#...#...#.........#.#.#
##.#.#####.###.#############.#.#
.....#.......................#.#
################################
