16
...#.....#...#.#
.###.###.#.#.#.#
.#...#.#...#.#.#
.#.###.#####.#.#
.#.#...#.....#.#
.#.###.#.#####.#
.#S#...#.#.....#
.###.###.#.#.#.#
...#.#...#.#.#.#
.#.#.#.###.#.#.#
.#...#...#.#.#.#
.###.###.#.#.#.#
.#...#...#.#.#G#
.#####.#####.#.#
.............#.#
################
