16
...#...#.......#
.#.#.#.#.#####.#
.#...#...#....G#
.###############
...............#
.#############.#
.......#.......#
.#######.#######
.#.....#.#.....#
.#.###.#.#####.#
.#.#S#...#...#.#
.#.#.#####.#.#.#
.#...#.....#...#
.#######.#####.#
.........#.....#
################
