8
....G#.#
.#.#.#.#
.#.#...#
##.###.#
S#.#.#.#
.#.#.#.#
...#...#
########
