16
.....#....G....#
.###.#.#######.#
...#...#...#.#.#
.#.###.#.#.#.#.#
.#...#.#.#.#...#
.###.###.#.###.#
.#...#...#...#.#
##.#.#.#####.#.#
...#.#.#.#...#.#
.#####.#.#.#####
.#.......#.....#
.#.###########.#
.#...#S..#...#.#
.###.###.#.#.#.#
.......#...#...#
################
