64
.......#...#.................#.....#.#.................#.......#
.#######.#.#.#.#####.#######.#.#.#.#.#.###########.###.#.#####.#
.........#...#.#.....#...#...#.#.#.#.#.#.........#.#...#.#...#.#
.#############.#.#####.#.###.###.#.#.#.#######.#.#.#####.#.#.#.#
.#.......#.....#.#.....#...#.....#.#.#.........#.#.#.......#.#.#
.###.#.#.#.#######.#######.#######.#.###########.#.#.#########.#
...#.#.#.#...#.....#...#...#.#...#.#.......#.....#.#.#...#...#.#
##.#.#.#####.#.#####.#.#.###.#.#.#.###.###.#.#####.#.#.#.#.#.#.#
.#.#.#.....#.#.....#.#.#...#...#.....#.#...#...#.#.....#.#.#.#.#
.#.###.###.#.#####.###.###.###.#####.###.#.###.#.#####.###.#.#.#
.#...#...#.#.......#...#.#...#.#...#.....#.#...#.#...#.#...#...#
.###.#####.#######.#.#.#.###.###.#.#######.#.###.#.#.###.#.#####
...#...#.....#...#...#.....#...#.#...#.#...#...#.#.#.....#.#...#
.#####.#.#####.#.#######.#####.#.###.#.#.#####.#.#.#########.#.#
.#.......#.....#.......#.#...#.....#.#...#.....#.#.........#.#.#
.#.#######.###########.###.#.#####.#.#.###.#####.#########.#.#.#
.#...#...#.#.........#.....#G....#.#.#.#...#.......#...#...#.#.#
.###.#.#.#.#.#######.###########.#.#.###.###.#.###.#.#.#.###.#.#
.....#.#...#.#.......#.......#...#.#.....#.#.#.#.#.#.#.#.....#.#
######.#####.#.#######.###.###.###.#######.#.#.#.#.#.#.#######.#
.....#...#...#.........#...#...#.#...#...#...#.#.#.#.#...#.....#
.###.#.#.#.#######.#####.###.###.###.#.#.#####.#.#.#.#####.###.#
.#...#.#.#.#.....#.#...#.....#...#.....#...#...#.#.#...#...#...#
.###.###.#.#.###.###.#.###.###.###.#######.#.###.#.###.#.###.###
...#...#.#.#...#...#.#...#.#...#...#...#.....#.........#.#...#.#
.#.###.#.#####.###.#.###.#.#.###.###.#.#.###############.###.#.#
.#...#.#.#.....#.#.....#.#.#.....#...#.#.#...#.........#...#...#
####.#.#.#.#####.#######.#.#######.###.#.#.#.#.#######.###.###.#
.....#...#.#.......#...#.#...#.....#.#.#.#.#...#...#...#...#...#
.#######.#.#.###.#.#.#.#.###.#.#####.#.#.#.#####.#.#.###.###.###
...#.....#.#...#.#.#.#...#.#...#...#...#.#.#.....#.#.....#.#...#
.#.#.#####.#####.###.#####.#######.#.#####.#.#####.#######.###.#
.#.#.....#.#.....#...#...#.........#.#.....#...#...#.#.....#...#
.#.#######.#.###.#.###.#.#.#########.#.#####.#.#.###.#.###.#.###
.#.......#...#...#.#...#...#...........#.#...#.#.....#...#.#.#.#
####.###.#####.###.#.#######.###########.#.###.#########.#.#.#.#
...#...#.....#.#...#.#.......#.......#.....#...#.........#.....#
.#.#######.#.#.#.###.#.#######.#####.#####.#.###.#############.#
.#.#.......#.#.#...#.#.....#...#...#.....#.#...#.#.....#...#...#
.#.#.#####.###.###.#.###.###.###.#.#####.#.###.#.#.#.###.#.#.###
.#...#...#.#.....#.#...#.#...#...#...#...#...#.#.#.#...#.#.#...#
.#####.#.###.#####.#.###.#.###.#######.#######.#.#.###.#.#.###.#
.#.....#.....#.....#.....#.#...#.....#...#...#.#.#.#...#.#...#.#
.#.###########.#####.#####.###.#.###.###.#.#.#.#.###.#.#.###.#.#
...#.........#.....#.#.....#...#.#...#.#...#.#.#.#...#.#...#.#.#
.###.#######.#####.###.#####.###.#.#.#.#####.#.#.#.###.###.#.###
...#.....#...#...#...#...#.......#.#...#...#.#.....#...#...#...#
##.#.###.#.###.#.###.###.#########.###.###.#.#########.#.#####.#
.#.#...#.#...#.#...#...#.........#.#.#.....#.........#.#.#...#.#
.#.#####.###.#.#####.###########.#.#.#####.#########.###.###.#.#
.#.......#.....#...#.#.....#.#...#.#.....#.......#.#.........#.#
.#########.#####.#.#.#.#.#.#.#.###.###.#########.#.###########.#
.....#...#.#.#...#...#.#.#...#...#.#...#.........#...#...#S..#.#
####.#.#.#.#.#.#.#####.#.#######.#.#.###.#########.#.#.#####.#.#
...#...#.#.#.#.#.#...#.#.......#...#.....#.........#.#.#.....#.#
.#.#####.#.#.#.###.#.#.#####.#######.#######.#######.#.#.#####.#
.#.......#.#.#...#.#.#.#...#.......#.#.......#.....#.#.#.#.....#
.#######.#.#.###.#.#.#.###.#######.#.#.#######.#.###.#.#.#.#.###
.#.......#...#.#...#.#.......#...#...#.....#...#.#...#.#.#.#...#
.###.#######.#.#####.#######.#.#.#####.###.#.###.#.###.#.#####.#
...#.......#...#...#...#.....#.#...#.....#.#...#.#.#...#...#...#
.#.###########.###.###.#.#######.#.#######.#.#.###.#.#.###.#.#.#
.#...................#...........#.........#.#.......#...#...#.#
################################################################
