16
.#..S#.........#
.#.#######.###.#
.#.........#.#.#
.###########.#.#
.#.........#...#
.#.#####.###.###
...#...#...#.#.#
.#####.###.#.#.#
.........#...#.#
########.#####.#
...#.....#.....#
.###.#########.#
.....#....G....#
.#########.###.#
...........#...#
################
