16
.........#.#...#
.#####.#.#.#.#.#
.#.#...#...#.#S#
.#.#.#######.###
.#.#.#.......#.#
.#.#.#.#######.#
...#.#.........#
####.#########.#
...#...#...#...#
.#.#.#.###.#.###
.#...#...#.#.#.#
.#######.#.#.#.#
...#...#...#.#.#
.#.#.#.#####.#.#
.#G..#.........#
################
