32
.#...#.........#...#.........#.#
.#.#.#.#######.#.#.#.#######.#.#
.#.#...#.#.....#.#S#...#.....#.#
.#.#####.#.#####.###.#.###.###.#
...#.....#.......#...#...#.....#
.#####.#.#########.#####.#####.#
.....#.#.....#...#.....#...#...#
####.#.#####.#.#.#####.###.#.###
.#...#...#...#.#.#...#...#.#...#
.#.#####.###.#.#.#.#.###.#.###.#
.#.#...#...#...#.#.#...#.#.#...#
.#.#.#.###.#####.#.###.###.#.###
...#.#...#.#...#.#.#...#...#.#.#
.###.###.#.###.#.#.#.###.###.#.#
.#...#.#...#...#...#...#.#.#...#
.#.###.#####.#.#######.#.#.###.#
...#.#.......#.#.....#...#.#...#
####.#.###.###.#.#.#######.#.###
...#...#...#...#.#.........#...#
.#.#.###.###.###.#########.###.#
.#...#...#...#.#.#.#.....#...#.#
.#####.###.###.#.#.#.###.###.#.#
...#...#...#...#...#.#.......#.#
##.#.#####.#.#.###.#.#########.#
.#.#.....#.#.#.....#.#.......#.#
.#.#####.#.#########.#.#####.#.#
.#G....#.#...........#...#.#...#
.#####.#.###.#######.###.#.#####
.......#.#...#.....#...#.#.....#
.#######.#####.###.#####.#.###.#
.......#.........#.........#...#
################################
