64
.#.........#.....................#...........#.....#...#.......#
.#.#######.#.#########.###########.#######.###.###.#.#.#.#####.#
.#...#.#...#.....#...#...........#...#...#...#.#.#...#.#.#...#.#
.###.#.#.#######.###.###########.###.#.#.###.#.#.#####.#.#.#.#.#
.....#.#.......#...#.........#.#.....#.#...#.....#...#.....#.#.#
.#####.###.#######.#####.###.#.#####.#.###.#######.#.#.#####.#.#
.....#.#...#.....#.......#.#.#.#...#.#...#...#.....#.#.#...#.#.#
####.#.#.###.###.#########.#.#.#.#.#.###.###.#.#####.#.#.#.###.#
.....#.#...#.#.#...............#.#.#...#.#.....#.#...#.#.#.....#
.#####.###.#.#.#################.#.###.#.#######.#.###.#.#####.#
...#.....#.#.#...........#...#...#.#...#.....#.....#...#.....#.#
##.#####.#.#.#.#########.#.#.#.###.#######.#.###.###.#######.###
.#.......#...#.#.........#.#...#...#.....#.#...#...#.....#.#...#
.#######.#######.#######.#.#######.#.###.#####.###.#####.#.###.#
.....#.#.#...#...#...#.#.#.#....S#.#.#.#.......#.#...#.......#.#
##.#.#.#.#.#.#.#.#.#.#.#.#.#.#####.#.#.#########.###.#####.###.#
...#...#...#...#.#.#.#...#...#...#.#.#.......#.....#...#.#.#...#
.#####.#########.#.#.###.#####.#.#.#.#######.#.###.###.#.#.#.#.#
.....#.....#.....#.#...#.#...#.#...#...#...#.#.#.#...#.#...#.#.#
####.###.###.#####.###.###.#.#.#####.#.#.#.#.#.#.#.###.#.###.###
.....#.#.#...#...#.#.#.#...#.#.#.....#.#.#.#...#.#.#...#...#...#
.#####.#.#.###.###.#.#.#.###.#.#.#####.#.#.###.#.#.#.#####.###.#
.#.......#.....#...#.#...#.#...#...#.#...#...#...#...#.....#...#
.#############.#.###.#####.#######.#.#######.#####.#########.###
.#...........#.#.............#...#...#.....#.#...#.....#...#...#
.#.#####.#####.#############.#.#.###.#.#.###.#.#.#####.#.#.###.#
.#...#.#.......#.........#...#.#.#...#.#...#...#...#.....#...#.#
.###.#.###########.#######.###.#.#.#######.#######.#########.#.#
.....#.............#...#...#...#.#.........#.....#...#.....#.#.#
.#########.#.#######.#.#.###.###.#########.#.###.###.#.###.#.#.#
...#.....#.#.......#.#.#.#...#...#...#.....#...#...#.#.#.#.#.#.#
##.#.###.#####.###.#.#.#.#.#####.#.#.#.#######.#.###.#.#.#.#.#.#
...#.#.#.#...#.#.#.#.#.#.#.#...#.#.#.#...#.....#.#...#.#...#...#
.###.#.#.#.#.#.#.#.#.#.#.#.#.#.#.#.#####.#.#.#####.###.#######.#
.#...#.#...#.#...#.#.#...#...#.#...#.....#.#.....#.#.....#...#.#
.#.###.#####.#.###.#.#######.#.#####.#####.#####.#.#.###.#.#.#.#
...#.......#.#.#...#.......#.#.#.....#...#.....#.#.#...#.#.#.#.#
####.#####.#.#.#.#########.###.#.#####.#.#####.#.#.#####.#.#.#.#
.....#.....#.#.#.#.......#...#.#.#.....#.......#.#.....#.#.#...#
.#.###.#####.#.#.#.#.###.###.#.#.#.#############.#####.#.#.#####
.#...#...#...#.#...#.#.....#.#.#.#.#...........#.....#.#...#...#
.###.#####.#########.#.#####.#.#.#.#.#.#######.#####.#.#.#####.#
...#.......#.......#.#.#.....#...#.#.#.#.....#.......#.#.#...#.#
##.###########.###.#.###.#####.#####.###.###.#########.#.#.#.#.#
.#.#...........#...#...#.#.#...#.....#...#...........#.#...#...#
.#.#######.#.###.#####.#.#.#.#####.#.#.#############.#.#######.#
.#.......#.#.#...#.....#.#...#.....#.#.....#.....#...#.....#.#.#
.#######.#.#.#.#####.#.#.###.#.###.#######.#####.#.###.###.#.#.#
.#...#...#.#.#...#...#.#...#...#.#.#.......#.....#.#.....#.#.#.#
.#.#.#.#####.###.#.#.#####.#####.#.#.#.#####.#####.#.#####.#.#.#
...#.#.#.....#.....#.#...#.....#...#.#.#...#.......#.#...#.#.#.#
.###.#.#.#.###########.#.#####.#.###.###.#.###.#######.#.#.#.#.#
...#.#.#.#...........#.#.....#.#...#.#...#...#.........#...#...#
.###.#.#######.#####.#.###.###.###.#.#.#####.#.###############.#
.#...#.......#.#...#.#...#...#.#.#.#.#.....#.#.#.............#.#
##.#########.#.#.#.#.###.###.#.#.#.#.#####.#.###.#########.#.#.#
...#..G....#.#.#.#.#...#...#...#...#.#.....#.......#.....#.#.#.#
.###.#####.#.#.#.#####.###.#########.#.#####.#####.#.###.###.#.#
...#.#...#...#...#.....#...#.......#...#...#.#...#.#.#.#...#.#.#
.#.#.#.#########.#.#.###.###.###.#.#####.#.#.#.#.###.#.###.#.#.#
.#...#.....#...#.#.#.#...#...#...#.......#.#.#.#.....#...#...#.#
.#######.#.#.#.###.#.#.#######.###########.###.#######.#######.#
.........#...#.....#.#.........#...............#...............#
################################################################
