64
.......#.....#.........#.............#...#.........#.....#.....#
.#####.#.###.#.#.#####.#######.#.###.#.#.#.###.#####.#.#.#.###.#
.#...#...#...#.#G#...........#.#.#.#.#.#.#...#.#...#.#.#...#.#.#
.###.#####.###.#.###########.#.#.#.#.#.#.###.###.#.#.#.#####.#.#
...#.....#.#...#...#...#...#.#.#.#...#.#...#.....#...#.....#...#
.#.###.###.#.#####.#.#.#.#.#.###.#.###.###.#########.#####.#.###
.#...#.....#.....#...#.#.#...#...#.#...#.......#...#.#.....#...#
####.#.#######.#######.#####.#.###.#.#########.#.#.#.#.#######.#
...#.#.#...#...#.....#.....#...#.#.#.......#.#.#.#.#.#.#.....#.#
.#.#.#.#.###.###.###.#####.#####.#.#######.#.#.#.#.###.#####.#.#
.#...#.#.....#.#.#...#.....#.......#...#...#.#.#.#...#.#.....#.#
.#####.#####.#.#.###.#.#########.###.#.#.###.#.#.###.#.#.###.#.#
.#.........#...#...#.#.#.......#.....#...#...#...#.#...#.#...#.#
.#########.#######.#.#.#.#####.###########.#.#####.#####.#####.#
.#...#...#.........#.#.......#.....#.....#.#.....#.....#.....#.#
.#.#.#.#############.#.###########.###.#.#.#####.#.###.#.###.#.#
...#.#.#.....#...#...#...#...#...#...#.#...#...#...#...#.#.#...#
.###.#.#.#.#.#.###.###.###.#.#.#.###.#.#####.#.###.#####.#.#####
...#.#.#.#.#.#.#...#.#.#...#...#.....#.....#.#.....#.....#.....#
##.#.#.#.#.#.#.#.###.#.#.#################.#.#######.#####.#####
...#.#.#.#.#...#.#.#...#...#.......#.......#.....#...#.........#
####.#.#.#.#####.#.#.#####.###.###.#.#.#########.#.###########.#
.....#.#.#...#...#...#...#...#.#...#.#...#.....#.#.#.......#...#
.#####.#.###.#.#######.#.###.#.#.###.###.#.###.#.#.#.#.###.#.#.#
.#.....#...#...#...#...#.....#.#.....#.#.#...#.#.#.#.#.#.....#.#
.###.#####.#####.#.#.###############.#.#.###.#.#.#.#.#.#######.#
...#.....#.......#...#...#.........#...#...#.#...#.#.#.#...#...#
##.#.###.#########.###.#.#.#######.#.#####.#######.#.#.#.#.###.#
...#...#...#.....#.#...#...#.......#.#.....#.......#.#...#...#.#
.#####.#.###.###.#.#.#######.#######.#.###.#.###############.#.#
.#.#...#.......#...#.......#.#...#...#...#.#.#...........#...#.#
.#.#.#########.#####.#######.#.#.#.#####.###.#.#########.#.#####
.#...#.....#.....#...#.......#.#.#...#.#.....#.#...#.....#.....#
.#####.###.#.#####.###.#######.#.###.#.#######.#.#.#.#####.###.#
.......#...#...#...#.#.......#.#...#.#.........#.#...#.......#.#
########.#######.###.#######.#.###.#.#########.#####.#########.#
.#.....#.........#.......#...#.#.#.......#.....#...#...#.......#
.#.###.###########.#######.###.#.#######.#.###.#.#.###.#.#.#####
.....#.#.....#.....#.....#.#.....#...#...#.#.#.#S#.#...#.#.#...#
.#####.#.###.#.#.###.###.#.#######.#.#.###.#.#.###.###.#.###.#.#
.#.....#.#.#...#...#...#.#.........#.#.....#.....#...#.#.....#.#
.#.#####.#.#######.###.#.#########.#.#######.#######.#.#####.#.#
.#...#...#...#.....#...#.....#...#.#.#...#.....#.....#.....#.#.#
####.#.###.#.#.#####.#######.#.#.###.#.#.#######.#########.###.#
.....#...#.#.#.......#...#...#.#.....#.#.........#.#.......#...#
.#.#####.#.#.#########.#.#.#.#.#####.#.###########.#.#######.###
.#.#.....#.#.....#.#...#...#.#.....#.#...#.#.......#.#...#.....#
.#.#.#######.#.#.#.#.#######.#####.#.###.#.#.#.###.#.#.###.###.#
.#.#.#.....#.#.#...#...#...#.#...#.#...#.#.#.#...#.#.#.....#...#
.#.#.###.#.###.#######.###.#.#.#.#.#####.#.#.###.#.#.###.###.###
.#.#.#...#...#.......#...#.....#.#.......#.#.#.#.#.#...#.#.#...#
.###.#.#####.#####.#.###.#################.#.#.#.#.###.#.#.###.#
...#.#.....#.......#...#...#...............#.#.#.#.#...#.....#.#
.#.#.#####.###########.###.#.#########.###.#.#.#.###.#######.#.#
.#.#.#.....#.......#...#.#.#.#...#...#.#...#.#.#.....#.#...#.#.#
.#.#.#.#####.#####.#.###.#.#.###.#.#.###.#.#.#.#######.#.#.#.#.#
.#...#.#.........#.......#.#.#...#.#.#...#.#.........#...#...#.#
.#####.#.#################.#.#.###.#.#.###.#########.#########.#
...#...#.#...#.............#.#...#.#.#.#.........#...#.......#.#
##.#.###.#.#.#.#############.###.#.#.#.#.#######.#.###.#####.#.#
.#.#.#...#.#.#...#.........#...#.#.#...#.#.....#.#.#...#...#...#
.#.#.#.###.#.###.#.#######.###.#.#.#######.###.###.###.#.#.###.#
.....#.....#...#.........#.......#...........#.........#.#.....#
################################################################
