64
.#.........#.....#.............#.......................#.......#
.#.###.###.###.#.#######.#.#####.#.#####.#############.#####.###
...#...#.......#.#.....#.#.#.....#...#...#.......#.....#...#...#
.###.###########.#.###.#.###.#######.#####.#####.#.#####.#.#.#.#
...#.....#.......#.#.#.#.#.....#...#.#.......#...#.......#.#.#.#
##.#####.#.#######.#.#.#.#.#####.#.#.#.#######.###########.###.#
.......#.#.#.......#...#...#.#...#...#...#...#.#.........#.#...#
.#######.#.###.#####.###.###.#.#####.#.###.#.#.#.#####.###.#.###
...#.....#.....#.....#.......#.#.....#.#...#...#...#...#...#...#
##.#.###########.#############.#######.#.#######.#.#####.#####.#
...#.#.........#.........#...#.........#.#G....#.#.....#...#...#
.###.#.#.#####.#########.#.#.###.#######.#.###.#.#####.###.#.###
.#.#.#.#...#.#...#...#.#...#...#.#.....#...#...#.....#...#.#...#
.#.#.###.#.#.###.#.#.#.#######.###.###.#####.#######.#.#.#.###.#
.#.#...#.#.#.......#.....#...#...#.#.#.#.....#.#...#.#.#.#...#.#
.#.###.#.#.#.###########.###.###.#.#.#.#.#####.#.#.#.#.#.###.#.#
...#...#.#.#.#...#.........#...#.#.#...#.#...#...#...#.#...#...#
##.#.#####.###.#.#########.###.#.#.#.###.###.#.#######.#######.#
...#.#.....#...#.#.......#.....#...#...#...#.....#.....#.......#
.###.###.###.###.#.#####.#############.#.#.#######.###.#.#######
.#...#...#...#.#.#...#.#.#...........#.#.#.#.......#.#.#.#.....#
##.###.###.###.#.###.#.#.#.#########.#.###.#.#######.#.#.#####.#
...#.#.....#...#.....#.#...#.#.......#...#.#.#.......#.#.......#
.###.#.#####.#.#######.#####.#.#########.#.#.#.#.#####.#######.#
...#...#.....#...#...#.......#...#.....#...#.#.#.............#.#
##.#.###.###.###.###.#.#####.###.#.#.#######.#################.#
...#...#.#...#.#...#...#...#...#...#...#.....#...#...........#.#
.#####.###.###.###.#.###.###.#.#######.#.#.###.#.#.#########.#.#
.....#.#...#.....#.#...#.#...#...#...#...#...#.#...#.......#.#.#
.###.#.#.#######.#.###.#.#.#####.#.#.#######.#.#####.#####.#.#.#
...#.#...#.......#.#.....#.....#.#.#.#.......#.#.......#...#.#.#
####.#####.#####.#.###########.#.###.#.#######.#.#####.#####.#.#
.....#.#...#.....#.........#...#.....#.#.....#.#...#...#...#...#
.#####.#.#.###############.#.#########.#.###.#.###.#.###.#.#####
.#...#...#.........#...#...#.#.......#...#...#.#...#...#.#.#...#
.###.#.#########.#.#.#.#.###.#.#####.#####.#.#.#.#####.#.#.#.#.#
...#.#.#.........#...#.#.#...#...#.#.....#.#.#.#.#...#...#...#.#
##.#.#.#.#########.#####.#.#####.#.#.#####.#.#.###.#.#########.#
...#...#.#...#.....#.....#.........#.#.....#.#.#...#.......#...#
.#######.#.#.#.#####.#####.#########.#.#####.#.#.#########.#.###
.#S....#...#.#.#.#...#.#...#...#.....#...#...#.#.#.......#.#...#
.#####.#####.#.#.#.###.#.###.#.#.#######.#.###.#.#.###.###.#.#.#
.....#.....#.#...#.#...#.....#.#.#.......#.#.#...#...#...#.#.#.#
####.#####.#.#.###.#.###.#######.#.#######.#.#######.###.#.###.#
...#.....#.#.#.#...#.....#...#...#.#.....#.#.....#.....#.#.#...#
.#######.#.#.#.#.#########.#.#.#.#.#.###.#.#.###.#.#####.#.#.###
.....#.#...#.#.#.........#.#...#.#.#...#...#...#.#.#.....#.#...#
##.#.#.#####.#.#########.#.###.###.###.#######.#.###.#####.#.#.#
...#.....#...#...#.......#.#...#...#.#.#.......#...#.#.....#.#.#
.#######.#.#.###.#.#######.###.#.###.#.#.#########.#.#.#######.#
...#...#.#.#...#.#...#.......#.#...#...#.#.......#...#.......#.#
.#.#.###.#####.#####.#######.#####.###.#.#.#####.###########.#.#
.#.#...#.....#.....#.......#.....#...#...#...#.#.........#...#.#
.#.###.#####.#.###.#######.###.#.###.###.###.#.#########.#.###.#
.#.#.....#...#.#.....#...#...#.#...#.#...#.#.#.........#...#...#
.#.#.#####.#####.#####.#.###.###.###.#.###.#.###.#####.#######.#
.#.#.............#.....#...#...#.#...#.....#...#...#.#.#.......#
.#.#############.#.#####.#.###.#.#.#######.###.###.#.#.###.###.#
.#.........#.....#.#...#.#...#.#.#.#...#...#...#...#...#...#...#
.#########.#.#####.#.#.#.###.#.#.#.#.#.###.#.###.###.###.#####.#
.#.....#.#.#.#...#.#.#.#.#...#.#.#.#.#...#.#.....#.#...#.....#.#
.###.#.#.#.###.#.#.###.#.#####.#.#.#.###.#########.###.#####.#.#
.....#...#.....#.......#.........#.....#.....................#.#
################################################################
