8
....G..#
.#####.#
.#...#.#
.###.#.#
S#...#.#
##.###.#
.......#
########
