8
...#...#
.#.#.#.#
.#S#.#.#
.###.###
...#...#
##.###.#
......G#
########
