8
.......#
.#####.#
G#...#.#
.#.#.#.#
.#.#...#
.#######
......S#
########
