8
...#...#
.#.#.#.#
.#.#S#.#
.#####.#
.#...#.#
.#.#.#.#
G..#...#
########
