64
.....#.........#.............#...........#.....................#
.#.###.#######.#.#######.#####.#####.###.#.#############.#####.#
.#.#...#.....#.........#...#...#...#...#.....#.....#...#.....#.#
##.#.#######.#########.###.#.###.#.###.#######.###.#.#.#.###.#.#
...#.#.....#...#...#.#.#...#.#...#...#.....#...#.#...#.#.#.#.#.#
.###.#.###.#.###.#.#.#.#.###.#.#####.#######.###.#####.#.#.#.#.#
...#.#.#.....#...#.#...#.....#...#.#...#...#...#.......#...#.#.#
.#.#.#.#######.###.#####.#######.#.###.#.#.###.#.###########.#.#
.#...#.....#...#...#...#...#...#.#.#.....#.....#...#.......#.#.#
.#######.#.#.###.###.#.###.###.#.#.#.#############.#.#####.#.#.#
.......#.#.#.#.#...#.#.#.......#.#.....#.....#.......#...#...#.#
######.###.#.#.###.#.#.#########.#####.#.###.#########.#######.#
...#...#...#.#.#...#.#.#...#...#.....#.#...#.#.....#.......#...#
##.#.###.###.#.#.###.#.#.#.#.#.#####.#.###.#.#.###.#####.#.#.###
...#.#...#...#.......#...#...#.#.....#...#.#...#.#.....#.#.....#
.#.#.###.#.#.#################.#.#########.#####.#####.#######.#
.#.#...#.#.#.#.....#...#.....#.#.#.........#.........#.......#.#
.#.###.#.#.#.#.###.#.#.#.###.#.#.#.#########.###############.#.#
.#...#...#.#.#.#.#.#.#.#...#.#.#...#.....#...#.............#.#.#
.#######.#.###.#.#.#.#.#.###.#.#.###.#.###.#.#.###########.#.###
.........#.......#.#.#...#...#.#...#.#.....#.#...#...#.#...#...#
##################.#####.#.#.#.###.#####.###.###.#.#.#.#.#####.#
.................#.....#.#.#.#.#.#.....#...#...#...#.#.#...#...#
.###############.#.###.#.#.###.#.#####.#######.#####.#.###.#.###
.#...#...........#...#.#.#...#.#.....#...#.......#.#.#...#.#...#
.#.###.###############.#####.#.#.###.###.#.#####.#.#.#.###.#.#.#
.#...#.#.........#...#.#...#...#.#...#...#.....#...#.#...#.#.#.#
.###.#.#####.###.#.#.#.#.#.#.#####.###.###.###.###.#.###.#.###.#
S#...#...#...#.#.#.#...#.#.#.....#.....#.....#...#.#...#.......#
##.#####.#.###.#.#.#####.#.#####.#####.#####.###.#.###.#######.#
.......#...#.....#.......#.#...#.....#.#...#.#...#...#.....#.#.#
.###.#######.#########.###.#.#.#####.#.#.#.###.#####.#####.#.#.#
...#.......#.#.......#.#.#.#.#.#.....#...#.#...#...#.#...#.#.#.#
.#######.#.#.###.###.#.#.#.#.###.#########.#.###.#.#.#.###.#.#.#
.#.......#.#.#...#...#...#.#.............#.#.#.#.#.....#...#...#
##.###.#####.#.###.#####.#.#############.#.#.#.#.#######.###.###
...#...#.....#.#.#.#...#.#.#.....#.....#.#.#.#...#...#...#...#.#
.#####.#.#####.#.#.#.#.#.#.#.###.#.#.###.#.#.###.#.#.#.#####.#.#
.....#.#.#...#.#...#.#...#...#...#.#.#...#.#...#...#.#.....#...#
.###.###.#.#.#.#.#############.#####.#.###.###.#########.#.#####
.#.#.....#.#...#...#...........#...#.#.#.#...#.#.......#.#.....#
.#.#######.#######.#.###########.#.#.#.#.###.#.#.#####.#.#####.#
...#.........#.....#...#.........#...#.#.......#.#.#...#.#.#...#
##.#.#######.###.#####.#.#.#######.###.#########.#.#.###.#.#.#.#
.#.#...#...#...#.#.....#.#.#.......#...#.........#...#.#.#.#.#.#
.#.#####.#.###.#.#.#####.#.#.#######.###.#.#######.###.#.#.#.###
.#.......#.....#.#.#.#...#.#.....#...#...#.#.....#.#.......#...#
.###############.#.#.#.###.#######.###.#.###.###.#.###.#######.#
.#.........#...#...#...#.#.#.....#.#.#.#...#...#.#...#.#.....#.#
.#.#.#####.###.#####.###.#.#.###.#.#.#.###.###.#.###.###.###.#.#
...#.....#...#...#...#...#...#...#.#.#...#...#.#.#.......#...#.#
.#######.###.#.#.#.###.#.#####.###.#.#.###.###.#.#.#######.###.#
.#.....#...#.#.#.#.....#...#...#...#...#...#...#.#...#...#.....#
.#.#######.#.#.#####.#######.###.###.###.###.###.#####.#.#####.#
.#.......#.#...#.....#.....#.#...#.....#.#...#...#.....#.....#.#
.###.###.#.###.#.#####.###.#.#.#########.#.###.#.#.#########.###
...#...#.#.#...#.#...#...#.#.#.........#.#...#.#.#.......#.#...#
##.#####.#.#####.#.#.###.#.#.#########.#.###.#.#.#.#####.#.###.#
.#.....#.#.#.....#.#.#...#.#.#.....#...#.....#.#.#.#...#.#...#.#
.#####.#.#.#.#######.#.###.#.#.###.#.#########.###.#.#.#.###.#.#
.....#.#.#...#.......#...#...#.#.#.#.#.......#....G#.#.#.....#.#
.#.###.#.#########.#.###.#####.#.#.#.#.#####.#######.#.#######.#
.#.................#...#.........#.....#.............#.........#
################################################################
