8
.......#
.###.#.#
.#...#.#
##.#####
...#..S#
.###.###
G......#
########
