8
.....#.#
.#.#.#.#
.#.#...#
##.#.###
...#.#S#
.#####.#
G......#
########
