8
.#S....#
.#####.#
...#...#
.#.#.###
.#.#...#
.#.###.#
G#.....#
########
