64
...........#.........#.......#.....#.......#.....#.....#.....#.#
.###.#####.#.###.#.###.###.#.###.#.#.#####.#.#.#.#.###.#.#.#.#.#
...#...#...#...#.#.#.....#.#...#.#.......#...#.#.#.#.#...#.#...#
##.###.#.#####.#.###.#####.###.#######.#######.#.#.#.#####.###.#
...#...#.....#.#.......#...#...#.....#.#.....#.#.#...#...#.#...#
.###.#######.#.#########.###.###.###.###.###.#.#####.#.#.#.#####
.#.#.......#.#.#.........#...#...#.....#.#.#.#.....#...#.#.....#
.#.#######.#.#.#.#########.###.#.#####.#.#.#.#.###.#####.#####.#
.......#...#.#.#...#.....#...#.#.....#...#.#.#.#...#.#...#.#...#
######.#.###.#.###.#.###.###.#######.#####.#.###.#.#.#.###.#.###
.....#.#.#...#.#...#...#...#.........#...........#...#.#...#...#
.#####.#.#.#####.###.#.#######.#######.###############.###.###.#
...#...#.#.......#...#.........#...#...#.............#..G....#.#
.#.#.###.#########.#############.#.#####.###########.#.#####.#.#
.#...#.#.#.......#...#.........#.#.#.....#.......#.#...#...#.#.#
.#####.#.#.#####.#####.#######.#.#.#.#####.#####.#.#####.#.###.#
...#...#...#...#.#...#.#.......#.#...#.........#.#...#...#.....#
##.###.#####.#.#.#.#.#.#.#######.#############.#.#.#.#.#######.#
.#.#...#.....#.#...#...#.#.....#.....#.........#...#.#.#.....#.#
.#.#.#.#.###.#.#########.#.###.#####.#.#############.#.#####.#.#
...#.#.#...#.#.#.....#...#.#.#...#...#.#.....#.......#.#.....#.#
.###.#.#####.#.#.###.#.###.#.#.###.###.#.#####.#######.#.#####.#
.#...#.......#.#...#.#...#.#.#...#.#...#.....#.#.....#.#.#.....#
.#.###########.###.#.###.#.#.###.#.###.#.###.#.#.#####.#.#.#####
.#.#.........#.#...#...#...#.#...#.#...#...#...#.#.....#.#.....#
.#.###.#####.#.#.#####.#####.#.###.#.#####.#####.#.#####.#####.#
...#...#.#...#.#.#...#.......#...#.#...#.#.#...#.#...#...#...#.#
####.###.#.###.#.###.###.###.###.#.#.#.#.#.#.#.#.###.#.#.###.#.#
.....#.....#...#.......#.#.....#...#.#.#.#.#.#...#...#.#.....#.#
.###.#######.###########.###########.#.#.#.#.###.#.###.#####.#.#
...#.........#.........#.............#.#.....#...#.#...#.....#.#
##.###########.#######.#.#############.###########.#.#########.#
.#...#...#.....#...#...#.......#.......#.........#.#...#.......#
.###.#.#.###.#.#.#.#.#####.#####.###.###.#######.#.#.#.#.#######
...#.#.#...#.#...#.#.#.....#.....#...#...#.....#...#.#...#.....#
.###.#.###.#######.#.#######.#####.###.#.#####.#####.#######.###
.#...#.#.........#.#.........#.#...#.#.#.#...#...#...#.....#...#
.#.###.#########.#.###########.#.###.#.###.#.###.#.###.###.###.#
.#.#.....#.......#.....#.......#...#.#.....#...#.#.#...#...#...#
.#.#####.#.#######.###.#.#####.###.#.#########.#.#.#.#####.#.#.#
.#.......#.......#.#...#...#.#...........#...#.#.#...#...#...#.#
.###############.###.#####.#.###########.#.###.#.###.#.#.#######
.........#.....#.....#.........#...#...#...#...#.....#.#.......#
####.###.#.###.#######.#########.#.#.#####.#.#########.#######.#
.....#...#.#.#.....#.#...#...#...#.#...#...#...#.....#.#...#...#
.#########.#.###.#.#.###.#.#.#.###.#.#.#.#####.#.###.#.#.#.#.#.#
.....#.....#.#...#...#...#.#.#...#.#.#.......#.#.#.#.....#.#.#.#
.###.#.#####.#.#######.###.#.#.###.#.#########.#.#.#########.#.#
...#...#.....#...........#.#...#...#.....#...#.........#.....#.#
##.#####.###.#############.#####.#######.#.#.#.#######.#.#####.#
.#.#.....#.#.....#...#.#...#.#S#.#.....#.#.#.#.#...#...#.#.....#
.#.###.###.#####.#.#.#.#.###.#.#.#.###.###.#.###.#.#####.#######
.#.....#.#.....#.#.#.#.#...#.#...#.#.#.#...#.....#.....#.......#
.#######.#.###.#.#.#.#.###.#.#####.#.#.#.#############.#######.#
.....#.......#.#.#.#.....#.#.......#.#...#...#.......#.....#...#
.#####.#######.#.#.#######.#.#.#####.#######.#.#.#########.#.#.#
.#.....#.......#.#.....#...#.#...#.#.......#.#.#...........#.#.#
.#.#####.#######.#####.#.###.###.#.#.#.###.#.#.#############.#.#
.#.....#.#.....#.#.....#...#.#...#...#.#.....#...#...#.......#.#
.#####.#.#.###.#.#.#######.###.###.###.#########.#.#.#.###.###.#
...#...#.#.#.#.#.#...#.....#...#.#.#...#.......#.#.#...#...#.#.#
.#.#.###.#.#.#.#.###.#.#####.###.#.#.###.###.###.#######.###.#.#
.#.....#.....#.......#.......#.....#.......#.............#.....#
################################################################
