32
.....#...#.............#.......#
.###.#.###.#########.#.###.###.#
..S#.#...........#.#.#...#.#.#.#
####.#.#########.#.#.###.#.#.#.#
.....#.#.....#.....#...#...#...#
.#####.#.###.#.#######.#########
.#.....#.#...#.#.....#...#.....#
.#.#####.#.#####.###.#.#.#.###.#
.#.....#.#.......#.#.#.#...#...#
.#######.#########.#.###.###.#.#
.#.......#.........#...#.#...#.#
.#.#######.#######.###.#.#.###.#
...#...#...#.....#...#.#.#.#...#
####.#.#.###.###.#.#.#.###.#.###
...#.#.#.....#.#.#.#.#.....#.#.#
##.#.#.#######.#.#.#.#######.#.#
...#.#...#.......#.#.#.....#...#
.###.#.###.#######.#.#.#.#####.#
.#...#.....#.....#.#.#.#.....#.#
.#.#########.#.###.###.###.#.#.#
.#.......#.#.#...#...#.#.#.#.#.#
.#######.#.#.###.###.#.#.#.#.#.#
.......#.#.....#...#...#.#.#.#.#
.#.###.#.#########.#####.#.###.#
.#...#.#.......#...#.....#...#.#
.###.#.#######.#.#.###.#####.#.#
.#.#.#...#...#.#.#...#.....#...#
.#.#.#####.#.#.#.###.#.#.#######
...#...#...#.#G#.#.#.#.#.......#
##.###.#.###.#.#.#.#.#######.#.#
.....#.....#.....#...........#.#
################################
