8
......G#
.#######
.......#
######.#
..S#...#
.###.#.#
.....#.#
########
