8
......G#
####.#.#
S..#.#.#
##.#.#.#
...#.#.#
.#####.#
.......#
########
