64
...#.......................#...#.....#.....#.........#.........#
.#.#.#######.#.###########.###.#.#.#.#.###.#####.###.#########.#
.#.#.#.....#.#.....#.#...#...#.#.#.#...#.#.#...#.#.#.........#.#
.###.#.###.#.#####.#.#.#.###.#.#.#.#####.#.#.#.#.#.#########.#.#
.....#.#.#.#...#...#...#...#.#...#...#.....#.#.#.#......G..#...#
######.#.#.#####.###.#####.#.#######.#.#####.#.#.#.#####.#.###.#
.......#.#.....#.#...#.#...#...#.....#.#.....#...#.#.#...#...#.#
.#######.#####.#.#.###.#.#####.#.#####.#####.#####.#.#.#.#####.#
...#.#.......#...#.#...#.....#...#...#.......#...#.#.#.#.#.....#
.#.#.#.#.#########.#.#.#####.#####.###########.###.#.#.###.#####
.#.#...#.....#...#.#.#.#...#.#.....#.....#.......#...#.....#...#
.#.###.#####.#.#.#.###.#.#.#.#.#.###.###.#.#####.###.#######.#.#
.#...#.#...#...#.#.#...#.#.#...#...#.#.#...#...#...#.......#.#.#
.###.#.#.#.#####.#.#.#.#.#.#.#####.#.#.#####.###.#.#######.###.#
...#.#.#.#.#...#.#...#.#.#.#.#...#.#.....#...#...#.......#.#...#
##.#.#.#.#.#.#.#.###.###.#.#.#.#.#.#####.#.###.#########.#.#.#.#
.#.#.#.#.#.#.#.#...#.#...#.#...#.#.........#...#.......#.#...#.#
.#.#.###.#.#.#.###.#.#.###.#####.###########.###.#####.#######.#
...#.#...#...#...#...#.#.#.#...#.....#.....#.#...#.#...#.......#
.###.#.#########.#####.#.#.#.#.###.###.###.#.#.###.#.###.#######
.#...#.#.......#.......#.#.#.#...#.#...#...#.#.#...#...#.#.....#
.#.###.###.###.#########.#.#.###.#.#.###.###.#.#.#.###.#.#.###.#
.#.....#...#...#.........#.#.#.#.#.#...#...#.#...#.#...#.#.#...#
.#######.###.#####.#####.#.#.#.#.#####.###.#.#####.#.###.###.#.#
.#.......#.#.#.....#.....#.#.#.#.....#.#...#.#.....#...#...#.#.#
.#.#######.#.#.#####.#####.#.#.#####.#.###.#.#.#######.###.#.###
.#.#...#...#...#...#.#...#.#.....#.#.#...#...#...#...#...#.#...#
.#.#.#.#.#######.###.#.###.#####.#.#.#.#.###.###.#.#.###.#.###.#
.#.#.#.#.........#...#...#.....#...#.#.#...#...#.#.#...#...#...#
.#.#.#.#####.#.###.###.#.#####.#.###.#####.#####.#.#########.#.#
.#.#.#.#.....#.#...#...#...#...#.#...#...#.....#.#.......#...#.#
.#.#.#.#.#####.#.###.#####.#.#.#.#.###.#.#.###.#.#####.#.###.#.#
.#...#.#...#...#.#...#.....#.#.#.#.....#.#.#.#.#.......#.....#.#
.#.###.#.#.#.###.#####.###.#.#.#.#######.#.#.#.###############.#
.#.#...#.#.#...#.#...#.#...#.#.#.#...#.#.#.#.#.......#.#.....#.#
.###.#####.###.#.#.#.#.#.###.###.#.#.#.#.#.#.###.###.#.#.###.#.#
...#.....#...#.#...#.#.#.#.#...#...#.#.#.#.#...#...#...#.#.#...#
##.###.#.#.#.#.#####.#.#.#.###.#####.#.#.#.###.###.###.#.#.#####
.#...#.#.#.#.#.#...#.#.#.....#.....#.#.#.#...#...#.#...#.#.....#
.###.###.###.#.###.#.#.#####.#.#####.#.#.###.###.#.#####.#.###.#
...#...#.#...#.....#.#...#...#.......#.#.#.......#.#.....#...#.#
.#.###.#.#.#.#####.#.###.#.###########.#.#######.#.#.#########.#
.#...#.#.#.#.#...#.#...#.#...#.........#...#...#.#.#.#.........#
.###.#.#.#.###.#.#.###.#.#####.#.#########.#.#.###.#.#.#######.#
...#...#.#.....#.#.#...#.#.....#.#.......#...#.#...#.#.......#.#
##.#####.#####.#.#.#.###.#.#####.#.###.#.#####.#.###.#.#####.###
.#.....#.#...#.#.#.#...#.#.#...#...#...#...#...#.#...#.....#...#
.#####.#.#.#.###.#.###.#.#.#.#.#.###.#######.###.#.###########.#
.....#.#.#.#.....#.#...#...#.#.#...#.#.....#...#.#.#.......#...#
.###.#.#.#.#######.#.#######.#.#####.#.###.###.#.#.#.#####.#.###
...#.#...#...#.....#...#...#.#.......#...#...#.#.#...#...#.#...#
.#.#########.#########.#.#.#.###########.###.#.#.#####.###.###.#
.#.....#.....#.......#...#...#...........#.#...#.....#.....#...#
######.#.#.###.#####.#####.###.###########.#####.#.###.#####.#.#
.......#.#.#...#...#.......#...#.........#.....#.#.....#.....#.#
.#######.#.#.###.###########.#####.#######.#.###.#########.###.#
...#...#.#.#...#.........#...#...#...#.....#...#.#.........#...#
.#.#.#.#.#.###.#######.#.#.#.#.#.#.#.#.#######.#.###.#######.###
.#...#.#.#...#.#...#...#.#.#.#.#S#.#...#.....#.#...#.#.....#...#
.#####.#.#.###.#.#.#.###.#.###.###.#####.###.#.###.#.#.#.#####.#
.....#...#...#.#.#...#.#.#...#...#...#...#.#.#.....#.#.#.#...#.#
####.#######.#.#.#####.#.###.###.###.#.###.#.#######.#.#.#.#.#.#
...........#.....#.........#.....#.....#.............#.#...#...#
################################################################
