16
...#...#......G#
.#.#.#.#.###.###
.#...#...#.#...#
.#########.###.#
.............#.#
.#############.#
.#.............#
##.#.#########.#
...#.#S..#.....#
.###.###.#.#####
.#...#...#.#...#
.#####.###.#.#.#
.......#...#.#.#
########.###.#.#
.............#.#
################
