32
...#.....#..G..........#.......#
.###.#.#.#######.#####.#.#####.#
...#.#.#.........#...#...#.#...#
.#.#.#.###########.#.#####.#.###
.#.#.#.......#.....#.#.#.....#.#
##.#.#######.#.###.#.#.#.#####.#
...#.#.....#.#.#...#...#...#...#
.###.#.#####.#.#.#####.###.#.###
.#...#.....#.#.#...#.....#.#...#
.#.#######.#.#####.#######.###.#
...#.......#.#...#...#...#.....#
.###.#####.#.#.#.###.#.#.#####.#
.#.....#...#...#...#...#.....#.#
.#.###.#.#####.###.###.###.###.#
.#...#.#.#...#...#...#...#.....#
.#####.#.#.#.#######.###.#######
.....#.#.#.#.#.......#.#.#.....#
####.#.#.#.#.#.#######.#.#.###.#
.......#.#.#...#.......#.#.#...#
.#########.###########.#.###.#.#
.#.#.......#.........#.#.#...#.#
.#.#.#######.#######.#.#.#.###.#
...#.#...#...#...#.#...#.#...#.#
####.#.###.#.#.#.#.###.#.#.#.###
.....#.#...#...#.#.....#.#.#...#
.#####.#.#######.#.#####.#####.#
.#.....#.....#...#.#.#...#.....#
.###.###.#####.###.#.#.###.###.#
.#S#.#...#.....#.....#.#...#.#.#
.#.#.#.###.###########.###.#.#.#
...#.....#.................#...#
################################
