16
...........#S..#
##########.###.#
.............#.#
.#######.#####.#
.#.....#.#...#.#
.#.#.###.#.#.#.#
.#.#.....#.#.#.#
.###.#####.#.#.#
...#.#...#.#.#.#
##.#.#.###.#.#.#
...#...#...#...#
.#######.#######
........G#.....#
.###########.#.#
.............#.#
################
