8
.#S#...#
.#.#.#.#
...#.#.#
.#####.#
.#....G#
.#.###.#
...#...#
########
