64
.......#.......#.......#.........#.....#.......#.........#.....#
.#####.#.#.#####.#.###.#.###.#####.###.#.#####.#.#####.###.#.###
.#...#.#.#.......#.#.#.#...#.#.....#.#.......#.#.#...#.....#...#
.#.###.#.#########.#.#.###.#.#.#####.#########.#.###.#########.#
.#...#.#.....#.....#.#.....#.#.#...#...#.......#.....#.......#.#
.###.#.#####.#.#####.#######.#.#.###.#.#.#####.#####.#.#####.#.#
.....#...#...#.#.............#.#.....#.#.#.........#.#...#.#.#.#
######.###.###.###.###########.#######.#.#.#######.#.###.#.#.#.#
.....#...#.#.#...#.#.....#.............#.#.#.....#.#.....#.#.#.#
.###.###.#.#.###.###.###.#.###########.#.#.#.###.#########.#.#.#
.#.......#...#.#...#.#.#.#...#.......#.#.#.#...#.#...#.......#.#
.###########.#.###.#.#.#.###.#.#####.###.#####.#.#.#.#.#######.#
.....#.....#.#.#...#.#.#...#.#.#...#.#...#.....#...#.#...#.....#
####.#.###.#.#.#.###.#.###.#.#.###.#.#.#.#.#########.#.###.###.#
.....#.#...#.#.#.....#...#...#.#...#.#.#.#.......#.#...#...#...#
.#####.#.###.#.#########.#####.#.###.#.#.#######.#.#####.#####.#
.......#...#.#.........#.....#.#.......#.#.....#.....#.#.....#.#
.#########.#.###.#####.#.#####.#########.#.###.#####.#.#####.###
.#.......#...#...#.....#.#.....#.....#.#...#...#...#.....#.#...#
.#.#####.#####.#####.###.#.#####.###.#.#####.###.#.#####.#.###.#
.#.#.....#...#.....#...#.#.........#.#...#.......#.#.....#.#...#
.#.#######.#.#.###.###.#.###########.###.#.#########.#####.#.#.#
.#...#.....#.#...#.#.#...#...#.....#...#...#.........#.....#.#.#
.###.#.#####.###.#.#.###.###.#.###.###.#.###.#########.###.#.###
...#...#...#.....#.#.#...#...#.#.#.#...#.#...#...#.....#...#...#
##.###.#.#####.###.#.#.###.#.#.#.#.#.#####.###.#.#.###.#.#####.#
.#...#...#...#...#.#...#...#.#.#.....#.....#...#.....#.#.#.....#
.###.#####.#.#####.#.###.###.#.#.#####.###############.###.###.#
...#...#...#.......#.#...#...#.#.#.....#.............#.#...#.#.#
.#.###.#.###########.#.#######.###.#####.#.###.#####.#.#.###.#.#
.#...#.#.#...........#...#.....#...#.....#...#.#...#...#.#...#.#
.#.#.#.#.#######.#######.#.###.#.#######.###.###.#.#####.#.#.#.#
.#.#.#.#.......#...#.....#.#.#.#.......#...#.....#.#.....#.#...#
.#.###.#.#####.###.#.#####.#.#.#######.#####.#####.#.#.#########
.#.#...#.#...#.#...#.#.....#.#.#.....#.....#.....#.#.#.#.....#S#
.#.#.###.#.#.#.#.###.#.#####.#.#.#.#######.###.###.#.###.###.#.#
.#...#.#...#.#.#.....#.#.........#.#.....#.#...#...#.#...#.#.#.#
.#####.#####.#.#.#####.#######.#####.###.#.#####.###.#.###.#.#.#
.#.#.........#.#.#...#.#.....#.#.....#...#.#.....#...#.#...#.#.#
.#.#.#########.###.#.#.#.###.#.#.#####.#.#.#.#####.###.#.#.#.#.#
.#.#.#.......#...#.#...#...#.#.#.#.#...#.#.#.....#...#.#.#.#...#
.#.#.#####.#.###.#.###.#.###.###.#.#.###.#.#.###.###.#.#.#######
.#...#.....#.#...#.#.#.#.#...#...#.#.#...#.#...#...#...#.....#.#
.###.#.#####.#.###.#.#.#.#.###.###.#.#.###.#######.#####.#.#.#.#
...#...#...#.#...#.#.#.#.#...#.....#.#...#.........#.....#.#...#
##.#####.#.#.###.#.#.#.#.###.#####.#.#############.#######.###.#
...#.#...#...#...#.#...#...#.......#.........#...#.........#...#
.###.#.#######.###.#.#####.#############.#.###.#.###########.###
...#.#.#.....#...#.#.#.....#.....#.....#.#.#...#.#.........#...#
##.#.#.###.#####.#.###.#######.###.###.#.#.#.###.#.#######.###.#
.#.#.#.....#.....#...#.#.....#.#...#.#.#.#.#...#.#.#...#.#.....#
.#.#.#####.#.#######.#.#.###.#.#.###.#.#.#.###.#.#.#.#.#.#######
...#...#...#.......#...#.#.....#.#...#...#.#.#.#...#.#.#...#...#
.###.#.#.#########.#####.#######.#.#######.#.#.#####.#.#.#.#.#.#
...#.#.#.........#.....#.....#...#.........#.#.......#...#...#.#
##.#.#.###.#####.#.###.#.###.#.#########.###.#################.#
...#.#.#...#...#.#.#.#.#.#.#.#...#.....#.....#...............#.#
.###.#.#.###.#.###.#.#.#.#.#.###.#.###.#######.#########.###.#.#
...#.#...#...#.....#.#.#...#...#...#.#.#.....#.#...#...#.#...#.#
##.#######.#########.#.#####.#.#####.#.#.###.#.#.#.###.#.#.###.#
.#...#...#.#...#.....#G......#.......#...#.#.#...#.....#.#...#.#
.###.#.#.#.#.#.#.#.#################.#####.#.#########.#.#####.#
.......#...#.#...#.........................#...........#.......#
################################################################
