16
...........#...#
.#####.###.###.#
.#...#...#...#.#
.#.#####.###.#.#
...#S#...#...#.#
##.#.#.###.###.#
.#.#.#...#...#.#
.#.#.#.#.###.#.#
...#.#.#...#.#.#
.###.#.###.#.#.#
.#.#.#.#...#.#.#
.#.#.###.###.#.#
...#...#.#...#G#
##.###.#.#.###.#
.....#...#.....#
################
