32
.............#.......#.........#
.###.#########.###.###.#######.#
.#...#.......#.#.#...#.......#.#
.#.#.#.#####.#.#.###.#####.###.#
.#.#.#.#.....#.#...#...#...#...#
.#.#.#.#.#####.###.#.#.#.###.#.#
.#.#.#.#.....#...#.#.#.#.#.#.#.#
##.###.#####.###.#.#.###.#.#.###
...#...#...#.....#.#.......#...#
.###.###.#.#######.###########.#
.#...#...#...#.....#.....#...#.#
.#.###.#.###.###.#.#.###.#.#.#.#
.#.#G..#...#.....#.#.#.....#.#.#
.#.###.###.#######.#.#######.#.#
.#...#.#.#...#.....#...#...#...#
.###.#.#.###.#####.###.###.###.#
.....#...#...#...#...#...#.....#
.#########.###.#.#######.#####.#
.#.......#.#...#...#.....#...#.#
.###.###.#.#.#####.#.#####.#.#.#
.....#.#.#.#.#.#...#.....#.#.#.#
######.#.#.#.#.#.#.#####.#.#.###
.....#...#.....#.#.....#...#...#
.#.###.#######.#.#####.#######.#
.#...#.....#...#.#...#...#.#...#
.###.#####.#####.#.#####.#.#.###
.#.....#...#.....#.#.......#...#
##.#####.###.#####.#.#########.#
...#.....#...#...#...#S......#.#
.###.#####.###.###.#########.#.#
...........#...............#...#
################################
