32
.......#.............#.........#
.#.###.#.###.#######.#.###.###.#
.#...#.#G#...#...#.#.#...#.#...#
####.#.###.###.#.#.#.#####.#.###
...#.#.....#...#...#.......#...#
.#.#.#######.#################.#
.#...#.......#.......#.......#.#
.#.#########.#.#####.#.###.###.#
.#.#...#...#.#...#.#...#.#.....#
.###.#.#.#.#.###.#.#####.#######
.#...#...#.#...#.........#.....#
.#.#######.###.#########.###.#.#
.#.....#.#...#...#.....#.....#.#
.#####.#.###.#.#.#.###.#######.#
.....#.#...#.#.#.#.#...#.......#
.###.#.#.#.#.#.###.#.#.#.#######
...#.....#.#.#...#.#.#.#.#.....#
##########.#.###.#.#.###.#.###.#
.........#.#...#...#.....#...#.#
.#######.#####.#.#####.#####.#.#
.#.....#.....#.#.#...#.....#.#.#
.#.###.#####.#.###.#.###.###.#.#
.#.#...#...#.#...#.#...#.#...#.#
.###.###.#.#.###.#.###.#.#.###.#
...#.....#.......#...#.#.#S#...#
.#.#################.#.#####.###
.#.....#...#.....#...#.....#...#
.#####.#.#.#.###.#.#######.###.#
.#.#...#.#...#.#.#.#...#.#...#.#
.#.#.###.#####.#.#.#.#.#.###.#.#
...#...........#.....#.....#...#
################################
