32
.........#.....#...............#
######.###.#.###.###.###########
.......#...#.....#.#...#.......#
.#####.#.#########.###.#.#####.#
.#...#.#.#...........#.#.....#.#
.#.###.#.#.#####.#.#.#.#####.#.#
.#.....#.#.#...#.#.#.#.....#.#.#
.#.#####.###.#.###.#.###.###.#.#
.#.....#...#.#...#.#.#.#...#.#.#
.#####.###.#.###.#.#.#.###.#.#.#
.#...#...#...#.#...#...#.#...#.#
.#.#####.#####.#######.#.#####.#
.#.....#.#.........#.#.......#.#
.#.#.###.###.#####.#.###.#####.#
.#.#.......#...#.#...#...#.....#
.#########.###.#.###.#.###.###.#
.........#.....#.....#.#.#.#...#
.#######.#######.#####.#.#.#####
.......#...#.....#.....#.#.....#
######.###.#######.#####.#####.#
....G#...#...#.....#.....#...#.#
.#.#####.###.#.#####.###.#.###.#
.#.....#.#...#...#...#...#...#.#
.#####.#.#.#####.#.###.###.#.#.#
...#...#.#.#.....#.#.#.#...#.#.#
##.#.###.#.#.#####.#.#.#####.#.#
...#.....#...#.....#.#.......#.#
.#############.#####.###.#####.#
.#...........#.#.......#.#.....#
.#########.#.#.#.###.###.#.#####
...........#...#...#.....#....S#
################################
