64
.........#.....#.#.........#...........#...........#.......#...#
.###.###.###.#.#.#.#######.#.#######.#.#####.#####.#.###.###.#.#
.#.#.#...#...#...#.#.....#.#.#.......#.#.....#...#.#.#...#...#.#
.#.#.#.###.#####.#.###.###.###.#######.#.#####.###.#.#####.###.#
...#.#.....#.#...#...#...#...#...#.......#.......#.#...#...#...#
##.#.#######.#.#####.#.#.###.###.###############.#.#.#.#.###.###
...#.....#.........#.#.#...#.#...#.....#.........#.#.#...#.#...#
.#######.###.#######.###.###.#.###.###.#.###.#####.#.#####.###.#
.......#...#.#...........#...#...#.#...#.#...#.....#....G..#...#
######.###.###.#######.###.###.#.#.#.###.###.#.#####.#######.#.#
.......#.#.....#.....#.#...#.#.#.#.#.#.....#.#.#.....#.....#.#.#
.#######.#######.###.###.###.#.#.#.#.###.#.###.#######.###.#.#.#
.#.........#.....#.#.#...#.....#.#.#...#.#.....#.......#.#.#.#.#
.#.###.###.#.#####.#.#.#########.#.###.#.#######.#######.#.#.#.#
.#...#.#...#...#...#.#.#.......#...#...#.#.......#.......#...#.#
.#####.#.#####.#.###.#.#.#####.#.###.###.###.###.#.###########.#
.#.....#.#.....#.#...#.#.....#.#...#.#.....#...#.#.#.....#.....#
.#.#####.#.#####.#.###.#####.#.###.#.#####.#.###.#.#.###.#.#####
...#...#.#.....#.....#.#.....#.#...#...#...#.#...#.....#.#.#...#
####.#.#.#####.#####.#.#.#####.#######.#.###.#.###.#####.#.#.###
.....#.......#...#...#.#.#...#.........#.#...#.#.....#...#.#...#
.###############.#.###.#.#.#.###########.###.#.#######.#.#.###.#
...#.....#.......#...#.#.#.#.........#.#...#.#.......#.#.#.#...#
##.#.###.#.#########.#.#.#.#########.#.###.#########.#.###.#.#.#
.#.#...#.#...#.....#...#...#.......#.#...#...#.......#...#.#.#.#
.#.#.#.#####.###.#######.###.#####.#.#.#####.#.#######.#.#.#.#.#
...#.#.#...#...#.......#...#.#...#...#...#...#.....#...#.#.#.#.#
.###.#.#.#.###.###.###.#####.#.#.#####.#.#.#######.#####.#.#.#.#
.#.#.#.#.#...#...#...#.....#...#.#.#...#...#.....#.....#.#.#.#.#
.#.#.#.#.###.###.###.#####.#.###.#.#.#######.###.#####.#.#.#.#.#
.#...#.#...#.....#...#...#.#.#...#...#.....#.#.#.....#.#.....#.#
.#####.###.#######.###.###.#.#.###.###.###.#.#.#####.#.#######.#
.....#.#...#.......#...#...#.#...#.#.....#...#...#...#.....#.#.#
####.#.#.#####.#.###.#.#.#######.#.#.###.#######.#.#####.#.#.#.#
.#...#.#.#...#.#.#...#...#.......#.#...#...#.....#.....#.#.#.#.#
.#.###.#.#.#.#.#.#####.#####.#####.#######.###.#######.#.#.#.#.#
...#...#...#.#.#.....#.......#...#.......#...#.......#.#.#.#...#
.###.#.#####.#####.#.#########.#.#######.###.###.###.#.#.#.#####
.#...#...#...#..S#.#.#.....#...#.#.....#...#...#.#...#.#.#.....#
.#.#####.#.#.#.###.#.#.#.###.###.#.#.#####.###.###.#.#.#.#####.#
.#.....#.#.#.#...#.#.#.#.......#...#.#...#...#.#...#.#.#.#...#.#
.###.###.#.#.###.#.#.#########.#####.#.#.###.#.#.#.###.#.#.#.#.#
...#.#...#.#.#.#.#.#.........#.#.....#.#.....#.#.#.#...#.#.#.#.#
##.###.#.#.#.#.#.#######.###.#.#.#####.#######.#.###.#####.#.#.#
.#.....#.#.#...#.......#.#...#.#.#.....#...#...#...#.....#.#...#
.#######.#.###########.#.#.#####.#.#####.#.#.###.#.#####.#.#####
.......#.#.......#.....#.#.#...#.........#...#.#.#.....#.#.#...#
.#####.#.#####.#.#.#####.#.#.#.###############.#.#####.#.#.#.#.#
.....#.#.#.....#.#.#...#.#...#.#...#.......#.....#...#...#...#.#
.###.###.#.#####.#.#.#.#.#####.#.#.#####.###.#####.###########.#
.#.#.#...#...#.#.#.#.#.......#...#.....#.....#...#...#.........#
.#.#.#.#####.#.#.#.###.###############.#.#####.###.#.#.###.###.#
.#.#.#.#.....#...#...#.#...............#.....#.#...#...#...#...#
.#.#.#.#.#####.#####.#.#.###################.#.#.#######.#######
...#.#.#...#...#.....#.#.#...#.....#.......#.#...#...#.#...#...#
##.#.#.###.#.###.#######.#.###.###.#.#####.#.#.###.#.#.###.#.#.#
.#.#.#.#.#.#.#...#.......#.#.....#...#...#.#.#.#...#.....#.#.#.#
.#.#.#.#.#.###.###.#######.#.#########.#.#.#.#.###.#######.#.#.#
...#...#.#.....#.......#.....#.#.......#...#.#.....#.....#.#.#.#
.#######.#############.#####.#.#.#########.#.#####.#.###.#.#.#.#
.....#...#...........#.....#...#.#.........#.#...#.#...#.#...#.#
####.#.#.#######.###.#####.###.#.###########.#.#.#####.#.#####.#
.......#.........#.........#...#...............#.......#.......#
################################################################
