8
.#.....#
.#.#.#.#
...#.#G#
####.#.#
.....#.#
.#####.#
S#.....#
########
