32
................G#.#...........#
.#########.#####.#.#.#.#######.#
.#.#.....#...#.#.#...#.#.#.....#
.#.#.###.###.#.#.#####.#.#.#####
...#...#.#...#.........#...#...#
.#####.#.#.#.###########.###.#.#
.#.....#...#.#.........#...#.#.#
##.#########.#.#######.###.#.#.#
...#.........#.#.....#.#.....#.#
.#####.#######.#####.#.#######.#
.#...#...#...#.#.....#.#...#.#.#
.#.#.###.#.###.#.###.#.#.#.#.#.#
.#.#...#...#...#.#...#...#.#.#.#
.#.###.#####.###.#.#######.#.#.#
...#...#.....#...#.#...#...#...#
.###.#.#.#####.###.#.#.#.#######
...#.#.#.#.....#...#.#...#.....#
##.#.###.#.#.###.###.###.#.###.#
.#.#.....#.#.#.....#.#...#.#.#.#
.#.#########.#######.#.###.#.#.#
.#.#.........#.......#.#.....#.#
.#.#.#####.###.#######.#.###.#.#
.#.#.#.#...#...#.....#.#.#S#.#.#
.#.#.#.#.###.###.###.###.#.#.#.#
...#.#.#...#.....#...#...#.#.#.#
.###.#.###.#######.#.#.###.###.#
...#.#...#.#...#...#.#.#.#.....#
##.#.###.#.#.#.#.#####.#.#######
.#...#...#.#.#.#.....#.#.......#
.#####.###.###.#####.#.###.###.#
...................#.......#...#
################################
