8
.#S..#.#
.###.#.#
...#.#.#
.#.#.#.#
.#.#.#.#
.###.#.#
......G#
########
