32
.#.........#.....#.............#
.#.###.###.#.###.#.#########.###
...#...#.#.#...#.#.....#...#...#
.###.###.#.###.#.#.#####.#.###.#
...#...#...#...#.#.#.....#.....#
##.###.#.###.#####.#.###########
.#.#...#.#...#.....#...........#
.#.#.###.#.###.###############.#
...#.#...#...#...#...#G........#
.###.#.#####.###.###.#.#########
...#.#.#.......#.#...#.........#
####.#.###.#####.#.#.#########.#
.....#.....#...#.#.#...#.......#
.#.#########.#.#.#.#####.#####.#
.#.#.....#...#.#...#...#.#...#.#
.###.###.#.###.#.###.#.#.#.#.#.#
...#.#.#.....#.#.#...#...#.#.#.#
.#.#.#.#####.#.#.#.###.###.#.###
.#.....#...#.#.#.#.#...#...#...#
####.###.#.#.#.#.#.#####.#####.#
...#.#...#.#.#...#.#.......#...#
.#.###.###.#.#####.#.#######.#.#
.#.....#.#.#.....#.......#...#.#
.#######.#.###############.###.#
.#.........#.....#.........#.#.#
.#.#######.#.###.#.#########.#.#
.#...#...#.#.#.#...#.#.......#.#
.#####.#.#.#.#.#####.#.#####.#.#
.#.....#.#...#.....#...#...#...#
.#.#####.#####.###.#.###.#.#####
.......#....S#...#.......#.....#
################################
