32
.......#...#...#.........#.....#
##.#####.#.#.#.#.#####.#.#.###.#
...#.....#...#...#...#.#.#.#.#.#
.###.###############.#.###.#.#.#
...........#...#...#.#.....#.#.#
.#########.#.#.#.#.#.#######.#.#
.....#...#...#.#.#...#.....#.#.#
####.#.#.#####.#.###.#.###.#.#.#
...#.#.#.#...#...#.#...#.....#.#
.#.###.#.#.#######.#.#########.#
.#.....#.#...........#.....#...#
.#######.#############.###.#.###
.#.....#...........#...#.#S#...#
.#.###.###########.#.###.#####.#
...#...#.........#...#.........#
####.###.#####.#.#####.#######.#
...#.#...#.....#.....#.......#.#
.#.#.###.#.#########.#.#####.###
.#.#...#.#.#.#...#...#.....#...#
.#####.#.#.#.#.#.#.###########.#
.....#.#.#.#...#.#.......#...#.#
####.#.#.#.###.#.#######.#.#.#.#
.....#.#.#...#.#.#.....#...#.#.#
.#####.#####.#.#.#.###.#####.#.#
.....#.......#.#...#.#.....#.#.#
.###.#########.#####.#####.#.#.#
.#.#.....#...#.#.........#.#...#
.#.###.#.#.#.#.#.#####.###.###.#
...#..G#.#.#...#...#.#.#.....#.#
##.#.#####.#######.#.#.#.#####.#
...#...............#...#.......#
################################
