32
.........#.....#...#...........#
.###.#####.#.###.#.#.#########.#
.#.#...#...#.#...#.#.#...#...#.#
.#.###.#.###.#.###.###.#.#.#.#.#
.#...#.#...#...#...#...#.#.#.#.#
.#.###.###.#####.#.#.###.#.#.#.#
.#...#.....#...#.#.#...#.#.#...#
.###.#######.###.#####.#.#.###.#
.....#.#...#...#.#.....#.#...#.#
####.#.#.#.#.#.#.#.#####.#.#.#.#
.....#...#...#.#...#.#...#.#.#.#
.#############.#####.#.###.#.###
...#...........#.....#...#.#...#
##.#.###.#####.#.###.###.###.#.#
.#.#...#.#..S#.#...#...#...#.#.#
.#.###.###.###.###.#####.#.#.#.#
.#.#...#...#.......#...#.#.#.#.#
.#.#.#.#.###########.#.#.#.###.#
.#.#.#.#.....#.......#.#.#.#...#
.#.#.#######.#.#######.###.#.###
.#.#...#.....#.#...#...#...#...#
.#.#.#.#.#####.#.#.#.###.###.#.#
...#.#.#.#.....#.#.#.....#...#.#
.###.#.#.#####.#.#.###########.#
...#.#.#.......#.#.............#
##.###.###########.###########.#
.#.....#...........#.......#...#
.#####.#.#############.#####.###
...#...#...#.#.........#...#...#
.#.#.#####.#.#.#.#######.#.###.#
.#.........#...#.........#..G..#
################################
