64
.#...........#...#.....#.....#...#.......................#S#...#
.#.###.#####.#.#.#.###.#.###.#.#.#.#########.#.#######.###.#.###
...#.#.....#...#...#...#.#.#.#.#.#.#...#...#.#.#.#.....#...#...#
.###.#####.#########.###.#.#.#.###.#.#.#.#.###.#.#.#####.#####.#
...#.....#.....#.....#...#...#.....#.#...#.....#...#.....#...#.#
##.###.#.#####.###.#####.#.###.#####.###.#####.#####.#####.#.#.#
.......#.....#...#.......#...#.#...#...#.#...#.#.....#.....#...#
############.###.###########.###.#.###.#.#.#.###.#########.###.#
...........#...#.#...#.....#.....#.....#.#.#...#.#.........#.#.#
.#########.#####.#.#.#####.#####.#######.#.###.#.#.#########.#.#
.#...#...#...#...#.#.....#.......#...#...#.#...#...#.....#.#...#
.#.###.#.###.#.###.#####.#########.#.#####.#.#######.#.#.#.#.###
.#.....#.#...#...#.#...#.#.........#.....#.#...#...#.#.#...#...#
.#.#####.#.#####.#.#.#.#.#.#############.#.###.#.#.#.#.#######.#
.#.....#.#.....#...#.#.#.#...........#.#...#.#...#...#.......#.#
.#.#####.#####.#####.#.#.###########.#.#####.###############.#.#
.#.#.....#.....#.....#...#...#.....#.#.....#.....#.......#...#.#
.#.#.#####.#####.#######.###.#.###.#.#.###.#.#.#.#####.###.###.#
.#.#.#.....#...#.....#.......#...#...#...#...#.#.....#.#...#...#
.###.#.#####.###.###.#######.###.#############.#####.#.#.#.#.###
...#.....#.........#.......#.#.#...............#.......#.#.#.#.#
.#.#####.#########.#######.#.#.#############.###########.#.#.#.#
.#...#.#.......#.......#...#.........#.....#.#.........#.#.#.#.#
####.#.#######.#######.#.#.###########.#.###.#.#######.#.#.#.#.#
.....#.....#.#.......#.#.#.#...........#.....#.....#.#...#.#.#.#
.#######.#.#.#######.#.#.###.#####################.#.#.#####.#.#
.#.....#.#...#...#...#.#.....#.......#.#.........#.#...#...#...#
.#.###.#.#.###.#.#.###.#######.###.#.#.#.#######.#.#####.#.###.#
.#.#...#.#.#...#.#.#.........#...#.#.#.#.#.........#...#.#...#.#
.#.#.###.###.###.#.#########.#####.#.#.#.#####.#####.#.#.###.#.#
.#.#.#...#...#...#.........#.......#.#.#.....#.#.....#...#.#...#
.#.#.###.#.###.###########.#.#######.#.#####.###.#########.#####
.#.#...#.....#.....#.....#.#.#...#.#.#.....#...#.....#.#.......#
.#.###.#####.#####.#.#.###.###.#.#.#.#.#.#####.#####.#.#.#####.#
...#.#.....#.....#...#...#.#...#.#.#.#.#.#.....#.....#...#...#.#
.###.#####.#####.#######.#.#.###.#.#.###.#.#####.#####.###.#.#.#
.......#.#...#.......#...#...#.#.#.....#.#.#.....#...#...#.#...#
######.#.###.#########.#######.#.#####.#.#.#.#####.#.###.#.###.#
.....#...#.#...#.....#.....#.........#...#.#.#.....#.#...#...#.#
.###.###.#.###.#.###.#.###.#.#######.#####.#.###.###.#.#####.###
...#...#.#...#.....#.#...#.#.#G....#.......#.....#.#.#.#...#...#
##.#.###.#.#.#######.#####.#.#.###.###############.#.###.#.#.#.#
...#.#.....#.#.......#...#.#.#.#.#.....#...........#.....#.#.#.#
####.#.#######.#####.#.#.#.#.#.#.#####.#.#.#######.#######.###.#
.....#...#.....#.#...#.#.#...#.#.....#...#.....#.#.......#.....#
.###.###.#.#####.#.###.#.#####.#.#.###########.#.#.###########.#
...#.#...#...#.....#...#...#...#.#.......#.....#...#.........#.#
.#.#.#.#####.#####.#.#####.#.###.###.#####.#####.###.#######.#.#
.#.#.#.#...#.#...#.#.....#.#.#.#.#.#.....#...#...#...#...#.#.#.#
.#.#.#.#.#.#.#.#.#####.###.#.#.#.#.#####.###.###.#.###.#.#.#.#.#
.#.#.#.#.#.#...#...#...#...#.#.....#...#...#...#.#.#...#...#.#.#
.#.###.#.#########.#.###.###.#####.#.###.#.###.###.#.###.###.#.#
.#...#.#.....#...#.#...#.....#...#...#...#...#.....#...#.#...#.#
.###.#.###.#.###.#.###.#######.#.#####.#####.#########.#.#.###.#
.#.#...#...#...#.#...#.....#...#.......#...#.#.........#.#.....#
.#.#####.#####.#.###.#####.###.#########.#.#.#.#########.#######
...#.....#.#...#...#.#...#.....#...#...#.#.#.#...#.....#...#...#
##.#.#####.#.#####.#.#.#.#######.#.#.#.###.#.###.#.###.###.#.#.#
.#...#.....#.#.....#.#.#.......#.#...#.....#.....#.#.....#...#.#
.#####.#.###.#.#.###.#.#####.#.#.#######.#########.#.#########.#
.....#.#.#...#.#.#...#.#.....#...#.....#.#...#.....#...#.....#.#
.###.#.#.#.###.#.#.###.#.#########.###.###.#.#.###.#####.#.###.#
...#...#.......#.#.....#.............#.....#.....#.......#.....#
################################################################
