32
..G....#...#.......#...........#
##.###.#.#.#.#####.#######.###.#
...#.#.#.#...#.#...#.....#.#...#
.###.#.#.#####.#.###.###.###.#.#
...#.#...#.#...#.#...#.#...#.#.#
.#.#.#####.#.#.#.###.#.###.#.#.#
.#.#.......#.#.#.....#.......#.#
##.#######.#.#.#####.#########.#
...#...#...#.#...#...#...#.....#
.###.#.#.###.#.###.###.#.###.###
...#.#.#.....#.....#.#.#...#...#
.#.#.#.#####.#######.#.###.###.#
.#...#.....#.......#.#...#...#.#
.#########.#######.#.###.###.###
...#.....#...#...#.....#.#.#...#
##.#.###.###.#.#.#######.#.###.#
.#.#...#.....#.#.......#.#...#.#
.#.###.#######.#######.#.#.#.#.#
.#...#.......#.......#.#.#.#.#.#
.###.#######.###.#####.#.#.###.#
.#...#.....#...#.#...#.....#S#.#
.#.###.###.###.#.#.#.#######.#.#
...#...#...#...#.#.#.#.......#.#
.#####.#####.#.#.#.#.#.#######.#
...#...#.....#.#.#.#...#.......#
##.#.#.#.###.###.#.###########.#
...#.#.#.#...#...#...#.........#
.###.#.#.###.#.#####.###.#####.#
.#...#.#...#.#...#.#...#.#.#...#
.###.#.###.#####.#.###.#.#.#.###
.....#...#...........#...#.....#
################################
