32
.........#.....#S#.....#.......#
.#######.#.#.###.#.###.#.#####.#
.#.#.....#.#...#...#...#.....#.#
.#.#.#########.#####.###.###.###
.#...#.......#.....#.#.....#...#
.#.###.#.###.#.#.###.#########.#
.#.#...#...#.#.#.#...#...#.....#
.#.#####.#.#.###.#.###.#.#.###.#
.#.....#.#.#.....#...#.#...#.#.#
.#####.#.#.#########.#.#####.#.#
...#...#.#.........#...#.....#.#
##.#.#####.#######.#####.#####.#
...#.#...#.....#.#...#.#.......#
.###.#.#.#####.#.#.#.#.#.#######
...#.#.#.....#...#.#...#.#.....#
##.#.#.#####.#####.###.#.#.#.#.#
...#.#.#...#.....#.#...#.#.#.#.#
.###.#.###.#####.#.#####.#.#.#.#
.#...#...#.....#...#.....#.#.#.#
.#.###.#.###.###.###.#####.#.#.#
.#...#.#.#...#...#...#.#...#.#.#
.###.###.#.#.#.###.###.#.###.#.#
...#.....#.#.#.#.#...#...#...#.#
.#.#######.###.#.###.#.###.###.#
.#...#.........#...#.#...#...#.#
.###.#########.#.#.#.#####.#.###
...#.#.......#.#.#.#.....#.#...#
##.#.#.#####.#.#.#######.#####.#
G#.#...#...#.#...#.....#.......#
.#.#####.#.#.#####.###.#######.#
.........#.#.........#.........#
################################
