16
.....#.......#G#
.###.#.#####.#.#
.#.#...#...#.#.#
.#.#####.###.#.#
.#...........#.#
.#.###########.#
.#.....#.#.....#
.#####.#.#.#.#.#
.#S..#.#...#.#.#
.###.#.#####.###
.#...#.#...#...#
.#.###.#.#.#.#.#
.#.#.#.#.#.#.#.#
.#.#.#.#.#.###.#
...#.....#.....#
################
