16
.........#.....#
######.#.#####.#
.....#.#.....#.#
.###.#.#####.#.#
S#.#.#.....#...#
##.#.#####.###.#
...#.#.....#.#.#
.###.#.#####.#.#
.#...#.#.....#.#
.#.###.#.###.#.#
.#.....#.#...#.#
.#######.#####.#
.#.....#...#...#
.#.#.###.#.#.###
...#.....#..G..#
################
