64
.............#.....#.......#.....#.#.........#.................#
.#.#######.###.#.#.#.###.###.#.#.#.#.#.#####.#.#############.#.#
.#.#.....#.#...#.#.#.#.#.....#.#.#...#.#.....#.#.#...........#.#
.#.#.###.#.#.###.#.#.#.#######.#.###.#.#######.#.#.#############
.#.#.#...#.#.#...#.#.#.#.......#...#.#.......#...#.#...#.......#
.###.#.#####.#.###.#.#.#.#########.#######.#.###.#.#.#.#.#####.#
.....#.......#...#.#...#.#.#.....#.......#.#.....#.#.#...#...#.#
.###############.#.###.#.#.#.#.#.#######.#.#######.#.#####.#.#.#
...#.#.........#.#.#...#.#.#.#.#.#.....#.#...#...#.........#.#.#
##.#.#.#######.#.###.###.#.#.#.#.#.###.#.#.###.#.#.#########.#.#
.#.#.#.#.....#.#.#...#.#.#...#.#.#...#...#.#...#.#.#...#...#.#.#
.#.#.#.#####.#.#.#.###.#.###.#.#.###.#####.#.###.###.#.#.#.#.#.#
...#.#.....#...#.#.#...#...#.#.#...#...#...#.#.#.....#.#.#...#.#
.###.#####.###.#.#.#.#.###.###.#######.#.###.#.#######.#######.#
...#.....#...#...#...#...#...#.......#.#...#.#.....#...#...#...#
##.#.###.###.###########.###.###.#.###.#####.#.#####.###.#.#.#.#
...#...#...#.#.........#.#.#...#.#.#...#.....#.#...#...#.#...#.#
.#####.#.###.#.###.###.#.#.###.#.#.#.###.#####.#.#.###.#.#####.#
.......#.#...#.#.#.#...#.#.#...#.#...#...#...#...#.#...#.....#.#
.#######.#.###.#.#.#####.#.#.###.#####.###.###.###.#.###.###.#.#
.#...#...#.......#.........#.#.#...#.....#.....#.#...#...#...#.#
##.#.###.#########.#########.#.###.#.###.#.#####.#########.#####
...#...#...#.....#.#.....#...#...#.#...#.#.#.............#.....#
.#####.###.#.###.#.###.#.#.###.#.#.#####.#.#.###########.#####.#
...#...#...#.#...#...#.#.#.#.#.#.#...#...#...#...#.......#.....#
##.#.#######.#.#####.#.#.#.#.#.#.###.#.#######.#.#.#######.#####
...#.#.......#.....#...#.#.#.#.#...#.#.#.....#.#...#.....#.....#
.###.#.#.#########.#####.#.#.#.###.#.#.#.###.#.#####.#.###.###.#
.#.#.#.#.#.......#.#.....#.#.#.#...#...#...#.#.#...#.#.....#...#
.#.#.#.#.#.###.#.#.#######.#.#.#.#####.###.#.#.#.#.#########.#.#
.#...#.#.#...#.#.#.......#.#.#.#.........#.#S#...#.........#.#.#
.###.#.#.###.#.#########.#.#.#.###########.###############.#.###
...#.#.#.#.#.#.........#.#.#...#.....#...#.#.....#.....#...#...#
##.#.###.#.#.#########.#.#.#.###.###.#.#.#.#####.#.###.#.#####.#
...#.....#...#.........#.#.#.....#...#.#...#...#...#...#.....#.#
.#########.###.#######.#.#.###.#####.#.#####.#.###.#.#######.#.#
.....#...#.#...#.......#.#.#.#.#...#.#.#.....#...#.#.......#.#.#
.###.#.#.###.###.#######.#.#.#.#.#.###.#.#######.#######.#.#.#.#
...#...#...#...#.....#...#.#...#.#.....#...#...#.#.....#.#.#...#
##.#######.#.#.#.#####.###.#####.#########.#.#.#.#.###.#.#####.#
.....#.....#.#.#.#.....#...#.....#.........#.#...#.#.#...#.....#
.#####.#####.#.#.#.#####.###.#####.#####.###.#####.#.#.###.#####
...#...#.#...#.#.#.#.#.....#.....#.....#.#...#.....#...#...#...#
.###.###.#.###.###.#.#.###.#####.#######.#.###.#.###.###.#####.#
.#...#...#.#...#...#...#.......#...#.....#...#.#...#...#.......#
##.###.#.#.#.#.#.#######.###.#####.#.#######.#.###.###.#######.#
...#...#.#.#.#.#.........#...#.....#.#.......#...#...#.#.....#.#
.#######.#.#.#############.###.#####.#.#########.###.###.###.#.#
.....#...#.#.........#.......#.......#.#...#...#...#...#...#...#
.###.#.###.#######.###.###############.#.#.#.#.#######.###.#####
.#...#...........#.....#.............#.#.#...#.....#...#.#.#...#
##.#.#################.#.#######.#####.#.#########.#.#.#.#.###.#
...#.#...#...#...#...#.#.#...#...#.....#...#.#...#...#...#...#.#
.#####.#.#.#.#.#.#.#.#.#.#.#.#.#.#.#######.#.#.#.#######.###.#.#
.#.....#...#...#...#.#.#.#.#.#.#.#...#.....#...#.....#...#...#.#
.#.#################.###.#.###.#####.#.###.#####.###.#.###.###.#
.#...#.....#...#...#.....#...#.......#...#.#...#...#.....#.#...#
.###.#.#####.#.#.#.#########.#########.#.###.#.###########.#.#.#
.....#.#.....#.#.#...#...........#.#...#.#...#.....#.......#.#.#
######.#.#####.#.#.###.###.#####.#.#.###.#.#######.#.#########.#
...#...#.#G#...#.#.....#.#.....#...#...#.#...#...#.#.#...#...#.#
.###.#.#.#.#.###.#######.#####.#######.#.###.###.#.#.#.#.#.#.#.#
.....#.....#.................#.........#.........#.....#...#...#
################################################################
