64
...........#.............#...#.............#...................#
.#######.#.#####.###.###.#.#.#######.#####.#.###.#############.#
.....#...#.....#...#.#...#.#.#.......#...#.#...#.#.....#...#...#
.#####.#######.###.#.#.###.#.#.#######.###.#####.###.###.#.#.###
.#...#.....#...#...#.#.#...#.#.#.....#...#.....#...#.....#...#.#
.#.#.###.#.#.#######.#.###.#.#.#####.#.#.#####.###.#.#########.#
.#.#...#.#.#.........#.....#...#.....#.#.......#...#...........#
.#.###.###.#####################.###.#.#########.#.#############
.#.#...#...#...#.........#.#.....#...#.#.......#.#.#...........#
##.#.###.###.#.#.#######.#.#.###.#.###.#.#####.#.###.#########.#
...#.#.......#.#.#.......#...#...#...#...#...#.#.#...#...#.....#
.###.#######.#.#.###.#####.###.###.#######.###.#.#.###.#.#.###.#
.#...#.....#.#.#...#.#...#.#...#...#...........#.#.....#.#...#.#
.#.###.###.###.#.#.#.#.#.#.#.#######.###########.#.#####.###.#.#
.#.....#.#.....#.#.#.#.#.#.#.....#...#.......#.....#...#.#...#.#
.#######.###.#####.#.#.#.#.#####.#.#######.#.###.###.#.###.###.#
.#.#.........#...#.#...#.#.#.....#...#...#.#...#.#...#.#...#.#.#
.#.#.#########.#.#.#####.###.#.#####.#.#.#.###.#.#.###.#.###.#.#
.#.....#.....#.#.#.#...#.....#.#.....#.#...#...#.#.#.....#.....#
.#######.###.#.#.#.#.#.#######.#.#####.#####.#####.###########.#
.....#...#.#...#.#...#...#...#.#.....#.#.#.........#.........#.#
.###.#.###.#####.#.#####.###.#.#####.#.#.#.#########.#####.#.#.#
.#...#...#.....#.#.....#.#...#.#.#...#.#.#.#.#.....#.#...#.#.#.#
.#.#.###.#.###.#.#.#####.#.#.#.#.#.###.#.#.#.#.###.#.#.#.###.#.#
.#.#...#.#...#.#S#.#.....#.#.#...#...#.#.#...#.#.#...#.#...#.#.#
.#.###.#.#####.#####.#####.#####.###.#.#.#.###.#.#####.###.#.###
.#.#.#.#.#.......#...#.........#...#.#.#...#...#.#.....#.#.#...#
##.#.#.#.#.#####.#.###.#####.#.###.#.#.#####.###.#.#####.#.###.#
...#.#.#.#.#.#...#.#.#...#.#.#...#.#.#.....#.#...#.#...#.......#
.###.#.#.#.#.#.###.#.###.#.#.#####.#.#.###.#.#.#.#.###.#.#####.#
.#.....#.#.#.#.#...#.....#.#.......#.#.#...#.#.#.#...#...#...#.#
.#.#####.#.#.#.#.###.#####.#########.###.###.#.#####.#####.#.###
.#...#...#.#...#...#.#...#.....#...#...#.......#...#...#...#...#
.#####.###.#.#####.#.#.#.#.###.#.#####.#########.#.###.#.#####.#
.#.....#...#.......#...#.#.#.#...#.....#.......#.#...#...#...#.#
.#.#######.#############.#.#.###.#.#####.#####.#.###.#####.#.#.#
.#.#.....#...#...#.....#...#.#...#...#.......#...#.#.#.....#.#.#
.#.#.###.###.#.#.#.###.#####.#.#####.###.###.#####.#.#.#####.#.#
...#...#.....#.#...#.....#...#.#...#...#...#.#.....#...#.#...#.#
######.#############.###.#.#.#.#.#####.###.#.###.#.#####.#.###.#
.......#...........#.#...#.#.#.#...#...#.#.#...#.#.....#...#...#
####.#.#.#########.#.###.#.#.#.#.#.#.###.#.###.#.#####.#.#####.#
.....#.#.#.......#.#...#...#.#.#.#.#...#.#...#.#.#.#...#...#...#
.#####.#.#######.#.###.#####.#.#.#.###.#.###.#.#.#.#.#####.#.#.#
.#.#...#.....#...#...#.....#.#.#.#...#.#.....#.#...#.#...#...#.#
.#.#.#######.#.#.###.#.###.###.#####.#.#######.###.#.#.#.#####.#
.#.....#...#.#.#...#.#.#.#...#.....#.#...#.....#...#.#.#...#...#
.#######.#.#.#.#####.#.#.###.#####.#.###.#.#########.#.#.###.###
.......#.#.#.#.....#.#...#.#.....#.#.#...#...#.....#.#.#.....#.#
.#####.#.#.#.#.###.#.###.#.#.#####.#.#.#####.#.###.#.#.#######.#
.....#...#...#...#.#...#...#.........#.....#.....#.#...#.....#.#
########.#######.#.###.###################.#######.###.#.###.#.#
.......#.....#...#...#.....#.......#.....#.......#...#.#.#..G#.#
.#####.#####.#.###.#.#####.#.#####.#.#.#########.#.#.#.#.#.###.#
.#.....#.....#.#...#.#.....#.....#.#.#.........#.#.#.#...#.#...#
.#.#########.###.#.###.#########.#.#.#####.###.#.#.#.#####.#.#.#
.#.........#.....#.#...#.......#.#...#...#.#...#.#.#.#...#.#.#.#
.#########.#########.###.###.###.#####.###.#.###.#.#.###.#.#.#.#
.#.....#.............#...#.#.....#.....#...#.#...#.#.#...#.#.#.#
.#.###.#.#######.#####.###.#########.#.#.###.#.#####.#.###.#.#.#
.#.#...#.#...#...#...#.#.........#...#.#.#...#...#...#...#.#.#.#
.#.#.#####.#.#####.#.#.#######.#.#.###.#.#######.#.###.#.#.###.#
...#.......#.......#...........#...#...#...........#...#.......#
################################################################
