8
G......#
##.###.#
...#...#
.#.###.#
.#.#S#.#
.###.#.#
.....#.#
########
