32
.........#...........#.....#...#
##.#####.#####.#.#####.#.#.###.#
...#...#.....#.#.......#.#...#.#
.###.#.#####.###########.###.#.#
.#...#.#.........#...#...#.#...#
.#.###.#########.#.#.#.###.###.#
...#.#.....#...#.#.#.#.#.......#
####.#####.###.#.#.#.#.#.#######
.....#...#..S#...#.#.#.#.#.....#
.###.#.#.#####.###.#.#.#.#.#.#.#
...#...#.....#.....#...#.#.#.#.#
.#.#####################.#.#.###
.#...#.................#.#.#...#
####.#.###############.#.#####.#
.....#.#.....#.........#.......#
.#####.#.#####.###############.#
.......#.....#.......#.....#...#
.#######.###.#######.#.#.###.###
.#...#...#...#.....#...#.#...#.#
.#.#.#####.#.###.#######.#.###.#
.#.#.....#.#.....#.....#...#...#
.#.#####.#.###.###.#.#######.#.#
.#.....#.#.#...#...#.........#.#
.#####.#.#.#.###.#############.#
.....#.#.#.#...#.#.....#.....#.#
####.#.#.#.#####.#.###.#.###.#.#
...#...#.#.......#.#...#...#...#
.#.#####.#####.###.#####.#.###.#
G#.....#.#...#.....#...#.#...#.#
.###.###.#.#.#######.#.#####.#.#
...#.......#.........#.......#.#
################################
