16
...#..........G#
.#.#.#####.#####
.#.#.#...#.....#
.###.#.#.#####.#
.....#.#.......#
.#####.#########
.#...#.#.......#
.###.#.#.#.#####
...#.#S#.#.....#
##.#.#######.#.#
.#.#.......#.#.#
.#.#.#####.###.#
.#.#.#.....#...#
.#.#.#.#####.#.#
.....#.......#.#
################
