32
G....#.....#...#...............#
.#.#.#.###.#.#.#.#########.#####
.#.#.#...#...#...#.........#...#
.#.#.#.#.#.#################.#.#
.#.#.#.#.#.#...#.....#.......#.#
.#.#.###.#.#.#.#.###.#.#######.#
.#.#.....#.#.#.#...#.#.#.....#.#
.#.#######.#.#.#.#.#.#.#.#####.#
.#.#.....#.#.#.#.#.#.#.#.#.....#
.#.#.###.#.#.#.###.#.#.#.#.#####
.#.#.#...#.#.#...#.#...#...#...#
.#.#.#.###.#.###.#.#####.#####.#
.#.#.#...#.#...#.#.#...#.....#.#
.#.#.###.#####.#.#.#.#.#####.#.#
.#.#.#.........#...#.#.....#...#
##.#.#.###############.#######.#
...#.#.#...#...........#...#...#
.###.###.#.#######.#.###.#.#.###
...#.....#.......#.#.....#.#.#.#
.#.#############.#.#######.#.#.#
.#...........#.#.#.......#...#.#
.#######.###.#.#.#######.#####.#
.#...#...#.....#S#.....#.#...#.#
.#.#.#.###########.###.#.#.#.#.#
.#.#.#.............#...#...#.#.#
.#.#.###############.#######.#.#
.#.#.........#.......#.....#.#.#
.#####.###.#.#.#####.#.###.#.#.#
.....#.#...#.#.#...#.#.#.#...#.#
####.###.###.#.#.#.###.#.#####.#
.........#...#...#.............#
################################
