32
.............#...............#.#
.###.#######.#.#############.#.#
G#.#.......#...#.......#...#...#
.#.#######.#####.#####.#.#.###.#
.#...#...#...........#.#.#...#.#
.#.#.###.#############.#.#####.#
...#.....#.....#.....#.#...#...#
########.#.#####.###.#.#.#.#.###
.......#.#.#...#.#.#...#.#.....#
.#.#####.#.#.#.#.#.#####.#######
.#.#.....#...#.#.#.........#...#
.#.#.#########.#.###########.#.#
.#.#.#.........#.......#.....#.#
.###.###.#####.#######.#.#####.#
.........#.......#.....#.#.#...#
.###########.#####.###.#.#.#.#.#
.#.........#.#...#.#...#.#.#.#.#
##.#######.###.#.#.#####.#.#.###
...#.....#.#...#S#.........#...#
.###.#.#.#.#.###########.#####.#
.#...#.#.#...#.........#.#...#.#
.#####.#.#####.#######.###.#.#.#
.....#.#.....#.....#...#...#...#
####.#.#####.#####.#.###.#####.#
...#...#.#...#.....#...#.....#.#
##.#####.#.###.#######.#####.#.#
...#.....#.....#.....#...#...#.#
.###.###.#######.#.#####.#.#####
...#.#.#.#.......#...#...#.....#
.#.#.#.#.#.#########.#.#######.#
.#.....#...........#...........#
################################
