32
.#...#.....#...#...#...........#
.#.#.#.#.#.#.#.#.###.#.#######.#
...#.#.#.#...#...#...#.#.......#
.###.#.#.#########.###.#.#######
.#.#.#.#.......#.....#.#...#...#
.#.#.#.#######.#.#####.###.#.#.#
...#.........#...#...#...#.#.#.#
##.#########.#####.#.###.###.#.#
.....#..S#.#.#.....#...#.....#.#
.#####.###.#.#.#######.#.#####.#
.#.....#...#.#.....#.#.#...#...#
##.#####.#.#.#####.#.#.###.#.#.#
...#.#...#.#...#...#.#...#.#.#.#
.###.#.###.###.#.###.###.###.#.#
...#.....#.....#...#...#.....#.#
##.#####.#########.#.#.#######.#
.#.#...#...#...#...#.#.......#.#
.#.#.#.#.###.#.#.#######.#####.#
...#.#.#.#...#.#.#.....#.#...#.#
.###.#.###.###.#.#.###.#.#.#.#.#
.....#...#.#...#.#.#...#...#G..#
########.#.#.###.#.#.###.#######
...#...#...#.#...#.#...#.#.....#
.###.#.#####.#.#.#.###.###.###.#
.....#.....#.#.#.#...#.......#.#
.#########.#.###.###.#########.#
.#.......#.#...#.......#.......#
.###.###.#.###.#########.#####.#
.....#.#.#.#...#.........#.#...#
######.#.#.#.###.#########.#.###
.........#.......#.............#
################################
