64
.......#.....#.........#.........#...............#.........#...#
.#####.#.###.#######.#.#.#####.#.#######.#######.#.#######.#.#.#
.#...#...#.#.#.......#.#...#...#.#.......#.#.....#.......#...#.#
.#.#.#####.#.#.#######.#####.###.#.#######.#.#####.#####.#####.#
...#...#...#.#.#...#...#.....#.#...#.......#...#.#.#...#.#...#.#
####.#.#.#.#.#.#.#.#.###.#####.#####.#.#######.#.#.#.###.#.###.#
...#.#.#.#.#...#.#.#...#.#.......#...#.#.....#.#.#...#...#G..#.#
.#.###.#.#.#.#####.###.#.#.###.###.#.###.#.#.#.#.###.#.###.#.#.#
.#.....#.#...#...#.......#.#...#...#.....#.#.#.#.....#...#.#...#
.#######.#####.#.#########.#.###.#########.###.#.#######.#.#####
.#.........#...#.........#.#.#...#.......#...#.#.#.#.....#.....#
.#.#########.###########.#.###.#########.###.#.#.#.#.#########.#
.#.#.............#.....#.#.....#.....#.....#...#...#...#.....#.#
.###.#############.###.#.#.#####.#.#.#.###.###########.#.###.###
...........#.....#.#.....#.....#.#.#.#.#.#...........#.#.#.#...#
############.###.#.###########.###.#.#.#.###########.#.#.#.###.#
.............#...#.....#.#...#.....#...#.......#.....#...#...#.#
.#############.#######.#.#.#.###########.#####.#.#######.#.###.#
.#...#.....#...#.......#.#.#.....#.......#.....#.......#...#...#
.#.#.#.#.#.#.###.#######.#.###.#.#.#######.#.#########.###.#.#.#
...#.#.#.#.#.#.......#...#.#.#.#.#...#...#.#.#.......#.#...#.#.#
.###.###.#.#.#.#####.#.#.#.#.#.#####.#.#.#.###.###.#.#.#.###.#.#
...#.#...#.#.#.....#.#.#.#...#.....#.#.#.#...#...#.#.#.#...#.#.#
.###.#.#####.#####.#.#.###.#######.#.#.#.###.#.###.###.###.#.###
.#...#...#...#.....#.#.....#.....#.#.#.#.#...#.#...#...#...#...#
.#.###.#.#.#########.#.#####.###.#.#.#.###.#.#.#.###.#######.#.#
.#.#...#...#.......#.#...#.#...#.#.#...#...#.#.#...#.......#.#.#
.#.#.#########.###.#.###.#.###.#.#.###.#.#.###.###.#######.###.#
.#.#.#...#.....#...#...#...#...#...#...#.#.#...#.#.#.....#.#...#
.#.#.#.#.#.#####.#####.###.#.###.###.###.###.###.#.#.#.###.#.###
.#.#...#...#...#.......#.#.#...#.#.....#...#.#...#...#...#.#...#
.#.#########.###########.#.###.###.#######.#.#.#########.#.###.#
.#.......#...#.........#...#.#.....#.....#.#.#.......#...#...#.#
.#######.#.###.#.#######.###.#######.###.#.#.#######.#.#####.#.#
...#.....#.#...#.#.............#...#...#.#...........#.......#.#
##.#.#####.#.###.#.###########.#.#.###.#.#.#########.#########.#
...#.#...#...#.#...#.....#...#.#.#.....#.#.#...#...#.#.........#
####.###.#.###.#####.#####.#.#.#.#.#####.###.#.###.#.#.#######.#
...#...#.#...#.......#.....#.#.#.#.#...#.....#.#...#.#.....#...#
.#.###.#.###.#.#######.#####.#.#.###.#.#######.#.###.#.#####.#.#
.#.....#...#.#.....#...#.....#.#.....#.....#...#.....#.#.....#.#
.#######.#.#.#####.#.###.#####.#####.#####.#.#######.#.#.#######
.......#.#.#.....#.#.#.......#.#...#.....#.#.......#.#.#.#.....#
.#####.###.#####.#.#.#######.#.#.#.###.###.#######.#.###.#.###.#
...#.#...#.#.....#.#...#...#.#.#.#.#...#...#...#...#...#.#...#.#
##.#.###.#.#.#####.###.###.#.###.#.###.#.###.###.#####.#.###.#.#
...#...#.#.#...#.....#..S#.#.....#...#.#.#.#.....#.......#...#.#
.###.###.#.###.#####.#####.#########.###.#.#.#######.#####.###.#
...#...#.#...#.....#...#...#...#...#.....#...#.....#.#.....#.#.#
##.###.#.###.#####.#.#.#.#.#.#.#.#.#######.###.###.###.#####.#.#
...#...#...#.#...#.#.#...#.#.#...#...#...#...#...#.....#...#...#
.###.#####.#.#.#.#.#.#####.#.#######.###.###.#.#.#######.###.###
.#.#...#...#...#...#.....#.#.....#.#...#...#.#.#.#...#.....#.#.#
.#.#.#.#.#####.#########.#.#####.#.###.###.#.#.#.#.#.#####.#.#.#
.#...#.#.....#...#.......#.#.....#...#.#...#.#.#...#.#.....#.#.#
.#####.#####.###.###.#####.#.#######.#.#.#.#.###.###.#.###.#.#.#
.....#...#...#.....#...#.....#.....#.....#.#...#.#...#.#...#.#.#
####.#.#.#.#######.###.#.#####.###.#.#####.###.###.###.#.###.#.#
...#...#.#.......#.....#.#.....#.#.#.#...#...#.....#...#...#.#.#
.#.#####.#######.#.#######.#####.#.###.#.#############.###.#.#.#
.#...#...#.#.....#.#...#...#.....#.#...#.#.....#.......#...#.#.#
.###.#.###.#.#######.#.#.###.###.#.#.###.#.###.#.#.#########.#.#
...#.......#.........#.......#...#.....#.....#...#.............#
################################################################
