16
.#.....#.......#
.#.#.###.#####.#
...#...#...#...#
######.###.#.###
.......#S..#...#
.#############.#
.#.............#
.#.#############
...#.....#.....#
.###.###.#.###.#
.#...#...#...#.#
.###.#.#####.#.#
G....#...#...#.#
########.#.###.#
...........#...#
################
