16
...............#
##.###########.#
...#.......#...#
.###.#.###.#.###
...#.#.#...#...#
##.###.#.#####.#
.#.#...#...#.#.#
.#.#.#####.#.#.#
.#.#.#.......#.#
.#.#.#####.###.#
.#S#.....#.#...#
.###.###.#.#.###
...#.#.#.#.#...#
.###.#.#.#####.#
.......#......G#
################
