32
.........#...#.............#...#
.###.#####.#.#.#########.###.#.#
...#.#.....#...#...#.#...#...#.#
.#.###.#######.#.#.#.#.###.###.#
.#.......#...#...#...#.......#.#
.#########.#.#####.###########.#
.#...#...#.#...#...#........G#.#
##.#.#.#.#.###.#.###.#######.#.#
...#...#...#...#...#.#...#...#.#
.###.#######.#######.###.#.###.#
.#...#.....#.....#...#...#.#...#
.#.###.###.#####.#.###.###.#.#.#
.#...#.#.....#...#.#...#...#.#.#
.###.#.#####.#.###.###.#.###.###
.#...#...#.#.#.....#...#...#...#
.#.#####.#.#.#######.#.###.#.#.#
.#.....#.#.#.#.......#...#.#.#.#
.#######.#.#.#####.#####.#.#.#.#
.....#...#.......#.#.....#.#.#.#
####.#.#########.#.#####.#.###.#
.....#....S#.....#.#...#.#.#...#
.#.#########.#####.#.#.###.#.#.#
.#.#.......#...#...#.#...#.#.#.#
.###.#.###.###.###.#.###.#.#.#.#
.....#...#...#...#.....#.#...#.#
########.#.#####.#####.#.#####.#
...#...#.#.#...#.....#.#.#...#.#
.#.#.#.#.###.#.#####.#.#.#.#.#.#
.#...#.#.....#.......#.#.#.#.#.#
.#####.###############.#.#.#.#.#
.....#.................#...#...#
################################
