64
.........#.......#.........#...........#.......#.......#.......#
.#.#######.#.#####.#####.###.###.#####.#####.#.#.#.#####.#.#####
.#...#...#.#...#.......#.#...#...#...#.....#.#.#.#.......#.....#
.###.#.#.#.###.#.#######.#.###.###.#.#####.#.###.#############.#
...#...#.#.#...#.#.......#.#.#...#.#...#...#.....#.......#.....#
.#######.#.#.###.#.#######.#.###.#.###.#.###.#########.###.###.#
.#.......#.#.....#...#.........#.#...#...#.......#.....#...#...#
.#.###.###.#########.#.#######.#.###.#####.#####.#.###.#.#######
.#...#.#.......#...#.....#...#.#.#...#.....#...#...#...#.......#
.###.###.#######.#.#######.#.###.#.#########.#.#######.#######.#
.#...#...#.......#.......#.#.....#...#.....#.#.......#.#.#...#.#
.#.###.###.#######.#####.#.#########.#.###.#.#######.#.#.#.#.#.#
.#.......#.....#.#.#S#.#.#...#.....#.#.#.#...#.....#.#...#.#.#.#
.###########.#.#.#.#.#.#.#.#.#.###.#.#.#.#####.###.#.#####.#.#.#
.....#.....#.#.#...#.#.#.#.#.#...#.....#.......#.#...#.....#.#.#
####.#.###.###.#####.#.#.###.#.#########.#######.#####.#####.#.#
.....#...#.#...#...#.#.......#.#.....#.#.....#.........#.....#.#
######.#.#.#.###.#.#.#######.###.###.#.#####.#.#.#######.#####.#
.....#.#.#...#...#.#.......#.#...#.#.#.....#.#.#...#.#...#.....#
.###.#.#.###.#.###.#######.###.###.#.#.###.#.#.###.#.#.#####.###
.#...#.#.#...#.#.#.....#...#...#...#.#...#.#.#.#...#.#.#...#...#
.#.#####.###.#.#.#.###.#.###.###.###.###.#.#.###.###.#.#.#.###.#
.#.....#...#.#...#...#.#.....#.......#...#.#.....#...#.#.#.#...#
.#####.###.#.###.###.#########.#######.###.#######.#.#.#.#.#.#.#
...#...#...#...#...#.........#.#.......#.......#...#.#...#.#.#.#
##.#.###.#########.#####.#####.#########.#####.###.#.#####.#.#.#
...#.....#.......#.#...#.....#.#.........#...#.....#.#...#.#.#.#
.###.#####.#####.#.#.#.#####.#.#.#########.#########.#.###.#.#.#
.#...#...#...#.#.#.#.#...#...#.#.#.....#.........#...#.#...#.#.#
.#.###.#.###.#.#.#.#####.#.###.#.#.###.#.#####.###.###.#.###.###
.#.#...#...#...#...#.....#.....#...#...#...#...#...#...#.#.....#
.###.#####.###.#####.#############.#.#######.#.#.#####.#.#.###.#
.....#...#.....#.#...#...#.......#.#...#.....#.#.......#.#...#.#
########.#######.#.#.#.#.#.#.###.#####.#.#############.#.#.###.#
...#.............#.#.#.#...#.#.........#.#...........#.#.#.#...#
.#.#.#.###.#####.#.#.#.#####.###########.#.#########.#.#.#.#.###
.#...#...#.#...#.#.#.#.#...#.......#.....#.#...#.....#.#.#.#...#
.#######.###.#.###.#.#.###.#######.#.#####.#.#.#.#####.#.#####.#
.#.....#.....#.....#.#...#.......#.#.........#.#.......#.......#
.#.###.#############.###.###.###.#.#.#######.#################.#
.#...#.....#...#...#.........#.#.#.#...#...#.#.........#.....#.#
.#########.#.#.#.#.###########.#.#.#####.#.###.#######.#.#.###.#
...#.......#.#...#.#.........#.#.#.......#.....#.......#.#...#.#
##.#.#.#####.#####.#.#######.#.#.###############.#####.#.###.#.#
.#.#.#.#.....#.......#.....#.#.......#.#.....#...#...#.#.#.#.#.#
.#.#.#.#.#############.#.#.#.#.#####.#.#.###.#.###.#.###.#.#.#.#
.#...#.#...........#...#.#.#.#.#...#...#.#...#.#...#...#...#...#
.#####.###########.#.###.#.#.###.#.#####.#.###.#.#####.###.#####
.....#...#...#...#.#.#.#.#.#.....#.......#.....#...#.....#.#...#
.###.###.#.#.#.#.#.#.#.#.#################.#######.#.#####.#.#.#
.#.#...#.#.#...#.#.#...#.........#.......#.#...#...#.....#.#.#.#
.#.###.#.#######.#.#########.#####.#####.#.#.#.#.#######.#.#.#.#
.....#...#.......#.....#...#.....#.....#...#.#...#.....#.#.#.#.#
####.#####.#####.#####.#.#.#####.#.#######.#.#########.#.#.###.#
...#.....#.#.......#.#...#.#...#...#.....#.#...#.....#.#...#...#
##.#####.#.#######.#.#####.#.#.#####.###.#.###.#.###.#.#####.###
...#.....#.#...#.#.....#...#.#.....#...#.#...#...#...#...#.....#
.###.#####.#.#.#.#####.#.###.#####.#.###.###.#####.###.#.#####.#
.....#...#...#.#.....#.#...#.....#...#...#...#...#.....#.......#
.#####.#.#####.#.#.###.###.#####.#####.#####.#.#.#############.#
.#.....#.......#.#.....#.#.......#...#.#...#.#.#.............#.#
.#.#############.#######.#########.#.#.#.#.###.#.#############.#
...#...............................#.#...#.....#....G..........#
################################################################
