64
.......#...........#...............#...#.........#.........#...#
.#.###.#.###.#####.#.#.###########.#.###.###.#####.###.###.###.#
.#...#.#...#...#...#.#.#...#.......#.....#...#...#...#...#...#.#
####.#.###.###.#.#####.#.#.#.#######.#####.#.#.#.###.###.###.#.#
...#.#.#...#...#...#...#.#.#...#...#.#...#.#.#.#.....#...#.....#
.#.#.#.#####.#####.#.###.#####.#.#.#.#.#.#.###.#######.#######.#
.#...#.....#.#...#...#.#...#...#.#.....#.#.....#.....#.....#.#.#
.#########.#.#.#######.#.#.#.###########.#########.#######.#.#.#
...#.....#...#.........#.#.#.....#...#...........#.......#.#...#
.#.###.#.#####.#.#######.#.#####.#.#.#####.#####.###.###.#.#.###
.#...#.#.....#.#.........#.....#...#...#...#...#...#.#...#.#...#
.###.#.#######.###########.###########.#####.#.###.#.###.#.###.#
.#...#...#...#.........#.#.#...........#.....#.#...#...#.#.#...#
.#.#####.#.#.#########.#.#.#.###########.#####.#.###.#.#.#.#.###
.#.....#...#.........#.#.#...#.............#.#.#.#...#.#.#.#.#.#
.#####.#.#########.###.#.#########.#######.#.#.#.#####.#.#.#.#.#
...#...#.....#...#.#...#.........#.#.......#.#.#.#.....#.#.#...#
####.#######.#.###.#.#####.#####.###.#######.#.#.#.#######.###.#
.....#.....#...#...#.#.....#...#...#.#.......#.#...#.....#.#.#.#
.#######.#.###.#.#.#.#.#####.#.###.#.#####.#.#.#####.###.#.#.#.#
.#.......#.#...#.#.#...#...#.#.....#.#...#.#.#.....#.#.....#...#
.#.#.#######.###.#.#.###.#.#.#######.#.#.#.#######.#.#.#########
.#.#.#...#.....#.#.#.#...#.#...#.....#.#...#.........#.#.......#
.#.###.#.#.#####.#.#.#.###.###.###.###.#####.#########.#.#####.#
.#.....#...#.....#.#.#...#.#.....#.#.#...#...#...#.....#...#.#.#
.#########.#.#######.###.#.#####.#.#.#.#.#.###.#.###.#####.#.#.#
...#.....#.#.#.......#.#.#S#...#...#.#.#.....#.#...#.#.....#.#.#
.#.#.###.###.#.#######.#.###.#.#####.#.#######.###.###.#####.#.#
.#.....#...#.#.#.......#.....#.#...........#...#.#.....#.......#
##########.#.#.#.#.###########.#.###########.###.#######.#######
.....#.....#.....#.#.......#...#.#...#.......#...#.......#.....#
.###.#.###.#####.###.#####.#.#####.#.#.#########.#.#######.###.#
.#.#...#...#...#.#...#.....#...#...#...#.........#.#.......#...#
.#.###.#####.#.#.#.###.###.###.#.#######.#####.###.#.#.#####.###
.#...#.#.....#.#.#.#.#.#...#.#...#.....#.....#.#...#.#...#...#.#
.###.#.#.#####.#.#.#.#.###.#.#########.#.###.###.###.###.###.#.#
...#...#.#.#...#.#...#...#.............#...#...#.#.#...#...#...#
.#.#####.#.#.#.###.#####.#######.#####.#.#####.#.#.###.###.###.#
.#.#...#...#.#.#...#...#...#.....#...#.#.#.....#.#.....#.#...#.#
.#.#.#.###.#.#.#.###.#.#.#.#.#####.#.###.#.#####.#.#####.###.###
.#.#.#.....#.#.#...#.#.#.#.#.#...#.#.....#.....#.#.#.......#...#
##.#.#######.#####.#.#.###.#.#.#.#.###########.#.#.#.#.#####.#.#
...#.....#...#...#.#.#.#...#.#.#...#...#...#...#.#...#.#...#.#.#
.#######.#.###.#.#.#.#.#.#.###.#####.#.#.#.#.###.###.###.#.#.#.#
.#.......#.#...#.#.#.#...#.#...#.....#.#.#.#.#...#...#...#.#.#.#
.#.#######.#.###.#.#.#######.#####.#####.#.#.#.###.###.###.#.#.#
.#.#...#.#.#.#.#...#.#.............#.....#...#.#.#.#...#...#.#.#
.#.#.#.#.#.#.#.#####.#.#############.#####.###.#.#.#.###.#####.#
.#.#.#...#.#.#.....#...#.#...........#.....#...#...#.#...#.....#
.#.#.###.#.#.#.###.#####.#.###########.#####.###.###.#.###.#####
.#.#...#.#...#.#...#.....#.#.............#...#...#.#.#...#.#...#
.#.#.#.#########.#.#.#.#.#.###############.###.###.#.###.#.#.#.#
.#.#.#.....#.....#.#.#.#.#.#.........#.....#.......#...#.#.#.#.#
.#.#####.#.###.###.###.###.#.#######.#.#####.#########.#.#.#.#.#
...#.....#...#.#.....#.#...#.....#...#...#...#.......#.#.#...#.#
.###.#######.#.#####.#.#.#####.###.#.###.#.###.#####.#.#.#####.#
...#.#...#...#.#...#...#.......#...#.#.#.#.#...#...#...#.#.....#
##.#.#.#.#.###.#.#.#############.###.#.#.#.#.#####.#####.#.###.#
.#...#.#.......#.#...............#.....#.#.#...#.......#...#G#.#
.#####.#########.#######################.#####.#.###########.#.#
...#...#...#.....#...#.........#.......#.......#...#.....#.....#
.#.#.#####.#.#####.#.#.#######.#.#####.#########.#.#.#.###.#####
.#.........#.......#.........#.......#...........#...#.........#
################################################################
