8
...#...#
.###.#.#
.#S#.#.#
.#.#.#.#
.#...#.#
.#####.#
......G#
########
