16
.#.......#.....#
.#.#.#.###.#.#.#
G..#.#.#...#.#.#
####.#.#.###.#.#
.....#.#.#.#.#.#
.#.#####.#.#.#.#
.#.#.......#.#.#
.#.#.#######.###
.#.#.#.#..S#...#
.###.#.#.#####.#
...#...#.#.....#
.#.###.#.#.#####
.#...#.#...#...#
.#.###.#######.#
.#.............#
################
