64
.......#.......#...#.........#.....#.......#.............#.....#
.#.###.#.#####.#.#.#####.###.#.###.#.#######.#######.###.#.#####
.#...#...#.......#.....#.#.#.#...#.#...........#...#.#.#.#.#...#
####.#################.#.#.#.###.#.###.#########.#.#.#.#.#.#.#.#
...#...#...#.......#.....#.#.....#...#...#.......#...#.#.#...#.#
.#.#.#.#.#.#.#####.#######.#.#######.#####.###########.#.#####.#
.#.#.#...#.#.#...#.....#...#.#.....#.#.....#.......#...#.#.....#
.#.#######.#.#.#.#####.###.#.#.###.#.#.#######.#####.#.#.#.###.#
.#.#.....#.#S#.#.....#...#...#.#.#.#.#...#...#.......#.#...#...#
.#.#.###.#.###.###.#####.#####.#.#.#.#.#.#.#.#.#######.#####.###
.#.#...#...#.....#.#.....#.....#.#.#.#.#...#.#.#.....#.....#...#
.#.###.###.#####.###.#####.#####.#.#.###.###.#.#.###.#####.###.#
.#...#.#.#.#...#...#.#.....#.....#.#...#...#.#.#.#.......#.....#
.###.#.#.#.#.#.###.#.#.###.###.#.#.###.#####.#.#.#.#####.#######
.#...#.#...#.#.#...#.#...#.#...#.#...#.....#.#.#.#.....#...#...#
.#.###.#.###.#.#.###.#####.#.###.###.#####.#.#.#######.###.#.#.#
.#.#...#.....#...#...#.....#...#.#...#.#...#.#.......#...#.#.#.#
.#.#.###########.#.###.#####.#.#.#.###.#.###.#######.###.#.###.#
.#...#...#.......#...#.#.....#.#.#...#.#.#.........#.....#.....#
.#####.#.#.#########.#.###.###.#####.#.#.#.#######.###########.#
.#.....#.#.#.......#.#...#.#.#.....#.#.#.#.....#...#...#.....#.#
.#.#####.#.#.#####.#.###.#.#.#####.#.#.#.#######.###.#.#.#.###.#
.#.#...#.#.#...#.#.#.....#...#...#...#...#.......#...#...#.....#
.#.#.#.#.#####.#.#.#########.#.#.#######.#.#######.###########.#
...#.#.#.....#...#.........#.#.#.......#.#.#.......#.#...#...#.#
.#####.###.#####.#######.###.#.###.###.#.#.#.#######.#.#.#.#.###
.#.......#...#...#.....#.#...#...#...#.#...#...#.....#.#.#.#...#
.#.#####.###.#.#####.###.#.#########.#.#######.#.#.###.#.#.###.#
.#.#.#...#.#.#.#.....#...#...........#...#...#.#.#...#.#...#...#
.#.#.#.###.#.#.#.#####.#.###############.#.###.#####.#.#####.###
.#.#.....#.#...#...#...#.#.............#.#.#.........#.#...#...#
.#.#####.#.#######.#.###.#######.#####.#.#.#.#######.#.###.###.#
...#...#...#.......#...#...#...#.#.#...#.#.#.#...#...#...#.....#
##.#.#.###.###.###.###.###.#.#.#.#.#.###.#.#.#.#.#######.#.#####
.#.#.#...#.#...#.....#...#...#...#.#.#.#.#...#.#.........#.#...#
.#.#.###.#.#.#######.###.#########.#.#.#.#####.###########.#.#.#
...#...#.#.#...#...#.#...#...........#.#.....#.#...#.....#...#.#
######.#.#.#.#.#.#.###.#########.#####.#####.#.#.###.###.#####.#
.....#.#.#.#.#...#...#.#.......#.#.........#.#.#...#...#.....#.#
.###.#.#.#.#####.###.#.#.#####.#.#########.#.#.###.###.###.#.#.#
.#.#...#.#.#...#...#.#.......#.#...#.....#.#...#...#...#...#.#.#
.#.#####.#.#.#.#####.#########.###.#.###.#.#####.###.###.###.#.#
.#...#...#...#.......#...#.....#.....#...#.....#...#.#.#.#...#.#
.###.#.#######.#####.#.#.#.###.#######.###.###.#.#.#.#.#.#####.#
...#.......#...#...#...#.#...#.#...#...#...#...#.#.#...#.....#.#
.#.#######.#####.#.#####.###.###.#.###.###.#.#####.###.#####.#.#
.#.....#.#.#.....#.#...#.#.#.....#...#.....#.......#.#.....#...#
.#####.#.#.#.#####.#.#.#.#.#####.###.#############.#.#####.#####
.....#.#...#...#.#.#.#.....#...#.#...#.#...#.....#.....#...#...#
####.#.#.#####.#.#.#.#######.#.###.###.#.#.#.#.###.#####.#####.#
...#.#.#.#.....#.#.#.#.#.....#...#.#.....#...#.#...#.....#.....#
.#.###.#.#.#####.#.#.#.#.#######.#.#.#########.#.###.#######.###
.#...#.#...#.....#.#...#...#.....#.#.......#.#...#.#...#...#...#
.###.#.#####.#.###.#.#####.#.#####.#.#####.#.#####.###.#.#.#.#.#
...#...#.#...#.....#.#.....#.#.....#.#...#...........#...#.#.#.#
.#.#####.#.###########.#####.#.###.###.#.#################.###.#
.#...#.#...........#...#...#...#...#...#..G..............#.#...#
.###.#.#.#########.#.#.#.#.#########.#################.###.#.#.#
...#.#...#...#.......#.#.#...#.......#.#...........#...#...#.#.#
##.#.#####.#.###########.###.#.#######.#.#.#######.#.#.#.###.#.#
.#.#.#.....#.#.........#...#.#.#.....#.#.#.#...#.....#.#.#...#.#
.#.#.#.#####.#.#######.###.#.#.#.###.#.#.###.#.#########.###.#.#
...#.......#.........#.....#.....#.....#.....#...............#.#
################################################################
