8
S#.....#
.###.###
...#...#
##.###.#
...#...#
.###.#.#
.....#G#
########
