8
S#.....#
.###.###
...#...#
##.###.#
...#G..#
.###.#.#
.....#.#
########
