32
...#...........#.......#.......#
.#.#.#####.###.#.#####.#####.#.#
.#.#.#...#.#.....#.....#.....#.#
.#.#.#.###.#########.###.#####.#
.#...#...#...#.....#.#...#....G#
.#######.###.#.###.#.#.###.#####
.#.........#.#...#.#.#.#...#...#
.#.###.#####.#.###.#.#.#.###.###
.#.#...#...#...#...#...#.#.....#
.#.#####.#.#####.#######.#.###.#
...#.....#.......#...#...#...#.#
.###.#############.#.#.#####.#.#
.#...#...#.......#.#.#.#...#.#.#
.#.###.#.#.###.#.#.#.#.#.#.###.#
.#.....#.#...#.#.#.#...#.#.....#
.#######.###.#.###.#####.#######
.#...#...#...#.#...#.#...#.....#
##.#.#.#######.#.###.#.#.#.###.#
...#S#.......#...#...#.#.....#.#
.#####.#####.#.###.#.#.#######.#
...#.#.#.#...#.#...#.#...#.....#
##.#.#.#.#.###.#.#######.#.#####
...#.....#.#.#.#.......#.#.....#
.#######.#.#.#.#.#####.#.#####.#
.#.....#.#.#...#.....#...#...#.#
.###.#.#.#.###.#####.#####.#.#.#
...#.#.#.#...#.#.........#.#...#
##.#.#.#####.#.###.#######.###.#
.#...#.#.....#...#.#.....#.#.#.#
.#####.#.#######.###.###.#.#.#.#
.........#...........#.....#...#
################################
