32
...#.......#..G#...............#
.###.###.###.#.#.#########.###.#
...#.#.#.....#...#.........#...#
##.#.#.###########.#########.###
...#.#...#.......#.#.......#...#
.#.#.#.#.#.#####.#.#.#####.###.#
.#.#.#.#...#...#.#.#.....#.....#
.#.#.#.#####.#.#.#.#####.#######
.#.#...#...#.#...#...#.#.#.....#
.#.#####.###.#######.#.#.#.###.#
.#.......#...#...#...#.....#...#
.#########.###.#.#.#####.#####.#
.#...#...#.#.#.#...#...#.#...#.#
.#.#.#.#.#.#.#.#####.#.###.#.###
...#...#.#...#.......#.#...#...#
.#######.#.#####.#####.#.#####.#
.....#.#.#.#...#.....#.....#...#
####.#.#.#.#.#.###########.#.###
...#.#.#...#.#...........#.#...#
.###.#.#####.###########.#####.#
.....#.....#.....#.......#.....#
.#########.#####.#.#######.#####
.#.......#...#...#...#.........#
.###.###.#.#.#.#####.#######.#.#
.....#...#.#.#...#...#.....#.#.#
######.#####.###.#.###.###.#.#.#
.#.....#.......#.#.....#.#S#.#.#
.#.#######.#####.#######.#####.#
...#.....#.....#...#...#.......#
.###.###.#####.###.#.#.#####.#.#
.....#...........#...#.......#.#
################################
