16
...#.........#.#
##.#.#######.#.#
...#.....#.#.#.#
.#######.#.#.#.#
.......#.#.....#
##.#####.#####.#
...#...#...#S#.#
.#.#.#.###.#.#.#
.#.#.#...#...#.#
.###.#.#######.#
G#...#.#...#...#
.#.###.#.#.#.###
...#.#...#...#.#
.###.#########.#
...............#
################
