64
.#....G#.............#.............#.............#...#.........#
.#.###.#.###########.#.#####.#######.#.#########.###.#.#.#####.#
.#...#...#...#.....#...#...#...#...#.#...#...#.#...#...#.#...#.#
.###.#####.#.#.###.#####.#####.#.#.#.###.#.#.#.###.###.#.#.#.#.#
.....#.....#.#.#.#.......#...#...#...#...#.#.....#...#.#...#.#.#
.#########.#.#.#.#.#######.#.#.#######.###.#####.###.#####.#.#.#
.#.......#.#.....#.#.......#.#.#.....#...#.#...#.#...#...#.#.#.#
.#.#.###.#########.#.#######.###.###.###.#.#.#.#.#.###.#.###.#.#
.#.#.#.....#.......#.....#.......#...#...#...#.#.#.....#...#.#.#
.###.#####.#.#####.#####.#####.#####.#.###.###.###########.#.#.#
...#.....#...#...#.#...#.#...#.#...#.#.#.#...#.....#.......#.#.#
##.#####.#####.#.#.#.#.#.#.#.###.#.#.#.#.###.###.###.#######.#.#
.#.....#...#...#.#.#.#.#.#.#.....#.#.#.#...#...#.....#.......#.#
.#####.###.#####.#.###.#.#.#######.#.#.#.#####.#######.#.#######
.....#.....#...#.#.....#...#.....#.#...#.......#.....#.#.......#
.###.#######.#.#.#####.#######.###.#####.#######.###.###.#####.#
...#.#.......#.#...#...#.......#...#...#.....#.....#...#.....#.#
.#.#.#.###.###.#.#.#.#####.###.#.###.#.#####.#####.###.###.###.#
.#.#.#.#.#.#.....#.#.......#...#.....#.....#.....#.#.#...#.#...#
.#.#.#.#.#.#######.#########.#############.#####.#.#.###.###.#.#
.#.#.#...#.#...#...#.......#.#...........#.....#.#.#.....#...#.#
##.#.###.#.#.#.#.###.#####.#.#####.###########.#.#.#.#####.###.#
...#...#.#...#.#.#...#.....#.#.....#...........#...#.#.......#.#
.#####.#.#####.#.#.###.#####.#.###.#.###############.#####.#.#.#
.#...#.#.#.#...#.#.#.#.....#...#...#.#.....#.......#.#...#.#.#.#
.#.#.###.#.#.#####.#.#####.#####.###.#.#.#.#.#.#####.#.#.###.###
.#.#.....#.#.......#...#.#.....#.#...#.#.#...#.#.....#.#...#...#
.#.#######.#########.#.#.#####.#.#.#####.#######.#####.###.###.#
.#...#.......#.......#.....#.#.#.#.....#.........#.....#.#...#.#
.###.###.###.###.#########.#.#.#.#####.#########.#.#.###.###.#.#
...#...#.#.#.#...#...........#.#...#.#...#.....#.#.#.#.....#.#.#
.#####.#.#.#.#.#############.#.###.#.###.#.###.#.###.#####.#.#.#
.#...#...#.#.#.....#.......#.#...#.....#...#.#.#.....#...#...#.#
.#.#.#####.#.#.###.#.#####.#####.#####.#####.#.#####.#.#.###.#.#
.#.#.......#.#.#.#.#.....#...........#.#.....#.....#.#.#...#...#
.#.#####.#.#.#.#.#.#####.#############.#.###.#####.#.#.###.#####
...#.....#.#.#...#.....#.............#.#...#...#...#.#...#.....#
####.#######.#########.#############.#.#####.#.#.###.###.#####.#
.....#.....#...#.....#.........#..S#.#.......#.#...#...#.....#.#
.#####.###.###.#.###.###.#####.#.###.#.#######.###.#####.#####.#
.......#...#...#.#.#...#.....#.#...#...#.....#...#.....#.#...#.#
.#######.#.#.###.#.###.#######.###.###.#.###.#####.###.#.#.#.#.#
.#...#...#.#.#...#...#.#.........#...#.#.#.#.....#.#...#.#.#...#
.#.#.#.#####.#.#.###.#.#.#.#########.###.#.#####.###.#.#.#.###.#
.#.#.#.....#.#.#...#.....#.#.......#.#...#.....#.#...#.#.#...#.#
.#.#.#####.#.#.###.###.#####.#####.#.#.###.###.#.#.#####.###.#.#
.#.#.....#...#...#...#.#.....#.#...#.#.#.#...#.#.#...#...#.#.#.#
.#.#####.#######.###.###.#####.#.###.#.#.#.###.#.#.#.#.###.#.###
.#.#.....#...#.....#.#...#...#.#...#...#...#...#.#.#.......#...#
.###.###.#.#.#######.#.###.#.#.###.#######.#.###.#########.###.#
.....#.#...#.#.......#...#.#.#.#.........#.#...#.......#.#.#...#
######.#####.#.#####.###.#.#.#.#.#######.#.###.#######.#.#.#.###
.....#.......#.#.....#.....#...#.#.#...#.#...#...#...#.#...#...#
.###.#.#######.#######.#########.#.#.#.#.###.#.#.###.#.#.#####.#
.#...#...#.....#.......#.....#...#...#.#...#.#.#.....#.#...#...#
.#.#####.#.###.#.#######.###.#.#######.###.###.#####.#.###.#.###
.#.......#...#...#.......#...#.......#...#...#...#...#.#...#...#
.#################.#######.###.#####.#.#####.###.#.###.#######.#
...#...............#.....#.#...#...#.#.....#.#...#.#.#.......#.#
##.#####.###########.#.###.#.###.#.#.#.###.#.#.###.#.#######.#.#
...#.....#.#.......#.#.#...#.....#.#.#...#...#.#.#.#.......#.#.#
.###.#####.#.###.###.#.#.###########.###.#####.#.#.#####.#.#.#.#
.....#.........#.....#...............#.........#.........#.#...#
################################################################
