64
.....#.....#.........#...#.......#.........#...............#...#
.#.#.#####.#.#####.#.#.#.###.#####.#####.#.#.#####.#######.#.#.#
.#.#.......#.#.#...#...#...#.....#.#...#.#.#.....#.....#...#.#.#
.#.#####.###.#.#.#########.#####.#.#.###.#.#########.#.#####.#.#
.#.#.....#.....#.#.....#...#.....#.#.#...#.#...#...#.#...#...#.#
.#.#######.#####.###.###.###.###.#.#.#.###.#.#.#.#.#####.#.###.#
.#.....#...#...#...#.........#...#...#.#.....#.#.#.#...#...#...#
.#####.#.###.#.###.#################.#.#.#####.#.#.#.#.#####.#.#
.#...#...#...#.#...#.......#.........#.#.#...#...#...#.#.....#.#
.#.#.#####.###.#.###.#####.#.#####.###.###.#.#########.#.#####.#
.#.#.......#...#.#...#...#...#...#...#...#.#.#...#.....#...#.#.#
##.#########.###.#.#####.#####.#.#######.#.#.###.#.#######.#.#.#
...#.......#.#...#.#...#.....#.#.........#.#.#...#.#.......#.#.#
.#####.###.#.#.#.#.#.#.#####.#.#######.###.#.#.###.#.#######.#.#
.....#...#.#...#.#...#...#...#...#.#...#...#.#.....#.#.#.....#.#
.###.#.#.#######.#######.#.#.###.#.#.###.###.#.#####.#.#.###.#.#
...#.#.#.#.......#.....#...#.#.#.#.....#.#...#.......#.#...#...#
####.#.#.#.###########.#####.#.#.#######.#.###########.###.#####
.....#.#.....#...#.......#...#.#...#.....#.#...............#..S#
.###########.#.#.#.#####.#.###.###.#.#####.#.###############.###
.........#.....#.#.#.....#.#.....#...#...#.#.......#.....#.#...#
.#######.#######.#.#######.#.###########.#.#######.#.###.#.###.#
.#.#...#...#...#.#.#...#...#.#.........#.#...#.#...#...#.....#.#
.#.#.#.###.###.#.#.#.#.#.###.#.#.#####.#.###.#.#.#####.###.###.#
.#.#.#...#...#...#.#.#.#.#.....#.#...#...#...#.#.....#.#...#...#
.#.#.###.###.###.#.#.#.#.#####.#.#.#####.#.###.#####.#.#####.###
.#.#...#...#...#...#.#.#.....#.#.#.....#.#.#.......#.#.....#...#
.#.###.#.#####.#####.#.#####.#.#.###.###.#.#######.#.#####.###.#
.#...#.#.....#.#.....#.......#.#...#.....#.#.....#.#.......#...#
.###.#.#####.#.#.#################.#.#####.#.###.#.#####.###.###
...#.....#.#.#...#.........#.....#.#.#...#.#...#.#.....#.#...#.#
##.#####.#.#.#####.#########.#.#.#.#.#.#.#.###.#.#.#####.#.###.#
.#...#.....#.......#.........#.#...#...#.#...#.#.#.....#.#.#...#
.###.###########.#.#.#########.#########.###.#.#.###.#.#.#.###.#
...#...........#.#...#.........#...#.#...#.#.#.#...#.#.#.#.....#
##.###########.###.###.#########.#.#.#.###.#.#.###.#.#.#.#####.#
.....#...#...#...#.#...#.....#...#...#.....#.#.#.#.#.#...#.....#
.###.#.#.#.#.###.#.#.#######.#.#.#########.#.#.#.#.#.#####.#####
...#...#...#...#.#.#.#.......#.#.........#.#...#.#.#.#...#.#...#
##.#############.###.#.#.#.###.#####.#####.#####.#.###.#.#.#.#.#
...#.....#.....#.#...#.#.#.#...#...#...#...#.....#.....#.#.#.#.#
.###.###.#.###.#.#.#####.###.#####.###.#.###.#.#########.#.###.#
.......#.#.#.#...#.....#...#.#.......#...#...#...#.......#...#.#
.#######.#.#.#####.###.#.#.#.#.#################.#.###.#####.#.#
.#...#...#.#.........#.#.#...#...#.............#.#.#...#.....#.#
.###.#.###.#.#########.#.#######.#.#.#########.#.#.#####.#####.#
.#...#...#.#.#...#...#.#.#.....#.#.#...#.......#.#.......#.#...#
.#.#.###.#.###.#.#.#.#.#.###.#.#.#.###.#.#######.#########.#.#.#
...#...#.#.....#...#...#.....#.#...#.#.#.......#.......#.....#.#
####.###.#####################.#.###.#.#######.###.###.#.#####.#
.....#...#...........#...#.....#.....#.#.....#...#...#...#...#.#
.#####.###.#########.#.#.#.#######.###.#.###.###.###.#######.#.#
.#...#.....#..G#.....#.#...#.....#.#...#...#...#.#.#.#.......#.#
.#.#.#######.###.###.#.#######.###.#.#########.#.#.#.###.#####.#
.#.#.........#...#...#.#.......#...#...#.......#.#.......#...#.#
.#.###.#######.###.###.###.#####.#####.#.#####.#.#########.#.#.#
...#...#.......#.....#...#...#.......#.#...#...#.#.....#...#...#
####.###.###############.#.#.#.#######.###.#.###.#.###.#.#####.#
.#...#...#.....#.......#.#.#.....#...#.#...#...#...#.#...#...#.#
.#.###.###.###.#.###.###.#.#######.#.#.#.#####.#####.#####.###.#
.#.#.#.#...#.#.#.#.#...#.#.....#...#...#.#.......#.......#.....#
.#.#.#.#.###.#.#.#.###.#.#######.#######.#########.#.#####.#####
.....#.......#.......#...........#.................#...........#
################################################################
