16
..........G..#.#
.###.#######.#.#
.#.#.....#.#.#.#
.#.#####.#.#.#.#
...#...#.#.....#
##.#.#.#.#####.#
.....#.#...#...#
.#####.###.#.###
.#...#...#.#.#.#
.#.#.#####.#.#.#
.#.#.......#...#
.#.###########.#
.#.#S....#.....#
.#.#####.#.#####
.#.......#.....#
################
