64
...#.......#.........#...........#...#.....................#...#
.#.#.#####.#.#####.#.###.#.#####.#.#.#.#################.###.#.#
.#.#.#.....#.....#.#...#.#.#...#...#.#.......#.........#.....#.#
.###.#.###.#####.#.###.#.###.#.#####.#.#####.#######.#.#######.#
.....#.#.#...#.#.#...#...#...#...#...#.#...#.........#.#...#...#
.#####.#.###.#.#.###.#####.#####.#.###.#.#.###########.#.#.#.#.#
...#...#.....#.#.#.#.......#.#...#...#.#.#...#.....#.....#.#.#.#
####.###.#####.#.#.#########.#.#######.#.###.#.###.#######.#.###
.....#.........#.#.....#.....#.......#.#.#.....#.......#.#.#...#
.###############.###.#.###.#.#######.#.#.#############.#.#.###.#
...#.........#...#...#...#.#.......#...#.....#.....#.#.#...#...#
.#.#.#######.#.###.#####.#.#.###########.###.#.###.#.#.#####.###
.#.......#...#...#.....#...#.#.........#...#...#...#.#.....#...#
.#########.#####.#####.#.#####.#######.#########.###.#####.###.#
.....#...#.....#.....#.#.#...#.....#...........#.#.......#...#.#
######.#.#####.#####.#.###.#.#####.###########.#.#####.#####.#.#
.......#.....#.....#.#.....#.....#.....#.........#...#...#...#.#
.###########.#.###.#.#.#######.#.#####.#.#########.#.###.#.###.#
.#...#...#.....#...#.#.....#...#.#...#.#.#.........#...#...#...#
.#.#.###.#.#########.#.#####.###.#.#.#.###.###########.###.###.#
...#...#.....#.......#.#.....#...#.#...#...#...#.....#...#...#.#
.#####.#######.#########.#####.###.#####.###.###.###.###.###.#.#
...#.#.................#.#.......#.#...#.#.#.......#...#...#.#.#
##.#.#################.#.#.#######.#.#.#.#.#.#########.###.#.#.#
...#.#...........#...#...#...#.....#.#.#.#...#...........#.#.#.#
.###.#.#########.#.###.#######.#####.#.#.#.###.#########.#.#.#.#
...#.#.#.....#...#.#...#.....#.#.....#...#...#.#...#.....#.#...#
##.#.#.#.###.#.###.#.###.###.#.#.#############.#.###.#####.###.#
.#G..#.#...#.#.#.....#...#.....#.#...#.........#.....#.#...#...#
.###.#.#####.#.#.#####.#########.###.#.###.#####.#####.#.###.###
...#.#.....#...#.#...#.........#...#...#.#.....#.......#.#.#...#
.#.#.#####.#.###.###.#####.###.###.#.###.#####.#.#####.#.#.###.#
.#...#...#.#...#...#.#...#.#...#...#...#...#...#.#...#.#.#...#.#
.#####.#.#.###.###.#.#.#.###.#.#.#####.###.#.#####.#.###.#.###.#
.#.....#.#...#.#.....#.#.....#.#.....#.....#...#...#...#.#.#...#
.###.#.#####.#.#######.#######.#####.#.#######.#.#####.#.#.#.###
.....#.#.....#.........#.#...#.#.....#.#...#...#...#.#...#...#.#
.#####.#.###############.#.#.#.#.###.###.#.#.#.###.#.#####.###.#
.#...#.#.#.................#...#.#...#...#.#.#.#...#.......#...#
.#.#.###.#.#################.###.#####.###.#.###.###.#######.#.#
.#.#...#.#...#.......#.....#...#.#.....#...#.#...#.#.#.......#.#
##.###.#.###.###.#####.###.###.#.#.#####.###.#.###.#.#########.#
...#.#...#...#...#.....#.#...#.#...#.....#.#...#...#.#...#.....#
.###.#####.###.###.#####.###.#######.#####.#.#####.#.#.#.#.###.#
.#.......#...#...#.....#...#.....#...#.....#.....#.....#.#...#.#
.#####.#####.###.#####.###.#####.#.#######.#####.#######.#.#.###
.....#.....#...#...#.......#...#.#.#.....#.....#...#...#.#.#...#
.###.#.#.#####.#.###.#######.#.#.#.#.###.#.###.###.#.###.#.###.#
.#...#.#.#.......#...#.#...#.#.#.#.#...#...#...#.#.#...#.#...#.#
##.###.#.#.#######.###.#.#.#.#.#.#.###.#####.###.#.#.#.#.#####.#
...#...#.......#.......#.#...#...#...#.#...#.....#.#.#.#.#.....#
.###############.#######.#####.#####.#.###.#.#####.#.#.#.#.###.#
.#...#.........#...#.....#...#.#.....#...#...#.....#.#.#.#.#...#
.#.#.#.#######.#.###.#####.#.#.#.#####.#.#####.#####.#.#.#.#.###
.#.#.#.....#.#...#...#.....#...#.....#.#.......#.....#.#...#.#.#
.#.#.#####.#.#####.###.#############.#####.#####.#####.#####.#.#
...#...#...#.....#...#.#.#.........#....S#...#...#...#.....#.#.#
.#####.#.#######.###.#.#.#.###.#############.#.#####.#.#####.#.#
.....#.#...#.....#.#.#...#.#.#...#.........#.#.#...#.#.#...#...#
####.#.###.#.###.#.#.#####.#.###.#.###.#.###.#.#.#.#.#.#.#.###.#
...#.#...#.#.#...#.#.......#...#.#.#.#.#.#...#.#.#...#...#.#...#
.#.#.#.###.#.#.###.#########.#.#.#.#.#.###.###.#.###.#####.#.###
.#...#.......#...............#.#.....#.....#.....#.......#.....#
################################################################
