64
...#...........#.......#.#.............#.......#.........#.....#
.#.#.#.#######.###.###.#.#.#.#########.###.###.#######.#.#.###.#
.#...#...#...#.#...#...#.#.#...#.#...#...#.#.#.....#...#...#...#
####.###.###.#.#.###.###.#.###.#.#.#.###.#.#.#####.#.#######.###
...#...#...#...#...#.#.#...#...#...#...#.#.#.#.....#.#.#...#G#.#
.#.###.###.###.#.#.#.#.#.###.###.#####.#.#.#.#.#####.#.#.#.#.#.#
.#...#...#...#.#.#.#.#...#.#...#...#...#...#.#.....#.#...#.....#
.###.###.###.#.###.#.#.###.###.###.#.#######.#####.#.#########.#
...#...#...#.#.#...#.#.....#...#.#.#.#...#.........#.......#.#.#
##.###.#####.#.#.###.#######.###.#.#.#.#.#.###############.#.#.#
...#.#...#...#...#.#...#...#...#...#...#.#.#.........#.....#...#
.###.###.#.#######.###.#.#.###.#.#######.#.#.#######.#.#########
.#...#...#.#.............#.....#.#.#.....#.#...#.#.....#.......#
.#.###.###.#.###################.#.#.#####.###.#.#.#####.#####.#
.#.....#...#...#.....#...#.........#.....#...#.#...#.......#...#
.#.#####.#####.#.###.###.#.#############.###.#.#####.#######.#.#
.#.#.......#...#.#.#...#...#.#...#.....#...#.#.#...#.#.#.....#.#
.#.#####.#.###.#.#.###.#.###.#.#.#.###.###.#.#.#.#.#.#.#.#######
.#.....#.#...#.#.#...#.#.#.....#.#...#.#...#.#...#.#.#.#.......#
.#####.###.#.###.#.#.#.#.#####.#.###.#.#.###.#.###.#.#.#######.#
.#...#...#.#.#...#.#.#.#.....#.#...#.#...#...#...#.....#.....#.#
.###.###.###.#.###.###.#####.#####.#.#####.###.#####.###.###.#.#
...#.........#.#.......#...#.......#.....#.#...#...#.#...#.#.#.#
##.#######.###.#.#######.#########.#####.#.#####.#.#.#.###.#.#.#
...#...#...#...#.#...#.......#...#...#...#.....#.#.#.#...#...#.#
.###.#.#####.###.#.#.#####.###.#.###.#.#######.#.#.#.###.#.###.#
...#.#.....#.#.....#.#...#.#...#.#...#.......#.#.#.#.#...#.....#
##.#.#####.#.#######.#.#.#.#.###.#.#######.###.#.#.###.#######.#
...#.#.....#.......#...#.#.#...#.#.......#...#...#...#.......#.#
.#.#.#.###########.#####.#.###.#.#.#########.#######.#.#####.#.#
.#.#.#.......#...#.#...#.#.....#...#.......#.......#.#.#.#...#.#
.#.#.#####.#.###.#.#.#.#.#####.#####.#####.#.#####.#.#.#.#.###.#
.#.#.#.....#...#.#.#.#.#.#...#.....#.#.#...#.....#.#.#...#.#...#
.###.#.#######.#.#.#.#.#.#.#.###.###.#.#.###.###.#.#.###.#.#.###
.....#.#.#...#.#.#.#.#.#...#.#...#...#.#.#.....#.#.#...#.#.#...#
.#####.#.#.#.#.#.#.#.#.#####.#.###.###.#.#.#####.#.###.#.#.#####
.....#.#.#.#.#...#.#.#...#...#.#...#.....#.#.....#.#...#.#.....#
####.#.#.#.#.###.#.#####.#.###.#.###.#####.#.#####.#.###.#####.#
.....#.#...#.....#.....#.#.#...#...#.#.....#.....#.#.#...#...#.#
.#####.###############.#.#.###.###.#.#.#########.###.#.#####.#.#
...#.#...............#.#.#...#.#...#.#.......#.#.....#.....#.#.#
##.#.###############.#.#.###.#.#.###.#######.#.###########.#.#.#
...#.............#...#.#.....#.#.#.#.......#.#.........#.....#.#
.###.###.#####.###.#.#.#####.###.#.#######.#.###.#####.#.#####.#
.#...#.#...#...#...#.#.....#.....#.......#.#...#.#...#.#...#...#
.###.#.###.#####.#########.#############.#.###.#.#.###.#####.#.#
...#.....#.#...#.........#...#...........#...#...#...#...#...#.#
##.#######.#.#.#######.#.###.#.#########.###.#####.#.###.#.###.#
.#...#...#...#.....#...#.#...#...#.....#...#.....#.#.......#...#
.###.#.#.#####.#.###.#####.#####.#.###.###.#####.#.#############
...#...#.....#.#...#.#S#...#.....#...#.#...#...#.#...#.....#...#
.###########.#.###.#.#.#.###.#####.#.###.###.#.#.###.#.###.#.#.#
.#.........#.#...#.#.#...#...#...#.#.....#...#.#...#.#.#...#.#.#
.#.###.###.#.#####.#.#####.###.#.#.#########.#.###.###.#.###.#.#
...#...#.#.#...#...#.......#...#.#.#.........#...#.....#.#...#.#
.###.###.#.###.#.#####.#####.#####.###.#########.#######.###.#.#
...#.#.......#.#.....#.#.........#...#.#...#...#.......#...#.#.#
####.#######.#.#####.#.#.#######.###.#.#.#.#.#########.###.#.#.#
.....#...#.#.#.......#.#.#.....#.......#.#.#.#.........#.#...#.#
.#####.#.#.#.#######.#.###.###.#########.#.#.#.#######.#.#####.#
...#...#.#...#...#...#.....#.#.#.......#.#.#.....#...#...#...#.#
.#.#.###.#####.#.#.#########.#.#.#####.#.#.#######.#.#####.#.#.#
.#.....#.......#.............#.......#...#.........#.......#...#
################################################################
