16
...............#
.#############.#
G............#.#
.###########.###
.#.....#.....#S#
.#####.#.#####.#
.......#.......#
######.#########
...#...#.......#
.#.#.#####.#.#.#
.#.#.#...#.#.#.#
##.#.#.#.###.#.#
...#...#...#.#.#
.#########.#.#.#
.............#.#
################
