8
S....#.#
####.#.#
.....#.#
.#####.#
...#...#
##.###.#
....G..#
########
