8
.......#
##.###.#
S..#...#
####.###
...#.#G#
.#.#.#.#
.#.....#
########
