16
.......#.......#
.#####.#.###.###
.#...#...#.#...#
.#.#######.###.#
.#.........#.#.#
.#####.###.#.#.#
.......#.#.#.#G#
########.#.#.#.#
.....#.....#.#.#
.###.#.#####.#.#
S#...#.......#.#
##.###.#######.#
...#...#.......#
.#######.#####.#
.........#.....#
################
