8
....G..#
.###.###
...#...#
##.###.#
S#.#...#
.###.#.#
.....#.#
########
