8
...#S..#
.#####.#
.....#.#
.###.#.#
.#.#...#
.#.#####
......G#
########
