8
.....#S#
.#####.#
.......#
.#######
G#...#.#
.#.#.#.#
...#...#
########
