64
.....#.....#.......#...............#...#...#.........#...#...#.#
.###.#.#.#.###.###.#####.#.#######.#.###.#.#.###.###.#.#.#.#.#.#
...#.#.#.#.....#.#.....#.#.....#.#...#...#...#.#.#.#.#.#...#...#
.#.###.#.#######.#####.###.###.#.###.#.#######.#.#.#.#.#######.#
.#.....#.#...#.......#...#.#...#.#...#.#.......#.#.#.#.#...#...#
.#######.#.###.#####.###.#.#.###.#.###.#.#######.#.#.#.###.#.###
...#.....#...#...#.#.....#.#...#.#...#...#...#...#.#.#.#...#...#
####.#####.#.###.#.###########.#.#.#####.#.#.#.###.#.#.#.#####.#
.....#.....#.....#.......#.....#...#.....#.#...#.......#.....#.#
.#.#####.#########.#####.#.#####.###.#####.###.#####.#######.#.#
.#.#...#.#.......#...#.....#...#...#.#...#...#.#...#.#.....#...#
.###.#.#.#.#####.###.#######.#.###.#.#.#.###.###.#.###.###.#####
.....#.#...#...#...#.#.......#...#.#.#.#.#...#...#.....#.#.#...#
.#####.#####.#####.#.#.#########.#.#.#.###.#.#.#########.#.#.#.#
.#...#.#.......#.....#...#.#...#.#.#.#...#.#.#.......#...#...#.#
.#.#.#.###.###.#.#######.#.#.#.#.#.#.###.#.#########.#.#######.#
.#.#.#...#...#...#.....#.#.#.#.#.#.#...#.#.........#.#.......#.#
.#.#.###.###.#####.###.#.#.#.#.#.#####.#.#######.#.#.###.#.###.#
...#.#.#...#...#.#...#.#.#...#.#.....#.#...#.....#.#.....#.#...#
####.#.###.###.#.###.#.#.#####.#####.#.###.#.###.#########.#.#.#
.#...#...#.#...#.#...#...#...#.....#...#...#.#...#.....#...#.#.#
.#.###.###.#.###.#.#######.#.###.#.#####.#.#.#####.#.###.###.###
...#...#...#.....#.#.......#.....#...#...#.#.......#.#.....#...#
.###.###.#####.###.#.#.#############.#.###.#########.#.#######.#
.#.....#...#...#...#.#.....#...#...#...#.#.........#.....#...#.#
.#####.###.#####.#########.#.###.#.#####.#######.#######.#.#.#.#
.......#.#...#...#.......#.#.....#...............#.....#.#.#...#
######.#.###.#.###.#####.#.###############.#######.###.###.###.#
.#.....#...#...#...#...#.#...............#...#...#.#.....#.#.#.#
.#.#######.#####.#####.#.#.#######.#####.###.#.#.#.#####.#.#.#.#
G#...#...#.......#...#.#.#.#.....#.#.....#.#.#.#.#.....#...#...#
.###.#.#.###.#####.#.#.#.###.###.###.#####.#.#.#.#####.#.#####.#
...#.#.#.....#.....#.#.#.....#.....#.#.#...#...#.#...#.#.#...#.#
##.#.#.#####.#.#####.#.#####.#####.#.#.#.#.#####.###.#.#.#.#.###
...#.#...#...#...#.#.#.......#...#...#...#.....#.....#.#.#.#...#
.###.#.#.#######.#.#.#########.#.#####.#######.#####.#.###.###.#
.....#.#.#.....#.#.#.......#...#.....#.......#.......#.......#.#
.#####.#.#.#.#.#.#.#######.#.#######.#######.###############.#.#
.....#.#.#.#.#.#.#.....#...#.#.....#...#.....#.....#.....#...#.#
####.###.#.#.#.#.#.###.#.###.#.#.#####.#####.#####.#.###.#####.#
...#...#...#.#.#.#...#.#.....#.#.#...#.....#.......#.#.#.....#.#
##.###.#.###.#.#.###.#.#######.###.#.#####.#########.#.#####.#.#
.....#.#.#...#.#.....#.#.....#.....#.....#...........#.....#.#.#
.#####.#.#.###.#######.#.###.#.#######.#.#################.#.#.#
.......#.#.#.#.#...#.#...#...#.#.#...#.#.#.....#...........#.#.#
.#########.#.#.#.#.#.#####.###.#.#.#.#.#.#.###.###.#########.#.#
.....#.....#.#...#.#.....#.#.#.#...#.#.#.#...#...#.....#S....#.#
####.###.###.#####.#.#####.#.#.#####.#.#.#.#.###.###.#.#######.#
...#.....#.....#.....#.....#.......#.#.#.#.#.#.#...#.#...#...#.#
##.#########.#.#.#####.###########.#.#.#.#.#.#.###.#.#.#.#.#.#.#
.......#.....#.#.#.....#.......#.....#.#.#.#.#.....#.#.#.#.#...#
.#####.###.#####.#.#########.#.#######.#.###.#.#######.#.#.###.#
...#.....#.#.....#.#.........#.........#.....#.#.......#...#.#.#
.#.#####.#.#.#####.#####.#####################.###.#.#######.#.#
.#.....#...#.#...#.....#.........#.......#...#...#.#...#.....#.#
######.###.#.#.#.#####.#########.#.#####.#.#.###.#.###.#.#####.#
.......#...#.#.#...#.#...#.......#.#.......#.#...#.#...#.#.....#
.###.#####.#.###.#.#.###.#.#######.#########.#.#####.###.#.#####
.#...#...#.#.....#...#.#.#.#.....#.......#...#.#...#...#...#...#
.#.###.#.###########.#.#.#.#.###.#.#####.#.###.#.#.###.###.###.#
.#.#...#.......#.....#.#.#.#...#...#.#...#.#...#.#...#...#.....#
.###.#########.#.#####.#.#.###.#####.#.#####.###.###.###.#####.#
.............#.........#...#.........#...........#.......#.....#
################################################################
