8
.....#.#
.#.#.#.#
.#.#..G#
##.###.#
...#...#
.###.###
S#.....#
########
