32
.........#...#...#...#.......#.#
.#########.#.#.#.#.#.#.#.###.#.#
.........#.#...#...#...#.#.#...#
.#####.#.#.#########.###.#.###.#
.#...#.#...#.......#...#.#.....#
.#.#.#.#####.#####.#####.#.#####
.#.#G#...#...#...#.......#...#.#
##.#.#####.###.#.###########.#.#
...#.....#...#.#.#.........#...#
.#######.###.#.#.#.###########.#
.#.....#.#...#.#.#.#...........#
.#.###.#.#.###.#.#.#.###########
.....#.#.#.#...#...#.....#.....#
######.#.#.#.###########.#####.#
.....#.#...#.#...#.....#.....#.#
.###.#.#####.#.#.#.###.#####.#.#
.#...#.....#.#.#...#.#.....#.#.#
.#.#######.#.#.#####.#####.#.#.#
.#.....#...#.........#...#.#.#.#
.#####.#.###.#######.#.#.#.#.#.#
.#.......#...#.....#.#.#.#...#.#
.#######.#####.###.#.#.#######.#
.....#...#...#...#.#.#.#.....#.#
####.#####.#.###.#.#.#.#.#.#.#.#
...#.......#...#.#S#.#...#.#...#
.#############.#.###.#.###.#####
...#.......#.#...#...#...#.....#
.#.#.###.#.#.#####.###########.#
.#...#...#.......#.........#...#
.#####.###################.#.#.#
.....#.......................#.#
################################
