16
.......#...#...#
.#####.#.#.#.#.#
.#.....#S#.#.#.#
.#########.###.#
.........#...#.#
.#######.###.#.#
.#.........#.#.#
.#.#########.#.#
.#...#.......#.#
####.#.#######.#
.....#.....#...#
.#########.###.#
...........#...#
.###########.#.#
....G........#.#
################
