32
.......#...#...#.......#.......#
.#.#####.#.#.#.#.#####.#.#.#####
.#...#...#...#...#...#.#.#.#...#
.###.#.#############.#.#.#.#.#.#
.#.#G#.#.............#...#.#.#.#
.#.#.#.#.###.#######.#####.#.#.#
...#...#...#.#.....#.#...#...#.#
##.#####.###.#.#.###.#.#.#####.#
.#.....#.#...#.#.#...#.#.#.....#
.#####.###.###.#.#.#####.#.#####
.....#...#.#...#.#.#.....#.....#
.###.###.#.#.#####.#.###.#####.#
...#...#.#.#...#.....#.......#.#
##.###.#.#.###.#.#########.###.#
.#...#...#...#.....#.....#.#...#
.###.#####.#.#.#####.###.###.###
...#.....#.#.#.#.....#.#.#...#.#
.#.#####.#.#.###.#####.#.#.###.#
.#.....#.#.#...#.#.....#.#.#...#
.#####.#.#####.#.#####.#.#.###.#
.....#.#.#.....#.....#.....#...#
####.#.#.#.#########.#######.###
.....#.#.#...#.....#.....#.....#
.###.###.#.#.#.###.#####.#####.#
...#.#...#.#...#...#S..#...#...#
.#.#.#.###.#####.#####.###.#.#.#
.#.#.#...#.....#.....#.....#.#.#
.#.#####.#####.#####.#######.#.#
.#...#...#.........#...#...#.#.#
.###.#.#############.#.#.#.#.#.#
...#.................#...#...#.#
################################
