16
...#G..........#
.#.#.###.#####.#
.#.#...#.#.....#
.#.###.#.#####.#
.#.....#.....#.#
.###########.###
.......#...#...#
####.###.#.###.#
...#.#...#.....#
.###.#.#######.#
.#...#.......#.#
.#.#######.#.#.#
...#...#S#.#.#.#
.###.#.#.###.#.#
.....#.#.....#.#
################
