32
.....#.#.........#...#...#.....#
.#.#.#.#.###.###.#.###.#.#.###.#
.#.#.#.....#.#.....#...#.....#.#
.#.#.#####.#.#####.#.#########.#
.#G#.....#.#.....#.#.#...#...#.#
##.#####.#######.#.#.#.###.#.#.#
...#...........#.#.#...#...#...#
.###.#########.#.#.###.#.#######
.#...#.....#.....#...#.#...#...#
.#####.###.#########.#.###.#.###
.#.....#.#...#.......#...#.#...#
.#.#####.###.#.#########.#.###.#
...#.....#...#...#.......#...#.#
.###.#.###.#####.#.#########.#.#
.#...#.#...#.....#.#...#.....#.#
.#####.#.###.#####.###.#.#####.#
.....#.#...#.#...#.....#.#.....#
####.#.###.#.#.#.###.###.#.#.###
...#.#...#.#...#...#.#...#.#...#
.#.#.###.#.#######.#.#.#######.#
.#.#.....#...#.....#.#S#.......#
.#.#####.###.#######.###.#.#####
.#...#.....#.......#...#.#.....#
.###.#.###########.###.#.#####.#
.#.#...#.#.......#.#...#.....#.#
.#.#####.#.#####.#.#.###.#####.#
...#.....#...#...#.#.#...#...#.#
##.#.###.###.###.#.#.#.###.#.#.#
.#.#.#...#.#...#...#.#.#...#...#
.#.###.#.#.###.#####.###.#####.#
.......#.....#...........#.....#
################################
