8
S#...#.#
.#.#.#.#
.#.#...#
.#.###.#
...#G..#
####.###
.......#
########
