64
.........#.......#...#...........#.#.........#.....#...........#
.#####.###.###.###.#.#.#####.###.#.#.#.#######.###.#.#.#######.#
.#...#.#...#.#.....#.....#...#.#.#...#..G........#...#...#.....#
.#.#.###.###.#############.###.#.#.#######.###########.#.###.###
.#.#.....#...........#.....#...#.#.#.....#.#.........#.#...#.#.#
.#.#######.#######.###.#####.###.#.#.###.###.#######.#.###.#.#.#
.#.#.#...#...#.....#...#...#.....#.#.#.#...#.#.....#.#.#...#...#
.#.#.#.#.#.#.###.###.###.#.#.#######.#.###.#.###.#.#.###.#####.#
...#.#.#...#...#...#...#.#.#.......#.#...#.#...#.#.#...#.....#.#
.###.#.#######.###.###.#.###.#####.#.#.###.#.#.#.#.###.#.###.#.#
.#.......#...#...#...#.#.....#...#...#.....#.#.#.#...#.#...#.#.#
.###.#####.#.###.#.###.#######.#.#####.#######.#.#.###.#####.###
...#...#...#.#...#.#...#.......#.#.#...#.......#.#.#...#...#...#
##.#####.###.#.#####.#.#.#######.#.#.###.#######.###.###.#.###.#
.#.#.....#.#.#.....#.#.#.......#.#.....#.....#.#.....#...#.....#
.#.#.#####.#.#.###.#.#########.#.#####.#.###.#.#.#####.#.#####.#
.#...#.....#.#...#.#.........#.#...#...#.#...#.#.....#.#.#.....#
.#####.#.###.#####.#####.#####.###.###.#.#.###.#####.#.#.#####.#
.....#.#...#.....#.....#.........#...#.#.#.#.........#.#.....#.#
.#####.###.#####.###.###############.#.###.#.#######.###.###.###
.....#.#.#.......#...#...........#...#.#...#.#.....#...#...#...#
.###.#.#.#######.#.###.#########.#.###.#.#####.###.###.###.###.#
.#.#.#.#...#...#...#...#.......#.#.#...#.#...#...#.#...#.....#.#
.#.#.#.#.###.#.#####.#####.###.#.#.###.#.#.#.#.###.#.#########.#
...#...#.#...#.....#.....#.#.#...#...#...#.#.#.#...#.....#.....#
##.#####.#.#######.#####.#.#.#######.#.###.#.#.#.#######.#.###.#
.#.......#.#...........#.#...#.....#.#.#...#...#.#.....#...#.#.#
.###.#####.###########.#.###.###.#.#.###.#######.#.#.#######.#.#
.....#.....#.....#.......#.#.....#.#.#...#.....#.#.#.#.....#...#
.#####.#####.###.#########.#######.#.#.###.#.###.#.###.###.#.###
.#...#.#.......#.#.....#.........#.#...#...#.#...#.......#.....#
.###.#.#.#######.#.###.#.#######.#.#.###.#####.###############.#
...#.#.#...#...#.....#.#.#.#.....#.#.....#...#...............#.#
##.#.#.###.#.#.#####.#.#.#.#.###.#.###.###.#.###.###########.###
.#...#...#.#.#...#.#.#.#...#.#...#.#...#...#...#...#...#...#...#
.###.#.###.#.###.#.#.#.###.#.#####.#####.#####.###.#.#.###.###.#
.#...#...#.#...#.#...#...#.#.#...#.....#.....#...#...#.......#.#
.#.#####.#.###.#.#.#####.###.#.#.#####.#.###.###.###########.#.#
...#...#...#...#.#.....#...#.#.#.......#...#.#.#.....#.......#.#
.###.#.#####.###.#########.#.#.#####.#######.#.#####.#.#######.#
...#.#.......#.#.#...#.....#...#...#.........#.....#.#.#.....#.#
####.#########.#.#.#.#.#########.#.###########.#####.#.#.###.#.#
.....#.........#...#.#...........#.......#.......#...#.#.#.#.#.#
.###.#######.#######.#.#####.###########.#.#####.#.#####.#.#.#.#
.#...#.....#.......#.#.#...#.#.........#.#...#...#...#...#.#.#.#
.#####.###.#.###.###.###.#.###.#######.#.###.#.#.###.#.###.#.#.#
.#.....#.#.#...#...#.....#.#...#...#...#.#...#.#...#.#.#...#.#.#
.#.#####.#.###.###.#######.#.###.###.###.#.###.#####.#.#.#.#.#.#
.#.....#.#...#.#S#...#...#.#...#...#.#...#...#...#...#.#.#...#.#
.#####.#.###.###.#.###.#.#.#.#.###.#.#.#.#######.#.###.#.#####.#
.....#.#...#...#.#.#...#...#.#.#...#.#.#.....#...#.....#.....#.#
.###.#.###.###.#.#.#.#######.#.#.###.###.###.#.#############.#.#
...#.#...#...#.#.#.#.....#.#.#.#...#...#...#.#.....#...#...#...#
##.#####.#.#.#.#.#.#####.#.#.#.###.###.#####.#.###.#.#.#.#.###.#
.#.....#...#.#...#.......#...#...#.#...#...#.#...#.#.#...#...#.#
.###.#.#####.#####.#########.###.#.#.###.#.#.#####.#.#####.#.#.#
.#...#...#...#...#.#.......#.#...#.#.....#...#...#.#.#.#...#.#.#
.#.#######.###.#.#.###.###.#.#.###.###########.#.#.#.#.#.#####.#
.#.........#...#...#...#.#.#.#.#.........#.....#...#...#...#...#
.###########.#######.###.#.###.#.#####.#.#.###.#######.###.#.###
.#.........#.....#...#...#.#...#.....#.#.#...#...#...#.#.#.#...#
.#.###.#########.#.###.#.#.#.#######.#.#####.###.#.#.#.#.#.###.#
.....#.............#...#.....#.......#.........#...#.....#.....#
################################################################
