8
G......#
.###.###
...#...#
##.###.#
...#S..#
.#######
.......#
########
