64
...#...#.....#.......#...................#.......#...#.........#
.#.#.#.#.#.#.#####.#.###.#############.###.###.#.#.#.#####.###.#
.#...#.#.#.#.....#.#...#...#.........#.....#...#.#.#.....#.#.#.#
####.#.#.#.#####.#.###.#.###.#######.#.#####.###.#.#####.#.#.#.#
...#.#...#.#...#...#.#.#.#...#.#.....#.#...#...#.#...#...#.#.#.#
.#.#.#####.#.#######.#.###.###.#.#####.###.###.#.###.#.###.#.#.#
S#.#.#.....#.#...#...#.....#...#.#...#.....#...#.#...#.....#...#
##.#.#.#####.#.#.#.#.#######.###.#.#.###.###.###.#.#########.###
.#.#.#.....#...#...#.....#...#...#.#...#.#...#.....#.......#...#
.#.#######.#.#######.###.#.#.#.###.#####.#.#########.#.#######.#
.#.........#...#...#...#...#.#.#.#...#...#.......#.#.#.........#
.###############.#.#########.#.#.#.#.#.#########.#.#.###########
.......#.........#.....#.....#.#...#.........#...#...#...#.....#
.#####.#.#############.#.###.#.###.#########.#.###.###.#.#.#.#.#
...#.....#.......#.......#...#...#.#.......#.#...#.#.#.#.#.#.#.#
.#.###.#########.#.#########.###.#.#.#####.#.###.#.#.#.#.#.#.###
.#...#.#...#...#...#.......#.#...#.#.....#.#...#.#.#...#...#...#
####.#.#.#.#.#.#####.#####.###.###.#####.#.###.#.#.#.#########.#
.....#.#.#...#.#.....#...#...#...#.#.....#...#.#.#.#...#.......#
.#######.#####.#.#####.#.###.###.###.#######.#.#.#.#####.#####.#
.........#...#.#.#.....#...#.#...#...#...#...#.#.#.#...#...#.#.#
.#########.#.#.#.#########.#.#.###.###.###.#####.#.#.#.###.#.#.#
.....#.#...#...#.....#...#.#.#...#.#.#.....#.....#...#.#...#...#
####.#.#.#.#########.#.#.#.#.###.#.#.#.#####.#########.#.###.###
...#.#.#.#.#.........#.#.#.#...#...#.#...#.#...#.....#...#.#...#
.###.#.#.###.#########.#.#.###.#####.###.#.#.#.#.###.#####.###.#
.....#.#...#...#.......#...#.#.....#.....#...#...#...#...#.....#
.#####.###.###.#.###.#####.#.###.#.#.###########.#.###.#.#.#####
.........#.....#...#...#.......#.#.#.#.........#.#.#...#.#.#...#
########.#########.###.#######.#.###.#.#######.###.#.#.###.#.###
.......#...#.....#...#...#.#...#.....#.#...#.....#.#.#.#...#...#
.#####.###.#.###.###.###.#.#.#########.#.#.#####.#.#.#.#.#####.#
.....#.#...#...#...#.#...#.#.#.......#.#.#...#.....#.#.#.....#.#
####.#.#.###.#.###.###.###.#.#.#####.#.#.###.#######.#######.#.#
.....#.#...#.#.#.#...#...#.#...#...#.#.....#.....#...#.....#.#.#
.#########.###.#.###.###.#.#####.###.#####.#####.###.#.###.#.#.#
.........#.....#...#...#.#.#...#...#...#.....#...#...#.#...#.#.#
.#####.#########.#####.#.#.#.#.#.#.###.#.#####.###.#.#.#.###.#.#
.#...#.....#.#.........#.#...#.#G#...#.#...#...#...#.#.#.#...#.#
.#.#.###.#.#.#.#########.#.###.#.#.#.#.#####.###.#.###.#.#.###.#
.#.#.....#...#.#.........#...#.#.#.#.#...#...#...#.#...#...#...#
.#.#########.#.###.#########.#.#.#.#####.#.###.###.#.#########.#
.#.#.......#.#.....#.......#.#...#.....#...#...#...#...#.......#
.#.###.#.###.#########.###.#.#######.#.#####.#.#######.###.###.#
.#...#.#...#.....#.....#...#...#.....#.....#.#.#.....#.#...#...#
.###.#.###.#####.#.#####.#####.#.#########.###.#.#.###.#.###.###
...#.#.#...#.......#.......#...#.........#...#...#...#.#.#...#.#
####.###.#.#.#####.#######.#.#####.#####.###.#.#####.#.#.#.###.#
.....#...#.#.#...#.#...#...#.#...#.#.....#.#.#.#.....#.#.#.....#
.#####.#.###.#.#.###.#.#####.#.#.###.#####.#.#.#.###.#.#.#####.#
...#...#.#...#.#.#...#.......#.#...#.#.....#.#.#.#...#...#.#...#
.#.#.#.###.###.#.#.###########.###.#.#.#.###.###.#.#######.#.###
.#.#.#.#...#...#...#.#.......#.#.....#.#...#.#...#.#...#...#...#
##.#.#.#.###.#######.#.#####.#.###.#######.#.#.###.#.#.#.#.###.#
...#.#.#.#.#.#.......#.....#.#...#.#.....#.....#.#...#.#.#.#...#
.###.###.#.#.#.#.#######.###.###.###.###.#######.#####.#.#.#.###
...#...#...#.#.#.........#.....#...#.#.#.....#...........#.#...#
##.#.#.###.#.###.#########.###.###.#.#.#####.#.#######.#######.#
...#.#.....#...#.#.......#...#.#.#.#.#.....#.#...#...#.#.....#.#
.#############.###.#####.###.#.#.#.#.#.###.#.###.#.#.#.#.###.#.#
.#...#.......#...#.#...#.....#.#.#.#...#...#...#.#.#.#.#.#.#...#
.#.#.#.#####.###.#.#.#.#######.#.#.#####.#####.###.#.###.#.#####
...#.......#.......#.#...........#...........#.....#...........#
################################################################
