64
.........#...........#.#.....#...........#...#...#.............#
.#.#####.#.#########.#.#.###.###.#.#####.#.#.###.#.#.###.#######
.#.#...#.#...#.#.....#.#.#.#...#.#.....#.#.#...#...#...#.#.....#
##.#.#.#.###.#.#.#####.#.#.###.#######.#.#.###.#.#####.###.###.#
...#.#.......#...#...#.#.#.............#...#.#.#...#...#...#...#
.###.#########.###.#.#.#.###################.#.###.#.#.#.###.#.#
.#...#.#.....#.....#...#.#.....#.#...........#...#.#.#.#.#...#.#
.###.#.#.###.#######.###.#.###.#.#.#####.###.###.#.#.###.#.###.#
...#...#.#...#...#...#...#.#.#.#.#.#.#...#.#.#.#.#.#.#...#...#.#
.#.###.#.#.###.#.#####.###.#.#.#.#.#.#.###.#.#.#.###.#.#####.#.#
.#...#.#.#.#...#.#...#.#...#.#.#.....#.#.......#...#...#...#.#.#
####.###.#.#.###.#.#.#.#.###.#.#######.#.#########.#.###.#.#.#.#
...#.#...#.#...#...#...#.....#...#.....#.#.....#...#.#...#.#.#.#
.#.#.#.###.###.#############.###.#.###.###.###.#.###.#.###.#.###
.#...#.#.#.....#...#.......#.#...#.#...#...#.#...#...#.#.#.#...#
.#.###.#.#.#####.#.#.###.#.#.#.###.#####.###.#####.###.#.#.###.#
.#.#...#...#.....#.#...#.#.#.#...#.....#.#.......#...#.#.#.....#
.###.#######.#####.###.#.#.#.###.#####.#.###.###.###.#.#.#####.#
...#.........#...#...#.#.#.#...#.....#.#...#...#.#...#.#.....#.#
.#.###########.#.#.###.#.###.#####.#.#.###.###.###.###.###.###.#
.#.........#...#.#.....#.#...#...#.#.#...#...#.......#...#.#...#
.#######.###.###.#######.#.###.#.#.#.#.#.###.#######.###.#.#.###
...#.....#...#.#.......#...#...#.#.#.#.#...#.......#.#...#.....#
.###.###.#.###.#######.#####.###.###.#.###.#######.###.#######.#
.#...#.#.#...#.......#...#...#.#.#...#.#.#.......#...#.......#.#
.#.###.#.###.###.#######.#.###.#.#.###.#.#.###.#####.#.#####.#.#
.#.#.......#.#...#.....#.#...#...#.#...#.#.#...#...#.#.#.....#.#
.#.#########.#.###.###.#.#.#.#.###.#.###.#.#####.#.#.###.#####.#
.#.#.....#...#...#.#.....#.#.#.....#.....#.#.....#...#...#...#.#
##.#.###.#.#####.#.#######.#.###########.#.#.#########.###.###.#
...#.#.#.#.......#...#.....#...#.....#...#...#.........#...#...#
.###.#.#.#######.###.#.#######.###.###.#########.#####.#.###.###
.#...#.#.#.....#...#S#.#.#...#.#...#...#.......#.#.....#.....#.#
.#.###.#.#.#.#.###.###.#.#.#.#.#.###.###.#.###.###.#####.#####.#
...#...#...#.#.#...#.#...#.#...#.#...#...#...#.....#...#.#.....#
.###.#.#####.###.###.###.#.#####.#.###.#####.#########.#.###.#.#
.#...#.....#...#.#.......#.#.#.....#.#...#...#.#.......#.....#.#
.#########.###.#.###.#####.#.#.#####.###.#.###.#.#.###########.#
.#...#.....#...#...#.#.....#.#.....#.....#.#...#.#.............#
.#.#.#.###.#.#####.###.#####.#####.#.#####.#.###.###############
.#.#...#.#.#.....#.....#...........#...#...#.#...#.#.......#...#
.#.#####.#.#####.#######.###############.###.#.###.#.###.#.###.#
...#.....#.#...#.....#...#...#.......#...#.....#.......#.#...#.#
########.#.#.#####.###.#####.#.###.#.#.###.#############.###.#.#
.......#.#.#.....#.....#.....#.#...#...#...#.....#.....#.#...#.#
.#####.#.#.###.#.#######.#.###.#.#######.#####.#.#.###.#.#.###.#
.#.......#.#...#...#.....#.#...#.....#...#...#.#...#.#...#.....#
.#########.#.#####.#.###.###.#######.#.###.#.#.#####.#########.#
.........#.#.....#.#...#.#...#...#...#.#...#...#.....#.......#.#
.#######.#.#.###.#.###.#.#.#####.#.###.#.#######.###.#.###.###.#
.....#...#.#...#.#.#...#...#.....#.#.....#.......#...#...#...#.#
####.#.###.#.###.#.#.#######.###.#.#######.#.#.#########.###.#.#
.#...#.....#.#...#.#.........#...#.....#...#.#.#.......#.#.#...#
.#.#########.#.###.###########.#######.#.###.#.#.#####.#.#.#####
.#...#.......#.#.#.........#...#.......#.#...#.#...#.#...#....G#
.###.#########.#.#########.###.#.#######.#.###.###.#.#########.#
...#...#.......#.........#...#.#.......#.#.#.....#...#.........#
.#####.#.#######.###########.#########.#.#.#########.#.#######.#
.#.....#...#.....#.........#.........#.#.#...#.....#.#.....#...#
.#.#######.###.#.#.#####.#.#########.#.#.###.#.#.###.#####.###.#
.#.......#...#.#...#...#.#.....#.....#.#...#...#...#.#...#...#.#
.#######.###.#.#######.#.#######.#####.###.#######.#.#.#.###.#.#
.............#.........#...............#.........#.....#.....#.#
################################################################
