32
...........#.....#...#...#.....#
.#####.###.#.###.#.#.#.#.###.#.#
.#.....#.#.#.#.#...#.#.#...#.#.#
##.#####.#.#.#.#####.#.###.###.#
...#.........#.#...#.#...#.....#
.#############.#.#.#.###.#######
.#.....#...#.....#.....#.......#
.#.###.#.#.#.#########.#######.#
...#...#.#.#...#...#.#...#.....#
.###.###.#.#####.#.#.###.#.###.#
.#...#...#.....#.#.#...#.#.#...#
##.#.#.#.#####.#.#.#.###.#.###.#
...#.#.#.#S#.#.#.#.#.....#...#.#
.#####.###.#.#.#.#.###.###.#.###
.....#.....#.#...#...#.#...#...#
.###.#######.#######.#.#.#####.#
.#.....#.....#.......#.#.#.....#
.#.###.#.#####.#######.#.#.#####
.#.#...#.#...#.#...#...#.#.#...#
.#.#.###.#.#.#.###.#.###.#.#.#.#
.#.#.....#.#.#.#...#.#...#...#.#
.#.#####.#.#.#.#.###.#.#######.#
.#.....#.#.#...#.....#.#.......#
.#####.###.#######.#####.#####.#
.....#...#.......#.....#.#....G#
####.###.#######.#####.#.#.#####
.....#.#.....#...#...#...#...#.#
.#####.#####.#.###.#.#######.#.#
...#.......#.#.....#...#.#...#.#
##.###.###.#.#########.#.#.###.#
.......#...#...........#.......#
################################
