16
...#...........#
.###.#######.###
.#...#.....#...#
.#.###.###.###.#
.#...#...#...#G#
.###.###.###.#.#
...#...#.#...#.#
.#.###.#.#.###.#
.#.....#.#.....#
####.###.#####.#
...#...#.#.....#
.#.###.#.#.#####
.#..S#.#.#...#.#
.#######.###.#.#
.........#.....#
################
