64
.........#.......#...#.................#...........#.......#...#
.#.#####.#.#######.#.###.###########.#.#.#########.#.###.#.###.#
.#...#.....#.......#...#.#.........#.#.#.....#.....#.#...#...#.#
####.#.#####.#########.#.#####.#.###.#.#####.#.###.#.#.#####.#.#
.....#.#.....#.#...#...#...#...#.#...#.#...#.#...#.#.#.....#...#
.#######.#####.#.#.#.#####.#.###.#.###.#.#.#.###.###.#####.#####
.#.....#...#.....#.#.#...#.#.#...#...#.#.#...#.#.#...#.....#...#
.#.###.###.#.#####.#.###.#.#.###.###.#.#.#####.#.#.###.###.#.#.#
...#...#...#.....#.#...#...#...#...#.#.#...#...#.#...#...#.#.#.#
.###.#.#.#########.###.###.###.#.###.#.###.###.#.###.###.###.#.#
.#...#.#...#.........#...#...#.#.#...#.#.#...#.#.#...#.#.....#.#
##.###.###.#.#####.#####.###.#.###.###.#.###.#.#.#.###.#######.#
...#.#...#S#.....#.#...#.#.....#...#.#.#...#.#.#.#...#...#.....#
.###.###.###.###.#.#.#.#.#####.#.###.#.#.#.#.#.#.###.###.#.###.#
...#.....#...#...#.#.#...#...#.#...#...#.#...#.#...#.....#...#.#
.#.#######.###.###.#.#####.#.#.###.#.#####.###.#.#.#####.###.#.#
.#.....#...#.#...#.#.......#.#.#...#.....#.....#.#.....#.#...#.#
.#####.#.###.###.###########.###.#######.#######.#######.#.#####
.#.....#...#...#.........#...#...#.....#.#.....#.#.......#.....#
.#.###.###.#.###########.#.###.###.#####.#.###.#.#.###########.#
.#.#.#.#.#.#.......#.....#...#...#.......#.#...#.#...#.....#...#
##.#.#.#.#.#####.###.#######.###.#.#######.#.###.###.#.###.#.#.#
...#.#...#.....#...#...#...#.#...#...#.....#...#...#.#...#.#.#.#
.###.###.#####.###.###.#.#.#.#.#####.#.#######.#.#.#.###.#.#.#.#
.#.....#.#.....#.....#.#.#...#.#...#...#...#.#.#.#.#.#...#.#.#.#
.#.#####.#.#####.#####.#.#####.#.#.###.#.#.#.#.#.###.#####.#.#.#
.#.......#.#.....#...#.#.#.....#.#.....#.#.#.#.#...........#.#.#
.#.#######.#.###.#.#.#.#.#####.#####.###.#.#.#.#.###########.#.#
.#...#.....#...#.#.#...#.....#.....#.#...#.#.#.#.....#.......#.#
.#####.#######.#.#.#########.#.###.###.###.#.#.#######.#######.#
.#.....#.......#.#.......#.#.#...#.....#...#.#.......#.#.....#.#
.#.#########.###.#####.#.#.#.#.#########.###.#######.#.#.###.#.#
.#.........#.#.#.#...#.#.#.#.#.#.....#...#.....#...#...#.#.#...#
.#########.#.#.#.#.#.#.#.#.#.#.#.###.#.###.#####.#.#####.#.#####
...#.....#...#...#.#.#.#...#.#.#.#.#.#...#.#.....#.....#.......#
.###.#.#######.#####.#.###.#.#.#.#.#.#.#.#.#.#########.#######.#
.#...#.......#.#.....#...#.#.#.#.#.#.#.#.#.#...#...#.#.......#.#
.#.#####.#####.#.#.#####.###.###.#.#.###.#.###.#.#.#.#######.#.#
.#.#...#.......#.#.....#...#.....#.#.....#...#...#.#.#.......#.#
.#.###.#########.#####.###.#######.#########.#####.#.#.#######.#
.#.....#.#.......#...#...#.......#...............#.#.#.........#
.#####.#.#.#######.#.#.#####.###.###.#############.#.###########
.....#.#...#.......#...#...#.#.......#...#.......#.#.....#.....#
.###.#.#####.#########.#.#.#.#.#######.#.#.#####.#.###.#.#.###.#
...#.#.......#.......#.#.#...#.#.......#.#...#...#.....#...#...#
##.#.#########.#####.#.#.#######.#######.###.#.#.###########.###
...#...........#.#...#.#.........#.....#.#...#.#.....#.....#.#.#
####.#.#########.#.###.###########.###.#.#.###.#####.#.###.#.#.#
...#.#.#...#.....#.#...#.........#.#.....#.#.#.....#...#...#...#
.#.#.###.#.#####.#.#.#######.###.#.#######.#.#####.###########.#
.#.#.....#.#...#...#.......#.#...#.......#...#...#.........#...#
.#.#.#####.#.#.###########.###.#.#######.###.#.###########.#.###
.#.#.#.....#.#...........#.#...#.#...#...#...#.........#.#...#G#
.#.###.###.#.#########.###.#.###.#.#.#.#.#.#######.###.#.#####.#
.#.....#...#.#.......#...#.#.#.#.#.#.#.#.#...#...#.#.#.....#...#
.#######.###.###.#######.#.#.#.#.#.###.#####.#.#.#.#.#####.#.#.#
.....#.#...#.....#.......#...#...#...#.....#...#...#.#...#.#.#.#
.###.#.#.#######.#.###########.#####.#####.#########.#.#.#.###.#
.#.#.#...#.....#.#...#.....#.........#...........#...#.#.#...#.#
.#.#.#####.###.#.###.#.###.#.#########.###.#####.#.###.#.###.#.#
.#.#.#.....#...#...#...#...#.#.#.......#...#...#...#...#.....#.#
.#.#.#.#####.#####.#####.###.#.#.###########.#.#####.#########.#
...#.......#...........#.......#.............#.................#
################################################################
