32
.#.....#...#.....#...#...#.....#
.#.#.#.#.#.#.#.#.#.###.#.#.###.#
.#.#.#...#.#.#.#...#...#.#...#.#
.#.#.#####.#.#.###.#.###.#.#.#.#
.#.#.#...#.#.#.#.#.#.#...#.#.#.#
.#.#.#.#.#.###.#.#.#.#.#####.#.#
.#.#...#.#.....#...#.#.......#.#
.#.#####.#######.###.#########.#
...#.....#.....#...#....S#...#.#
####.#######.###.#########.#.#.#
.....#.......#...#.......#.#...#
.#####.###.#.#.###.###.###.#####
...#.#.#.#.#.#...#.#.#.....#...#
##.#.#.#.#.#####.#.#.#######.#.#
...#...#.#.#.....#...#.....#.#.#
.###.###.#.#.#######.#.#.#.###.#
.#.......#.....#...#.#.#.#...#.#
.#####.#########.#.#.###.###.#.#
.....#.#.........#.#.....#.#...#
####.#.#.#########.#######.###.#
.....#.#.#.......#...........#.#
.#####.#.###.#########.#.###.#.#
.#.....#.#...#.......#.#.#...#.#
.#####.#.#.#.#.#####.###.#####.#
.#...#.#...#.#.....#.....#.....#
.#.#.#######.#####.#.#####.#####
...#...#..G..#...#.#.#.....#...#
.#####.#.#####.#.#.###.#######.#
.....#.#.....#.#.#.....#.......#
####.#.#####.#.#.#######.#####.#
.....#.........#.........#.....#
################################
