8
.......#
####.#.#
.....#.#
.#####.#
S#...#.#
##.###.#
......G#
########
