16
.#.......#.....#
.#.#####.#.#.#.#
...#...#...#G#.#
.###.#.#####.###
.....#.....#...#
######.#######.#
.......#.......#
.#######.#####.#
.......#.....#.#
.###########.###
.#S#.......#...#
.#.#.#####.#.#.#
.#.#.#...#.#.#.#
.#.#.#.#.#.###.#
.#...#.#.......#
################
