32
...............#...............#
.#########.###.#######.#######.#
.#.........#.#.......#.#.#...#.#
##.#########.#######.#.#.#.#.#.#
...#.....#.........#...#.#.#.#.#
.#####.###.#.###########.#.#.#.#
.....#.#...#...............#.#.#
.###.#.#.###################.#.#
.#...#.#.#.....#...#.........#.#
.#.###.#.#.#.#.#.#.#.#########.#
.#...#...#.#.#.#.#.#.#.........#
.###.#.#####.#.###.#.#.#########
...#.#.......#...#.#...#G......#
##.#.###########.#.###########.#
.#.#...........#.#...#.........#
.#.###########.#.#.#.###.#####.#
.#.#.....#.....#...#.....#...#.#
.#.#.###.#.#######.#######.###.#
.....#...#.#.......#.....#...#.#
.#########.#.#######.###.###.#.#
.#.#...#...#...#.....#...#...#.#
.#.#.#.#.###.###.#####.###.#.#.#
...#.#.#...#.#.......#.#...#.#.#
####.#.###.#.#.#######.#.###.#.#
...#.#.....#.#.#.#...#.#.#...#.#
.#.#.#########.#.#.#.#.#.#.###.#
.#.#.#...........#.#...#.#...#.#
.#.#.#.###########.#####.#####.#
.#...#.#.#...#.....#.#...#.....#
.#####.#.#.#.#.#####.#.#.#.#####
.........#S#...#.......#.......#
################################
