16
.....#.........#
.#.###.#.#######
.#.#...#.......#
##.#.#########.#
..G#...#.....#.#
.#####.#####.#.#
...#...#.....#.#
.#.#.###.#.###.#
.#.#.#...#.#...#
.#.#.#.#####.#.#
.#...#.#.....#.#
.#####.#.#######
...#...#.#S....#
##.###.#.#####.#
.......#.......#
################
