16
.....#...#.....#
##.#.#.#.#####.#
...#.#.#.....#.#
.###.#.#####.#.#
.#.#.#.....#...#
.#.#.#####.###.#
.#.#.#S....#.#.#
.#.#.#######.#.#
.#...#.....#...#
.###.#.###.#.###
...#...#...#.#.#
##.#####.###.#.#
...#...#.#...#.#
.###.#.###.###.#
.....#........G#
################
