16
.......#.#.....#
.#####.#.#.###.#
.#.....#...#...#
.#.#####.###.###
.#....S#.#.#...#
.#######.#.###.#
.#...........#.#
.#############.#
...#...........#
##.#.#########.#
.#...#.....#...#
.#####.#.###.###
.......#.#...#.#
.###.#####.###.#
...#........G..#
################
