64
.....#.....#.........#.........#...........#.......#...#.......#
.#####.#.###.#####.#.###.#.###.#.#####.###.#######.#.#.#.#####.#
.....#.#.....#...#.#...#.#...#.#.#...#...#.......#.#.#...#G#...#
.###.#.#########.#.###.#.###.###.#.#####.#######.#.#.#####.#.#.#
.#...#...#.......#...#.#...#.......#.....#...#.#.#.#.#.....#.#.#
.#.#####.#.###.#####.#.###.#########.#.###.#.#.#.#.#.###.###.#.#
.#.....#.#...#.#...#.#.#...#.........#.#...#.#.....#.....#...#.#
.#####.#.###.###.#.#.#.#####.#########.#.###.#######.#####.###.#
.#.#...#...#.....#.#.#.......#.......#.#.#.#.#.....#.#...#.#...#
.#.#.#####.#######.#.###.#########.#.#.#.#.#.#.###.#.#.#.#.#####
...#.....#.#.....#.#.#.#.#.......#.#.#.#.#.#...#.#...#.#.#.....#
######.###.#.###.#.#.#.#.#.#####.#.#.#.#.#.#####.#####.#.#####.#
.......#...#.#.....#.#...#.#...#.#.#...#.......#.#...#.#.......#
.#######.###.#######.#.###.#.#.#.#############.#.#.#.#.#######.#
...#.....#.#.....#...#...#.#.#.#.............#...#.#...#.......#
.#.#.#####.#.###.#.#####.#.###.#########.###.#.###.#####.#######
.#.#.....#.....#.#...#...#...#.....#...#.#...#.#...#...#.#...#.#
.#.#####.#######.###.#.#####.#.###.#.#.#.#####.#.###.#.#.#.#.#.#
.#.#.....#.....#...#.#...#.#.#...#.#.#.#.......#.#.#.#...#.#...#
.#.#.#####.###.###.#.###.#.#.###.#.#.#.#########.#.#.#####.###.#
.#.#.....#.#.#...#.#...#...#.#...#.#.#...........#.#.....#...#.#
##.#####.#.#.###.#.###.###.#.#####.#.#############.#####.#.#.#.#
...#...#.#.#...#.#...#...#.#.#.....#...#.......#.......#.#.#.#.#
.###.#.#.#.#.###.#.#####.###.#.#.#####.#.###.###.#####.#.###.#.#
.....#.#...#.#.....#...#...#...#.#.....#...#.#.....#...#.#...#.#
.#####.#####.#.#####.#.###.#####.#.#########.#.#####.#.#.#.###.#
...#.......#...#.....#.......#...#.#.......#...#.....#.#.#...#.#
##.#.#######.###.#.#########.#.###.#.###.#.#####.#####.#.###.#.#
...#.........#...#.#.......#.#.#...#.#...#...#...#.#...#...#.#.#
.#############.#.###.#####.###.#.#####.#####.#.###.#.#####.#.#.#
.....#.....#...#.#.......#.....#.....#...#.#...#...#.....#...#.#
####.#.#####.#####.#####.###########.#.#.#.#####.#.#####.#####.#
...#.#...#...#.....#S#.#.#.....#.....#.#.#.....#.#.....#.#.....#
##.#.###.#.#.#.#####.#.#.#####.#.#######.#.###.#.###.###.#.#####
...#.....#.#.#.....#.#.#...#...#...#.....#...#...#.#.....#.....#
.#####.###.#.###.###.#.###.#.#####.#.#.#########.#.#####.#####.#
.....#.#...#...#.#...#...#.#...#...#.#.#.......#...#...#.....#.#
.#.###.#.#######.#.###.#.#.###.#.###.###.#####.#####.#.#######.#
.#.#...#.........#...#.#.......#...#.#...#.....#.....#.#.....#.#
.#.#.###############.#####.#######.#.#.###.#####.#####.#.###.#.#
.#.#...#...#...#...#.....#.#.......#...#...#...#...#...#.#.#...#
##.###.#.#.#.###.#.#####.###.###########.#.#.#.#.###.###.#.#####
...#.....#...#...#.......#...#...........#.#.#...#...#...#...#.#
.###.#########.###########.###.###########.#.#####.#.#.###.#.#.#
.....#...#.....#...#.......#.....#.........#.#...#.#.#.#...#...#
.#####.#.#.#####.###.#.#########.#######.###.###.#.###.#.#####.#
.....#.#.#.#...#...#.#.........#.......#.#.......#.#...#.#...#.#
.#####.#.#.#.#.#.#.#.#########.#####.#.###.#######.#.###.#.###.#
.#...#.#.#...#.#.#.....#.#...#.....#.#.#...#.......#.....#...#.#
.#.#.#.#.#####.#######.#.#.#.#####.###.#.###.#####.#######.#.#.#
.#.#...#.....#...#...#.#...#.....#.#...#.#.#.....#.......#.#.#.#
.#.#####.###.###.#.#.#.#####.#.###.#.###.#.#####.#######.#.#.#.#
.#.....#.#.....#...#.#.#.....#.#...#.#.........#...#.....#.#...#
######.#.###########.#.#.###.###.###.#.#######.###.#######.#####
.......#.............#...#...#...#.#...#...#.....#.......#.....#
.#############################.###.#.###.#.#######.#####.#####.#
.#.......#...........#.........#...#...#.#...#...#.#.........#.#
.#.#.###.#.#######.#.#.#########.#.###.#.###.#.#.###.#######.#.#
.#.#...#.#.#.....#.#.#.........#.#.....#...#...#.....#.....#.#.#
.#.###.#.#.#.###.#.#.#.#######.#.#########.#########.#.###.###.#
.#.#...#.#.#.#.#.#.#.#.#.......#.#...#...#.....#...#.#...#...#.#
.###.###.###.#.#.#.#.###.#######.#.#.#.#.#####.#.#.#####.###.#.#
.....#.......#.....#.....#.........#...#.....#...#.........#...#
################################################################
