16
...#...#..G....#
.#.#.#.#.###.#.#
.#...#.#...#.#.#
.#####.###.#.###
.#...#...#.#...#
.#.#.###.#.###.#
.#.#.....#.#...#
.#.#######.#.###
.#.......#.#...#
.#######.#.###.#
.#.....#.#.#.#.#
.###.###.#.#.#.#
...#.#S..#...#.#
##.#.#########.#
...............#
################
