16
.....#.........#
.###.#####.###.#
..G#.......#...#
.#.#########.###
.#...#.....#...#
.###.#.#.#####.#
.#...#.#.......#
##.###.#########
...#.....#.....#
.#########.###.#
.#.....#.....#.#
.#.###.#.#####.#
.#.#.#...#.....#
.#.#.#####.###.#
.........#S#...#
################
