32
...#.....#.......#.......#.....#
##.#.###.#######.#.#.###.#.###.#
...#.#.#.......#...#.#...#...#.#
.###.#.#######.###.#.#######.#.#
...#.....#...#...#.#.........#.#
.#.#####.###.###.#.###########.#
.#...#.........#.#...........#.#
####.#.#########.###########.#.#
.....#.#.......#.#...#.....#.#.#
.#####.#.#####.#.#.###.#.###.#.#
...#...#...#.#...#.....#.....#.#
##.#.#####.#.#############.###.#
...#.#S....#.............#.#.#.#
.###.#######.###########.#.#.#.#
.....#.#.........#.......#...#.#
.#####.#.#######.#######.#####.#
.#.....#.....#...#.....#.......#
.#.#.#######.#.#.#.###.#######.#
.#.#.......#.#.#.#.#.#...#.....#
.#######.#.#.#.###.#.###.#.#####
...#.....#.#.#.#...#...#.#.#...#
##.#.#######.#.#.###.#.#.#.#.###
.#.#.#...#...#.....#.#.#.#.#...#
.#.#.#.#.#.#######.#.#.#.#.###.#
.#.#...#...#.....#...#.#.#.....#
.#.#########.###.#.#####.#####.#
.#...........#.#.#.#...#...#...#
.#############.#.###.#.###.#.###
.#.......#.....#.....#.#...#.#.#
.#.#####.#.#.#########.#.###.#.#
.......#...#............G#.....#
################################
