64
.........#.............#...#...#.......#.........#.......#...#.#
##.#####.#######.#####.#.#.#.###.###.#.#.#######.###.###.#.#.#.#
...#.......#...#...#...#.#.#.......#.#...#.....#...#...#...#...#
.#########.#.#.#.#.#.###.#.#########.#########.###.###.#######.#
.......#...#.#.#.#.#.#...#.#.....#...#.........#...#...#.......#
######.#.###.#.###.#.#.###.#.###.#.###.#####.###.###.###.#######
...#...#.....#.....#...#.#.#...#...#.......#.#...#.....#.#..G..#
.#.#.###################.#.###.#.#########.###.#####.#.#.#.#####
.#...#.........#.......#.......#.#.......#...#.....#.#.#.#.....#
.#############.#.###.###.#########.#####.#.#.#####.###.#.#####.#
.#.......#...#.#.#.#.......#.........#...#.#...#.#.....#.....#.#
.#.#####.#.#.#.#.#.#########.#########.###.#.#.#.###########.#.#
.#.#...#...#.#.....#.............#.....#...#.#.#.....#.......#.#
.#.###.#####.#######.###########.#.#####.###.#.#####.#.#######.#
.#.....#...#.#.........#.......#.#.#...#.#...#.....#.#.#.......#
.###.###.#.#.#.#########.#####.###.#.#.#.#.#######.#.#.#.#####.#
...#.#...#...#.#...#.....#.#.......#.#.#.#...#.....#.#.#.#.#...#
##.#.#.###.###.###.#.#####.#.#######.#.###.#.#####.#.#.#.#.#.###
...#.#...#.#...#...#...#...#.#...#...#...#.#.....#...#.#.#.#.#.#
.#.#.###.#.#.###.#.###.###.#.#.#.#.#####.#.#####.#####.#.#.#.#.#
.#.#...#.#.#.....#...#.#...#.#.#...#...#.#.#.....#.....#.#.....#
.#####.#.#.#######.###.#.###.#.#######.#.#.#.###.#.#####.#####.#
.......#.#.#...#.#.#...#...#.#.....#...#.#.#...#.#...#.....#.#.#
.#####.#.#.#.#.#.#.#.###.#.#.#####.#.#.#.#.###.#####.#.###.#.#.#
.#...#.#.#...#...#.#...#.#...#...#.#.#.#.#...#.......#...#.#.#.#
##.#.###.#########.###.#.#####.#.#.#.#.#.###.#############.#.#.#
...#.....#.......#.#.#.#.....#.#...#.#.#...#.....#.....#...#...#
.#.#######.#####.#.#.#.#####.#.#####.#####.#####.###.#.#.###.###
.#.#.......#.#...#.#.#...#.#.#.....#.....#.....#.....#.#.#...#.#
.###.#######.#.###.#.###.#.#.#####.#####.#####.#######.#.#.###.#
...#.#.......#...#...#.#.#...#...#.#.......#...#.....#.#.#...#.#
.#.#.#######.###.###.#.#.###.#.###.#.#######.###.#####.#.###.#.#
.#...#.........#.#...#.#...#...#...#.#.....#.#.........#.#.....#
.#####.#########.#.###.###.###.#.###.#.###.#.#.#########.#######
.#...#.#.....#...#.#.....#...#.#.#...#.#.#...#...#.....#...#...#
.#.#.#.#.###.#.###.#.#######.###.#.###.#.#######.#.###.#.#.#.#.#
.#.#.#.#.#...#.....#.#.....#.#...#.....#.....#...#.#.#.#.#...#.#
.#.#.#.#.#.###.#####.#.###.#.#.###.#####.#.###.###.#.#.#.#####.#
.#.#.#.#.#...#.......#.#.....#.#.#.#...#.#.....#.#...#.#.#...#.#
.#.#.#.#.###.#####.###.#.#####.#.#.#.#.###.#####.###.#.#.#.###.#
...#.#.#...#...#.#.#...#.#.#S..#.#.#.#...#.....#.....#.#.#.#...#
####.#.###.###.#.#.#.###.#.#####.#.#.###.#####.#######.#.#.#.###
...#.....#.#...#...#.#.....#.#...#.#...#.#...#...#...#.#.#.#...#
.#.###.###.#.#######.#####.#.#.#.#.###.#.###.###.#.#.#.#.#.###.#
.#.#...#...#.#.....#.#...#...#.#...#...#...#...#...#.#.......#.#
.#.###.#.###.#.###.#.#.#.#####.#####.#####.#.#######.#########.#
.#...#.#...#...#...#.#.#.......#.....#.#...#.......#.#.........#
.###.#.###.#####.###.#.###########.###.#.#########.#.#.#######.#
...#.#...#...#.#.#...#.........#...#.#...#...#.....#.#.#.....#.#
.#.#.#######.#.#.#.#.#########.#.###.#.###.#.#.#####.#.#.###.#.#
.#.#.......#.#...#.#.....#...#...#...#...#.#.#.....#...#.#.#.#.#
.#.#######.#.###.#######.#.#.#####.#####.#.#.#.###.#####.#.#.#.#
.#.....#.#.#...#.........#.#.....#.....#...#.#...#.......#...#.#
.#####.#.#.###.#########.#.#.###.#.#.#.#####.###.#.#######.###.#
.#.....#.......#.........#.#...#.#.#.#.....#.#...#.......#.#...#
.#.###.#########.#########.###.###.#.#####.#.#.#########.###.###
.#...#.#.....#...#...#...#...#.....#...#...#.#.#.......#.....#.#
.###.###.###.###.###.#.#.###.#########.#.###.#.#######.#######.#
...#.#...#.#...#.....#.#...#.#.......#.#.#...#...#.............#
##.#.#.###.###.#######.###.#.#####.#.#.#.#.#####.#.###########.#
...#.#.#.....#...#...#.#.#.#.....#.#.#.#.#.#...#...#.........#.#
.###.#.###.#.###.#.#.#.#.#.#####.#.#.#.###.#.#######.###.#####.#
...#.......#...#...#.....#.........#.#.....#...........#.......#
################################################################
