32
.........#...#.....#...........#
####.###.#.#.#.###.#.###.#######
...#.#.....#.#.#...#.#.#.......#
.#.#.#.#####.#.#.###.#.#######.#
.#...#.#...#...#...#...#.....#.#
.#####.#.#.###.#######.###.###.#
.#...#.#.#...#.#.....#.#...#...#
.#.#.###.###.#.#.###.#.#.#.#.#.#
...#G......#.#.#...#...#.#.#.#.#
.###########.#.###.#####.#.#.###
...#...#...#.#.#.#.#.....#.#...#
##.###.#.#.#.#.#.#.#.#########.#
.......#.#...#...#...#.........#
.#######.#.#####.#.###.#########
.#.......#.#...#.#.#...#.......#
##.#.#####.#.#.###.#.#######.###
...#.#...#.#.#.....#...#...#...#
.#####.#.###.#########.#.#.#.#.#
.......#.#...#.#.....#...#S#.#.#
########.#.###.#.###.#########.#
.........#...#...#.....#.......#
.#######.###.#.###.###.#.#.###.#
.#.......#...#.#.#...#.#.#...#.#
.#.#######.###.#.###.#.#.###.###
.#.......#.#.#.....#.#.#...#...#
.#######.#.#.#####.#.#.###.###.#
...#...#.#.#.......#.#.#...#...#
##.#.#.#.#.#########.#.#.###.#.#
...#.#.#.#.....#.....#.#.#...#.#
.###.#.#######.#.#####.###.###.#
.....#...........#.........#...#
################################
