8
....G..#
####.#.#
.....#.#
.#####.#
.#.#...#
.#.#.###
S#.....#
########
