8
....G#.#
.###.#.#
.#...#.#
.#.###.#
S#...#.#
####.#.#
.......#
########
