16
.#.............#
.#.#####.#######
.#.#...#.......#
.#.###.#######.#
.....#.#.....#.#
####.#.#.###.#.#
S..#...#.#...#.#
##.###.#.###.#.#
...#...#...#...#
.###.#####.###.#
...#.#...#...#.#
##.###.#.###.#.#
.#.#...#..G..#.#
.#.#.#########.#
.....#.........#
################
