32
.................#.........#...#
.###.###########.#.#######.#.#.#
...#.#.......#.....#.#...#...#.#
##.###.#####.#######.#.#.#####.#
...#...#...#...#.......#....G#.#
.###.#####.###.#######.###.#.#.#
...#.#.....#.#...#...#.#.#.#.#.#
##.#.###.#.#.###.#.#.#.#.#.###.#
...#.#...#.....#...#.#...#.#...#
.###.#.#######.#####.#####.#.###
...#.#.#.....#...#...#...#.#.#.#
.#.#.#.#.#######.#.###.#.#.#.#.#
.#.....#.........#...#.#...#.#.#
.#######.#######.###.#.###.#.#.#
.#...#.#.#.....#...#.#.#...#...#
##.#.#.#.#.###.#####.#.#.#####.#
...#.#...#...#.......#.#.....#.#
.###.#######.#########.#######.#
...#.#.....#.#.......#.........#
##.#.#.###.#.#.#####.#.#########
.#.#...#.....#.#.....#.#.....#.#
.#.###.#########.#.###.#.#.#.#.#
.#.#...#S....#...#.#...#.#.#.#.#
.#.#########.#.#####.#####.#.#.#
.#.......#...#.#...#.....#.#...#
.#####.###.###.#.#.#####.#.#####
.....#.#...#...#.#...#...#.....#
.###.#.#.###.###.#.#.#.#######.#
...#.#...#...#...#.#.#.#.......#
.#.#######.###.###.###.###.###.#
.#...............#.........#...#
################################
