32
.......#...........#...........#
####.#.#.#####.###.#####.###.###
.....#.#.#.#...#.......#.#.#...#
.#####.#.#.#.#########.#.#.###.#
.....#.#.#.#.#.......#.#...#...#
.###.###.#.#.#.#####.#.###.#.###
...#.......#.#.#.....#...#.#...#
.###########.#.#.#.#####.#####.#
.#.....#G....#.#.#.#...#.......#
.#.###.#.###.#.#.#.#.#.#######.#
.#...#...#...#.#.#.#.#.#.......#
.###.#.#######.#.###.#.#####.###
...#.#.#.....#.#.....#.#...#.#.#
##.#.###.###.#.#######.#.#.#.#.#
...#...#...#...#...#.#...#.#...#
.#####.###.#####.#.#.#####.###.#
.....#.....#.....#...#...#...#.#
####.#######.#######.#.#.###.#.#
.#...........#.....#.#.#.....#.#
.#.###########.###.###.#######.#
.#.#.#.........#.#.....#.....#.#
.#.#.#.#########.#######.###.#.#
.....#...#.....#...........#...#
.#######.#.#.###.#############.#
.#.......#.#...#.#.#.........#.#
##.###.#######.#.#.#.#######.#.#
...#.#.#.....#.....#.#...#S..#.#
.###.#.#.###.#######.#.#.#####.#
.#.....#.#.#.#.....#...#.#.....#
.#######.#.#.#.###.#####.#.#####
...........#.....#.......#.....#
################################
