64
.....#...#.....#.........#...#...#...........#......S#.........#
.###.#.###.###.#.#####.#.###.#.#.#.###.#####.#.###############.#
...#...#...#...#.....#.#.....#.#...#.#...#...#.#...........#...#
##.#####.###.#####.###.#####.#.#####.###.#####.#.#########.#.###
...#...#...#.....#.#...#.#...#.#.......#...#...#.....#...#.#...#
.###.#.###.###.###.#.###.#.###.#.#####.###.#.#######.#.#.#.#.#.#
.#...#.....#.#.....#.#.....#.#...#...#.#...#.#.....#...#.#.#.#.#
.#.#########.#######.#####.#.#####.###.#.###.#.###.#####.#.###.#
.#...#.....#.....#...#...#...#...#.....#.....#.#.#.....#.#...#.#
.###.###.#.###.#.#.###.#.#####.#.#.###########.#.#####.#.###.#.#
...#.....#...#.#.#.....#.......#.#.#.....#.....#.....#...#.#.#.#
.#.#########.###.###############.#.#.#.###.###.#.###.#####.#.#.#
.#.....#...#.#.............#...#...#.#.....#...#.#...#.....#.#.#
.###.#.###.#.#.###########.###.#########.###.###.#.#.#.#####.#.#
...#.#...#.#...#...#...#...#...........#...#...#.#.#...#.....#.#
####.###.#.#######.#.#.#.###.#########.###.###.#.#.#####.#####.#
.....#.....#.....#...#.#.....#.#.......#.....#.#.#.............#
.#########.###.#.#####.#######.#.#######.#####.###############.#
.......#.#.#...#.........#.....#.....#...#...#...............#.#
.#####.#.#.#.###########.#.###.#####.#####.#.#######.#######.#.#
...#.#.#...#.#...#.....#.#...#...#.#...#...#.......#.......#.#.#
##.#.#.#.###.#.#.#####.#.#####.#.#.###.#.#########.#######.#.###
.#.#.#.#...#...#.....#.....#...#.#...#...#...#...#.......#.#...#
.#.#.#.###.###.#####.#####.#.###.#.#.#####.#.#.#.#######.###.#.#
.....#.#.#...#.#...#...#...#.#.....#.......#.#.#.......#...#.#.#
.#####.#.###.#.###.###.#.###.###############.#.#######.###.###.#
.#...#.#.....#.....#.#.#.....#...#.......#...#.....#.....#.....#
##.#.#.#.#########.#.#.#####.#.#.###.#####.#######.#.#########.#
...#.#.#.....#.....#.#.....#.#.#...#.........#...#.#.........#.#
.###.#.#####.###.###.#####.#.#.###.#########.#.#.#########.###.#
.#...#.#...#...#...#.....#.#.#.#.#.#.....#.....#.#.......#...#.#
.#.###.###.###.###.#.#.#.#.###.#.#.#.###.#######.#.#####.###.#.#
.#...#...#.#...#.#.#.#.#.#.......#.#.#.#...#.#...#.#.#.......#.#
.###.###.#.#.###.#.###.#######.###.#.#.###.#.#.###.#.#.#######.#
.#.......#...#.........#.....#.#...#...#...#.....#.#...#.....#.#
.###.#######.###.#####.#.###.###.#####.#.#######.#.#####.###.#.#
...#.#.....#...#.#...#.#.#...#...#...#.#.......#...#.....#...#.#
.#.###.###.###.###.#.###.#.###.###.#.#.#######.#####.#####.###.#
.#.....#.#...#.....#.....#.#.......#.#...#...#.........#...#...#
.#######.###.#############.###.#####.###.#.#.###########.###.###
.......#...#...#.....#...#...#.#...#...#.#.#...#...#...#...#.#.#
######.#.#.###.#.###.#.#.###.#.###.#.###.#.###.#.#.#.#.###.#.#.#
.....#.#.#...#.....#.#.#.#...#...#.#.#...#.#.....#.#.#...#.#.#.#
.#####.#.#.#########.#.#.#.#####.#.#.#.###.###.#####.###.#.#.#.#
...#...#.#.#.......#.#.#.#.#.......#.#...#...#.#.....#.....#...#
.#.#.###.###.#####.#.#.#.#.#####.###.###.###.###.#.#######.###.#
.#...#G#...#...#...#.#.#.#.....#.#.....#...#...#.#.#...#.#.#.#.#
.#####.#.#.###.#.###.#.#.#####.###.###.###.#.#.#.###.#.#.#.#.#.#
...#.....#...#.#.....#.#.....#.....#.#.#.#.#.#.#.....#.#.....#.#
##.#####.#.#.#.#######.#############.#.#.#.###.#######.#.#####.#
.#.....#.#.#.#.....#.#.............#...#.#.....#.....#.#...#...#
.#####.#.#.#.#####.#.#.#########.#.#.###.#####.#.#.###.#####.###
.......#.#.#...#.#.#...#.#.....#.#...#.....#...#.#.#...#.....#.#
.#######.#.###.#.#.#.###.#.###.###.#####.#.#.###.#.#.#.#.#####.#
.#...#...#...#...#.#.#...#...#...#.......#.#.#...#.#.#.#.#.....#
.#.#.#.#####.###.#.#.#.#.###.###.#########.#.#.###.#.#.#.###.#.#
.#.#.#.#...#.#...#.#...#...#.#.#.#.......#.#...#.#.#.#.#...#.#.#
.#.#.###.#.#.#####.#.#####.#.#.#.#.#####.#.#####.#.#.#####.#.#.#
.#.#.#...#.#.....#.#.#...#.#.#.#...#.#...#.#.....#.#.....#.#.#.#
.#.#.#.###.#####.#.#.#.#.###.#.#####.#.###.#.###.#.#####.#.#.#.#
.#.#.#...#.....#.#.#.#.#.....#.......#...#...#...#.#...#.#...#.#
.#.#.###.#####.#.#.###.###########.#.###.#########.###.#.#####.#
...#.....#.......#.................#...#...............#.......#
################################################################
