32
.......#.........#S....#.......#
####.#.#.#######.#####.#.#####.#
.....#...#...#.....#...#.#.....#
.#########.#.#.#####.###.###.###
.....#...#.#...#.....#.#...#...#
.###.#.#.#######.#####.#.#.###.#
...#...#.........#.#.....#...#.#
##.###############.#.#######.###
...#...#.......#.#...#.#...#...#
.###.#.#.#.###.#.#.###.#.#.#.#.#
.#...#...#...#...#.#...#.#.#.#.#
.###.#######.#.###.###.#.#.###.#
...#.....#...#.#...#...#.#.....#
##.###.###.#####.###.#.#.#####.#
.#...#.#...#...#...#.#.#.#...#.#
.###.#.#.#.#.#.###.#.###.#.###.#
.#...#.#.#.#.#.......#...#...#.#
.#.###.#.###.#########.###.#.#.#
.#.#.#.#.....#...#.....#...#...#
.#.#.#.#######.#.#.#####.#######
...#.#.#.......#.#.#...#.#.....#
.###.#.#.#######.#.#.###.#.###.#
.#.....#...#.......#...#.#...#.#
.###.#####.#########.#.#.#.#.#.#
...#.#...#.#...#...#.#...#.#.#G#
##.###.#.#.#.#.###.#.#####.#.#.#
...#...#.#...#...#...#...#.#.#.#
.###.###.#.#####.#.#####.#.#.###
...#.#.#.#.....#.#.....#...#...#
##.#.#.#.#######.#####.#######.#
.....#...........#.............#
################################
