8
...#..G#
.#.###.#
.#.....#
.#####.#
.#...#.#
.#.#.#.#
S#.#...#
########
