64
.........#...............#.......#.#...........#...#.......#...#
######.#.#.#.###.#######.#.#####.#.#.###.#####.#.#.###.###.#.#.#
.......#.#.#.#...#.....#...#...#...#.#.#.....#...#.....#.#...#.#
.#######.###.#####.###.#.###.#.###.#.#.#####.###########.#####.#
.#.....#...#.......#.#.#.#...#...#.#.....#...#.#.....#...#.....#
.#.#.#.###.###.#####.#.###.#####.###.#####.###.#.#.###.#.#.#####
.#.#.#...#...#.......#.......#...#...#.....#.#...#....G#.#.#...#
.###.#######.#######.#########.###.###.#####.#.#########.#.###.#
...#.#.....#.......#.#...#...#.....#...#.#...#...#...#...#.....#
.#.#.#.###.#######.#.#.#.#.#.#######.###.#.#.#.###.#.#.#######.#
.#.#.#.#.#.......#.#...#.#.#.#.....#...#...#...#...#...#.......#
.#.#.#.#.###.#.###.#####.#.#.#.###.###.#.#######.#######.#######
.#.#.#.....#.#.#...#...#.#.#...#.....#.#...#...#.....#...#.....#
##.#.#####.#.#.#.###.#.#.#.#########.#.###.#.#######.#.###.#.###
...#.#.....#.#.#...#.#...#.#.......#...#.#.#.......#...#...#...#
.###.#.#####.#####.#######.#.#####.#####.#.#####.#.#####.#####.#
.#.........#.....#.......#.......#...#.....#...#.#...#...#...#.#
.#########.#####.#######.#####.#####.#.#####.#.#.###.#.###.#.#.#
.......#.......#...#...#...#...#.....#...#...#.#...#.#...#.#...#
######.#.#####.#.#.###.###.#.###.#######.#.###.#####.###.#.###.#
.......#.#...#.#.#.....#.#.#...#.#.....#...#.#...#...#...#.#.#.#
.#########.#.#.#.#####.#.#.#####.#.#########.###.#.###.###.#.#.#
...#.......#.#.#...#...#.#.#.....#.............#.#.......#.#.#.#
.#.#.#######.#.###.#.###.#.#.#####.###.#######.#.###.#####.#.#.#
.#.#.#.......#.#...#...#.#...#...#.#...#.....#.#...#.#.....#.#.#
.#.#.#####.#####.#####.#.#####.#.#.#.#.#.###.#####.#.#.#####.#.#
.#.#.....#.....#...#...#.....#.#.#.#.#.#...#.....#.#.#.....#...#
.#.#####.#####.#.#.#.###.#####.#.#.#.#####.###.###.#.#####.#.###
.#.#.....#...#.#.#.#.#...#...#.#.#.#.....#...#.....#...#...#...#
##.#.#####.#.#.###.#.#.#.#.#.#.#.#.#####.###.###########.#####.#
...#...#...#.......#...#.#.#.#.#.......#...#.#...........#...#.#
.###.#.###################.#.#.###########.#.#####.#######.#.###
.#...#...........#.....#...#.#.#...#.....#.#.#.....#.......#...#
.#.#############.#.###.#.###.#.#.###.###.#.#.#.###.#.#########.#
.#.#.........#...#...#.#.#.#...#.#...#.....#...#...#.#.....#...#
.#.#.#######.#.###.###.#.#.#####.#.#########.#######.#.###.#.###
.#.#.#.#.....#.....#...#...#...#.#.......#...#.....#.#.#.#.#.#.#
.#.#.#.#.#####.#####.#####.#.#.#.#######.#.###.###.#.#.#.#.#.#.#
.#.#...#...#...#...#.......#.#.#...#...#...#.#...#...#...#...#.#
.#####.###.#.###.#.#########.#.#.#.#.#.#.###.###.#######.#####.#
.#.......#.#.#...#.#.........#.#.#.#.#.#.....#...#...#...#...#.#
.#.#######.#.#.###.#.#.#######.#.#.#.#.###.###.#####.#.###.#.#.#
.#.#...#...#...#.#.#.#.#.......#.#.#.#...#.#...#.....#.#...#.#.#
.#.#.###.#######.#.#.#.###.#####.#.#.###.###.###.###.#.###.#.#.#
.....#...#.....#...#.#...#...#...#.#...#.....#.....#.#.#...#...#
.#####.###.###.#.#######.###.#.#######.#######.###.#.#.#.#####.#
.#.....#.....#.#.#.......#.....#.......#...#...#...#.#.#...#...#
.#.#####.###.###.#.#.###########.#########.#.###.#####.###.#####
.#.#...#...#.....#.#.....#S....#.#.........#.#.#.....#...#.#...#
.#.#.#####.#############.#####.#.#.#.#####.#.#.#####.###.#.#.#.#
.#.#.............#...#...#...#...#.#...#.#.#.......#...#.#...#.#
##.#.###########.#.#.#.###.#.#####.###.#.#.#####.###.#.#.#####.#
...#...#.......#...#...#...#.#...#.#...#.#...#...#...#.#.#...#.#
.#####.#.#####.#########.###.#.#.#.#.###.###.#.###.###.#.#.#.#.#
...#...#...#.#.........#...#...#...#.#.......#.#.#...#.#...#.#.#
.#.#######.#.#########.###.#########.#.#######.#.###.#######.#.#
.#...#...#.......#...#...#.#.......#.#.....#...#...#.....#.#.#.#
.###.#.#.#######.###.###.#.#.###.###.#####.#.###.#####.#.#.#.#.#
.#...#.#.........#.....#.#.#.#...#...#.....#...#.#.....#...#.#.#
.#.###.###########.###.#.#.#.###.#.#######.###.#.#.#######.#.#.#
.#.....#.......#.....#.#...#...#.#.......#.#...#.#.#...#...#.#.#
.#########.###.#####.#.#######.#.#######.###.###.#.#.#.#####.#.#
...........#.........#.........#.......#.........#...#.........#
################################################################
