16
...#...#.......#
.#.#.#.#.#.#####
.#.#.#.#.#.#...#
.###.#.#.#.#.#.#
.#S..#.#.#...#.#
.#####.###.###.#
.....#...#.#...#
####.###.###.###
...#...#...#...#
.#.###.###.###.#
.#.......#...#.#
.###.#######.#.#
...#.#.....#...#
.#.###.#.#####.#
.#.....#..G....#
################
