16
...........#...#
####.#####.#.###
S....#.#...#...#
######.#.###.#.#
.#...#...#.#.#.#
.#.#.#.###.#.#.#
...#.#.#...#.#.#
.###.#.#.###.#.#
.#.#...#.....#.#
.#.#######.###.#
...#.....#.#...#
##.#.###.###.###
.#.#.#.#...#...#
.#.#.#.###.###.#
.....#....G....#
################
