64
.....................#.........#...#.................#.....#...#
.#################.###.###.#####.#.#.#######.#.#####.###.###.#.#
...#.....#.........#...#.#.#...#.#.#...#.....#.#...#..G#.#...#.#
##.#####.#.#.#######.###.#.#.#.#.#.###.#.#######.#.###.#.#.###.#
...#...#.#.#.#.....#.#...#...#.#.#...#.#...#.....#...#.#...#...#
.###.#.#.#.#.#.###.#.#.#######.#.###.#.###.#.#######.#.#####.#.#
.#...#...#.#.#.#...#.#.....#.#...#.#.#.#.#.......#...#.#.....#.#
.#.#####.#.###.#.###.###.#.#.#####.#.#.#.#########.###.#.#####.#
...#.....#...#.#.....#...#.........#...#.#.........#.#.#.#.....#
##.#########.#.#######.###.#############.#.###.#####.#.#.#.#####
...#.....#...#.......#...#.#.............#...#.#...#.....#.....#
####.###.#.#.#######.#.#.###.#########.#.###.#.#.#.###########.#
...#.#...#.#.#.......#.#.....#.#.......#.#.#.#.#.#.........#...#
.#.#.#.###.###.#############.#.#.#######.#.#.###.#########.#.###
.#...#.....#...#.......#...#...#.#.......#.#...#.#.#.......#...#
.#########.#.#####.###.#.#.#.###.#####.###.###.#.#.#.#########.#
.........#.#.....#.#.....#.#.#...#...#.......#.....#.#...#.....#
.#######.#.#####.#.#######.#.#.###.#.#######.#######.#.#.#######
.....#...#.#.#...#...#...#.#.#.....#...#.#.....#.....#.#.......#
####.#.###.#.#.###.#.###.#.#######.###.#.#.#####.#####.#######.#
.#...#...#...#.#.#.#...#.#.#.....#.#...#...#...#.#...#.....#...#
.#.#####.#.###.#.#.###.#.#.#.###.###.###.###.#.#.#.#.#####.#.###
.#...#.#.#.#...#...#.#.#.#.#.#.......#...#...#...#.#.....#.#...#
.###.#.#.###.#####.#.#.#.#.#.###########.#.#####.#.#####.#.###.#
...#.#.#.....#...#...#.#.....#.........#.#.#.....#.#.#...#...#.#
.###.#.#######.#.#####.#.#####.#######.#.#.#.#####.#.#.#####.#.#
.#...#.........#.......#...#...#...#...#.#.#.....#.#.#.......#.#
.#.###.###########.#####.###.###.###.#####.#####.#.#.#########.#
...#.....#.....#...#...#.#...#...#.........#.....#.........#...#
.#######.#.###.#####.#.###.###.###.#######.#######.#####.###.#.#
.......#.#.#.#.#.....#...#...#.....#.....#.#.......#...#.#...#.#
######.#.#.#.#.#.#######.###.#######.###.###.#######.#.###.###.#
.#.....#.#.#.#.#.....#.....#.#.....#.#.#.....#.......#.....#.#.#
.#.#####.#.#.#.###.###.###.#.#.###.#.#.#######.#############.#.#
.#.....#.#.#.#.....#...#.#.#.....#.#.....#.#...#.........#.....#
.#####.#.#.#.#######.###.#.#######.#####.#.#.#.#####.###.#.#####
.....#.#.....#...#...#.......#...#.....#.#.#.#.#...#...#.#.....#
##.#.#.#####.###.#.###.#######.#.#.#####.#.#.###.#.###.#.#####.#
...#.#.....#...#.#.#.....#.#...#.#.......#.#.....#...#.#.......#
.#########.###.#.#.#####.#.#.###.###.#####.#########.#.#########
.........#.#.....#...#.#...#.#.#...#...............#.#.........#
.#######.#.#####.###.#.###.#.#.###.#############.###.###########
.....#...#.....#...#.#.....#.#...#.#...#.........#...#.........#
####.#.#######.#.###.#.#####.###.#.#.#.###########.###.#######.#
.#...#...#.....#.#...#.....#...#...#.#...#.....#...#.....#.....#
.#.#####.#.#######.###.#######.#.###.###.#.###.#.#.#.#####.###.#
...#...#.#.#.......#.#.#.......#.#.....#...#.#.#.#.#.#.#...#...#
.###.#.#.#.#####.###.#.#.#######.#####.#####.#.#.###.#.#.#####.#
.#.#.#...#.......#.#...#.#...#.#.......#.....#.#.......#.....#.#
.#.#.#############.#.###.#.#.#.#########.###.#.#.#######.###.###
.#.#.........#.........#.#.#.#...........#...#.#...#...#.#.#...#
.#.#########.#.#########.#.#.###########.#####.###.#.#.#.#.###.#
...#.......#...#...#.....#.#.....#.......#.....#...#.#.#...#...#
##.###.#.#########.#.#####.#####.#.#####.#.#########.#.#####.#.#
.#...#.#.......#...#.....#...#.#...#...#.#...#.......#.......#.#
.###.#####.###.#.#.#####.###.#.#.###.#.#####.###.#############.#
...#.......#.....#...#...#...#...#...#.....#...#.#.....#...#...#
.#.###.#####.#######.#.###.###.###.#####.#.###.#.#.###.###.#.###
.#...#.#S..#.#.....#.#.#...#...#...#.....#.#...#.....#...#.#...#
.#####.###.###.###.#.#.#.###.###.###.#####.#.###########.#.###.#
.....#...#.#...#.#.#.#.#...#.#...#...#.....#...#...#.....#.....#
.###.###.#.#.###.#.###.#.#.###.###.###########.#.#.#.#####.#####
...#.....#...#.........#.#.......#...............#...#.........#
################################################################
