32
.......#.........#...#.......#.#
.###.#.###.#####.#.#.#.#.###.#.#
...#.#.....#.......#.#.#.#.#...#
##.#.#######.#########.#.#.###.#
...#...#.#.....#.......#.#...#.#
.#####.#.#.#####.#######.#.###.#
...#...#.#.#.#...#.....#.#.....#
####.###.#.#.#.###.#.#.#.###.###
.....#.......#...#.#.#.#...#...#
.###.#######.###.###.#.###.#####
.#...#.....#...#.....#.#.#.#...#
.#####.###.###.#######.#.#.#.#.#
.#...#...#.#...#.....#...#...#.#
.#.#.###.#.###.#.#######.#####.#
...#.....#...#.#.#.....#...#.#S#
.###########.#.#.#.###.###.#.###
...#.......#.#...#...#.#...#...#
##.#####.#.#.#.###.###.#.###.#.#
.#...#...#.#.#.#...#...#...#.#.#
.###.#.#####.#.#.###.#####.#.###
...#G..#.....#.#...#...#...#...#
.#####.#.#####.###.###.#.#####.#
.......#.#...#...#...#...#.....#
########.#.#.###.###.#######.#.#
.......#...#.#.....#.#.#.....#.#
.#####.#####.#######.#.#.#.#####
.#.......#...#.....#.#...#.....#
.#######.#.#.#.###.#.#####.###.#
.#...#.....#.#.#.#.#.#...#...#.#
.#.#.#########.#.#.#.#.#.#####.#
...#.............#.....#.......#
################################
