32
.....#...#...........#.....#...#
.#.#.#.#.#.#########.###.#.#.#.#
.#.#.#.#.#.#...#...#.#...#...#.#
.#.#.###.#.#.#.###.#.#.#######.#
.#.#.....#.#.#...#.....#...#...#
##.#####.#.#.###.#######.#.#.###
...#.....#.#.#.#.#.....#.#...#.#
.#########.#.#.#.#.###.#.#####.#
.#.....#...#.#.#...#...#...#...#
.#.###.#.###.#.#####.#####.#.#.#
.#...#...#...#...#...#...#.#.#.#
.###.#.###.###.#.#.###.#.#.#.###
...#.#.#...#...#.#..S#.#...#...#
.###.###.#####.#.#####.#######.#
...#.....#.....#.....#.#.......#
##.#######.###########.#.###.###
...........#...#.......#.#.#...#
.###.#######.#.#.#######.#.###.#
...#.#.......#...#.....#...#.#.#
##.###.###########.#######.#.#.#
...#...#...#.................#.#
.#.#.###.#.#.#################.#
.#.#...#.#.#.....#...#...#...#.#
.#####.#.#######.#.#.#.#.#.#.#.#
.....#.#.........#.#...#...#.#.#
.#.###.#.#########.#########.#.#
.#...#.#.........#.....#...#...#
.###.#.#.#####.#######.#.#####.#
.#.#G#.#.#...#.#...#...#.......#
.#.#.#.###.#.###.#.#.###.#######
...#.......#.....#...#.........#
################################
