8
.......#
##.###.#
...#.#G#
.###.#.#
S#...#.#
##.###.#
.......#
########
