8
...#..S#
##.#.###
...#.#.#
.###.#.#
...#.#.#
.#.#.#.#
.#..G..#
########
