8
.....#S#
.#.#.#.#
.#.#.#.#
.#.###.#
.#.....#
.#######
..G....#
########
