32
G......#.......#.....#.......#.#
.#.###.###.#.###.###.#.#.###.#.#
.#.#.....#.#.#...#...#.#.#.....#
.#.#####.#.#.#.###.#.#.#.#.#####
.#.....#...#.#...#.#.#.#.#.#...#
######.#.#######.#.###.#.###.#.#
.....#.#.#.......#.....#.....#.#
.###.#.#.#.###################.#
...#.#.#.#.#.....#.............#
.#.#.#.###.#.###.#.#############
.#.#...#...#.#...#...#.........#
.#.#####.###.#.#.###.###.#####.#
.#.......#...#.#...#...#.#.#...#
.#########.###.###.###.#.#.#.###
.#...#...#.#.#...#.#...#.#.....#
.#.#.#.#.#.#.###.#.#.###.#####.#
.#.#...#.#.....#.#.#.#.......#.#
.#.#####.###.###.#.#.#.#####.#.#
.#...#.#.#...#...#.#.#.#.....#.#
.#.#.#.#.#.###.###.#.###.#####.#
.#.#.#...#...#...#.#.#S#...#...#
.###.#.#####.###.#.#.#.###.#####
.....#.#...#.#...#.#.#...#.....#
######.#.###.#.#####.###.#.###.#
.......#.....#.#.......#.#...#.#
.#######.#####.#.#######.###.#.#
.#.....#.#.....#.........#...#.#
.#.###.#.#.###.###############.#
.#...#...#.#.#.#.......#.......#
.#########.#.#.#.#####.###.###.#
...........#.....#.........#...#
################################
