32
.......#.............#.....#...#
.#######.###.#.#####.#.###.#.###
...#.....#...#.#...#...#...#...#
##.#.#####.#####.#.#######.###.#
...#...#.#.......#.......#.#...#
.#.###.#.###############.#.#.#.#
.#...#...#...........#...#...#.#
.#######.#######.#####.#######.#
.......#.....#...#.....#...#.#.#
####.#.#####.#.###.#####.#.#.#.#
..S#.#.........#...#.....#.#...#
.#############.#.###.#####.###.#
.....#.......#.#...#.....#...#.#
####.#.#####.#####.#####.###.###
...#...#...#.....#.......#.#...#
.#######.#######.#####.###.###.#
.#.....#.....#...#...#.......#.#
.#.###.#.###.#.###.#.#####.###.#
...#.#...#.#...#...#.#...#.#...#
.###.#####.#######.#.#.#.###.#.#
.#.........#...#...#.#.#.....#.#
.###.#####.#.#.#.###.#.#######.#
.....#...#.#.#...#.#...#...#...#
######.#.#.#.#####.#####.###.###
.......#...#...#...#.....#...#.#
.#############.#.#.#.#.###.###.#
.#...#.........#.#.#.#...#.#...#
.#.#.#######.###.###.###.#.###.#
.#.#.......#.#.......#...#G#...#
.#.#######.#.#.#######.###.#.#.#
...#.........#.......#.......#.#
################################
