8
.....#.#
.#.#.#.#
.#.#..G#
##.###.#
S#...#.#
.###.#.#
.....#.#
########
