32
...#.............#.............#
.###.###########.#.#######.###.#
.#...#.......#...#...#...#.#...#
.#.###.#####.#.#####.#.#.#.#.###
.#.#...#...#.#.....#.#.#.#.#...#
.#.#.###.###.###.###.#.#.#####.#
.#...#...#...#.#.....#.#.....#.#
.#####.###.###.#######.#####.#.#
.....................#...#...#.#
########################.#.###.#
S....#...#.....#.........#.#...#
####.#.#.#.###.#.#########.#.#.#
...#.#.#.#...#...#.....#...#.#.#
.#.#.#.#.###.#####.#####.#####.#
.#.#...#.#...#.........#.#...#.#
.#.#####.#.###.#####.#.#.#.#.#.#
.#.....#.#.#...#...#.#.#...#.#.#
.#.#####.#.###.#.#.###.#####.#.#
.#.......#...#.#.#.....#.....#.#
.###########.###.#######.#####.#
.......#.....#...#.....#...#...#
######.###.###.###.###.###.###.#
.....#...#.#...#...#.#...#.....#
.#######.#.#.###.###.###.#####.#
.#.....#...#...#.#.....#.......#
.#.###.#######.#.#.###.#########
.#.#.#.........#.#...#.....#...#
.#.#.#####.#####.#.#.#####.###.#
.#...#.....#.....#.#.#...#.#...#
.###.#.#####.#######.#.###.#.#.#
.....#...............#....G..#.#
################################
