16
...#...#...#...#
.#.###.#.#.#.#.#
.#.....#.#...#.#
.#.#####.#####.#
.#.#S..#...#.#.#
.#####.###.#.#.#
.....#.#...#...#
####.#.#.###.###
.....#...#.#...#
.#########.###.#
.............#.#
.###########.#.#
...#.....#...#.#
##.#.###.#.###.#
.....#...#....G#
################
