8
.#S#...#
.#.#.#.#
.#...#.#
.#####.#
...#...#
.#.#.###
.#..G..#
########
