8
.#.....#
.#.###.#
..G#.#.#
.###.#.#
.#...#.#
.###.#.#
.....#S#
########
