32
.......#...#.....#.....#.......#
.#####.#.#.#####.#.#.#.#.#######
.#...#...#...#...#.#.#...#.....#
.###.#######.#.###.#.#.###.###.#
.#...#.......#.....#.#.#...#.#.#
.#.###.#######.#####.###.###.#.#
...#...#.......#...#.........#.#
##.#.###.#########.#########.#.#
.#.#...#...........#.......#.#.#
.#.###.###.#########.#####.###.#
.#.#.#...#.#.........#...#..S#.#
.#.#.###.###.#########.#######.#
.#...#.#...#...#...#...#...#...#
.###.#.###.###.#.###.#.#.#.#.#.#
...#.#...#.....#.#...#...#...#.#
.###.#.#########.#.###########.#
.#...#.........#...#.......#...#
.#.###.#######.#.###.#####.#.###
...#.#...#.....#...#...#...#...#
.###.###.#.#######.###.###.###.#
.#.#...#.#...........#...#...#.#
.#.#.#.#.###############.###.#.#
.#...#.......#...........#.#...#
.#############.###########.###.#
..........G....#.........#...#.#
################.#####.#.#.#.#.#
.......#.......#...#.#.#...#.#.#
.#.#####.#####.###.#.#.#######.#
.#.#...#.#.#...#...#.#.#.......#
.###.#.#.#.#.###.###.#.#.#######
.....#.....#.........#.........#
################################
