64
.#.............#.....#...#.........#.......#...#.......#.......#
.#.#####.#####.#.###.#.#.###.#####.#####.#.#.#.#.#####.#.#####.#
.#.#...#.....#...#...#.#.....#...#.......#.#.#...#...#.#...#...#
.#.#.#######.#####.###.#########.#########.#.#####.#.#.#.###.#.#
...#.....#...#...#...#...#.............#.#.#.#...#.#.#...#...#.#
.#####.#.#.###.#.###.###.#.###.#######.#.#.#.#.#.#.#.#.###.###.#
.......#.#...#.#.#.......#.#...#.....#.#.#.#.#.#...#.#...#.#.#.#
####.#######.#.#.#.#######.#.###.###.#.#.#.###.#####.###.#.#.#.#
.....#.......#.#.#...#...#.#.#.#...#.#...#...#.....#.#...#.#...#
.#####.#####.#.#.#####.#.###.#.#.#.#####.###.#.###.#.#####.#.###
.#...#...#.#.#.#...#...#...#.#...#.......#...#.#.#.#...#...#.#.#
.###.###.#.#.#.###.#.#####.#.#######.#####.###.#.#.###.#.###.#.#
...#.#...#...#...#...#.....#.......#.#.....#.....#.#.#.#...#...#
##.#.#.#.#######.#####.#####.#####.###.###########.#.#.###.###.#
...#.#.#.#.....#.#...#.....#.#...#.................#.#.....#...#
.###.#.###.#.###.#.#.#####.#.#.#.###.###############.#######.###
.....#.....#.#...#.#.....#.#.#.#...#.#...#.............#...#.#.#
####.#######.#.###.###.###.#.#.###.###.#.#.###.#######.###.#.#.#
.....#.......#.#.....#.#...#.#...#.....#.#...#.#...#.......#...#
.#####.#####.#.###.#.###.#######.#######.###.###.#.#######.###.#
.#...#.....#.#...#.#.#...#.........#...#...#...#.#...#...#.#...#
.#.#.#####.#.###.###.#.###.#########.#.###.#.#.#.###.#.#.#.#.###
...#.....#.#.#.#...#.#...#.#.....#...#.....#.#...#...#.#.#.#...#
########.#.#.#.###.#.###.#.#.###.#.#########.#####.###.#.#####.#
.......#.#.#...#.......#.#.#...#...#...#.....#...#...#.#.......#
.#######.#.#####.#######.#.###.#####.#.#######.#.#.#.#.#########
.#.......#.......#...#...#...#.....#.#.#..S#...#.#.#.#.#.......#
.#.###############.#.#.#.###.#####.#.#.#.###.###.###.#.#######.#
...#.........#.....#...#.#...#...#.#.#.#.#.....#.#...#...#.....#
.###.#######.#.#########.#.###.#.#.#.#.#.#####.#.#.#.###.#.###.#
.#...#.#...#.#.#...#.....#.#...#.#...#...#.....#...#.#...#.#...#
.#.###.#.#.#.#.###.#.#####.#.###.#########.###########.###.#.###
...#.....#...#.#...#.#.#...#.#.#.........#.#.........#.....#.#.#
####.#########.#.###.#.#.###.#.#########.#.#.#######.#######.#.#
...#...#...#.#.#.......#...#.#...#.....#.#.....#.......#.#...#.#
.#.###.#.#.#.#.###########.#.###.#.###.#.#######.#####.#.#.###.#
.#...#...#...#.#...#.....#.#...#...#...#.....#...#.......#...#.#
.#.#########.#.#.#.#.#.###.###.#####.#.#####.#.#########.###.#.#
.#...........#...#...#...#.....#.....#...#...#.....#...#.#...#.#
.#######################.#######.#########.###.###.#.#.###.###.#
.....#...#...#.........#.......#.......#...#.#...#...#...#...#.#
####.#.###.#.#.#######.#.#######.#####.#.###.#.#####.###.###.#.#
.#...#.....#.#.#.....#.#.......#.#...#.#.#.....#...#...#...#.#.#
.#.#########.#.#.#####.#.#####.#.#.#.#.#.###.###.#.#######.#.#.#
...#.....#...#.#.......#.....#.#...#.#.#...#...#.#.......#.#.#.#
.#####.#.#.#.#.#.#########.###.#####.#.###.###.#.#######.#.#.#.#
...#...#...#.#.#...#.....#.#...#.....#...#...#.#.#.....#.#...#.#
##.#.###.#####.###.###.#.###.#.#.#######.###.###.#.###.#.###.#.#
.#...#.#.#.....#.#.....#...#.#.#.#.........#.....#.#...#...#...#
.#####.#.#.#####.#########.#.###.#.#####.#########.###.###.###.#
.#.......#.#.........#.....#.#...#.#...#.#.......#...#...#...#.#
.#.#######.#.#########.#####.#.###.#.###.#.#####.#.#.#######.###
.#.#.......#.......#...#...#.....#.#...#.#.#.....#.#.......#...#
.#.#.#######.#####.#.###.#.#.#####.#.#.#.#.#.###.#.#####.#####.#
...#G....#.#.#...#...#...#.....#...#.#...#.#.#...#...#.#.....#.#
.#######.#.#.###.#####.#########.#########.#.#.#####.#.###.###.#
.#.......#.........#.........#...#.........#.#.#...#.#.#...#...#
.#.#######.#######.###########.#.#.#########.###.#.#.#.#.###.###
.#.#.#.....#...#.........#.....#.#.#.......#...#.#...#.#.....#.#
.#.#.#.#####.#.#########.#.#.#####.#######.###.#.#####.#######.#
.#.#.......#.#...#.....#...#.#.....#.....#...#...#...#.......#.#
.#.#########.###.#.###.#######.#####.###.#.#.#####.#.###.###.#.#
.#.............#.....#...............#.....#.......#.....#.....#
################################################################
