64
.....#.................#.....#...................#...#.........#
.#.###.#############.#.###.###.###############.#.#.#.#.#########
.#.#.......#.......#.#...#...............#.#...#...#.#...#.....#
.###.#######.#####.#.###.###.###########.#.#.#######.###.#.###.#
.....#.......#...#.#.#.#...#...#.....#.....#.#.........#...#...#
.#####.#######.#.#.#.#.###.#####.###.#####.#.#########.#####.#.#
.....#...#...#.#.#...#...#.#.....#.#...#...#...#...#.........#.#
.#######.#.###.#.#####.###.#.#####.###.#.#####.#.#.###########.#
.#.......#...#.#.........#...#.....#...#.....#...#.....#.....#.#
.#.###.#####.#.#########.#####.#####.###.#############.#.###.#.#
.#.#...#...#.....#...........#.......#G..#...........#.#.#...#.#
##.#####.#.#######.###.#######.#######.###.#########.#.#.#.###.#
...#.....#...#...#...#.#.......#...#...#...#.....#...#...#.#...#
.###.#######.#.#.###.###.#########.#.###.###.#.#.#.#####.#.###.#
...#.......#...#...#.#...#...#.....#.#.#.#.#.#.#.#.#...#.#...#.#
.#.#.#############.#.#.###.#.#.#####.#.#.#.#.#.#.#.#.#.###.#.#.#
.#...#...#.......#.#.#.....#.#.........#.#...#.#.#...#...#.#.#.#
.#####.#.#.#####.#.#.#.#####.#########.#.#####.#.#######.#.#.###
.#...#.#...#...#.#.#...#...#.#.......#.#.#.....#.#.....#.#.#...#
.#.###.#######.#.#.#####.#.#.#.#####.#.#.#.#####.###.#.#.#.###.#
.#...#.....#...#...#.....#.#...#...#.#.#.#...#.#.....#.#.#.#...#
.###.#####.#.###.###.#####.#####.#.#.###.###.#.###.#####.#.#.#.#
...#...#...#.....#...#...#...#...#.......#...#.....#.....#.#.#.#
##.#.###.#########.###.#.###.#######.#####.###.#####.#######.#.#
.#.#.#...#...........#.#...#...#...#.#...#.#...#...#...#.....#.#
.#.#.#.###.###########.###.#.#.#.#.###.#.#.#.###.#.###.#.#######
...#.#.....#.......#...#.#.#.#...#.....#.#.#.#...#.....#.......#
.###.#########.###.#.###.#.#.###########.#.###.###############.#
.....#...#.....#.#.#...#.#.#.#.......#...#...#...#...........#.#
####.#.#.###.###.#.###.#.#.#.#.#####.#.###.#.###.#.#####.###.#.#
...#...#.#...#.....#...#.#.#...#.....#.#...#.....#.#...#.#...#.#
.#.#####.#.###.#####.###.#.#####.#####.###.#######.###.#.###.#.#
.#.........#...#...#.#.........#.....#...#.#.....#...#.#...#...#
.###############.#.#.#########.#########.#.#.#######.#.###.###.#
.#.#.............#.#.#.....#.......#.....#.#.#...#...#...#...#.#
.#.#.#############.#.#.###.#######.#.#####.#.#.#.#.###.#####.#.#
...#...#.......#.#.#.#.#.#...#...#.#.#.....#...#.#...#.....#.#.#
##.###.#.#####.#.#.#.#.#.###.#.#.#.#.#####.#####.###.###.#.#.#.#
.....#.#.....#.#.....#.#...#.#.#...#.....#.....#...#.....#.#.#.#
######.#.#####.#####.#.#.###.#.#########.#####.#.#.###.#####.###
.....#...#.....#...#.#.#.#...#.......#...#.....#.#.....#...#...#
.###.#####.#####.#.###.#.#.#########.#.###.###########.#.#.###.#
.#.#...#...#...#.#.....#.#.#.......#...#...#.........#.#.#.....#
.#.###.#.###.#.#.#######.#.#.#####.#####.#####.#####.###.#####.#
.#.......#...#.#.#.......#.#.....#...#.......#.#...#.....#.#...#
.#########.###.#.#.#.#####.#####.###.#######.#.#.#.#######.#.###
.#.........#.#.#...#.#.........#.#.#...#.......#.#.......#...#.#
.#.#########.#.###.###.#####.###.#.###.#########.###.#####.###.#
...#.......#.#.....#...#.....#.......#.....#...#...#.#.....#...#
.#####.###.#.#######.#####.###.###########.#.#####.#.#.#####.#.#
.....#.#.#.#...#...#.....#.#...#.#.........#...#...#...#...#.#.#
####.#.#.#.#.#.#.#######.#.#.###.#.#########.#.#.#######.#.###.#
...#.#.#.....#...#.......#.#.....#.....#.....#.#.....#...#...#.#
.###.#.#########.#.#############.#####.#.#####.#####.#.#.###.#.#
...#.#.#...#...#.#.#.....#...#...#...#.#...#...#.#...#.#.#...#.#
##.#.#.#.#.#.###.#.#.###.#.#.#.#####.#.#####.#.#.#.###.#.###.#.#
...#.#.#.#.#.#...#.....#...#.........#.....#.#...#.#.#.#...#...#
.###.#.#.#.#.#.#####################.#####.#.#.###.#.#.###.###.#
.#...#.#.#.#...#...#.........#.....#.....#.#.#.#...#.....#.#...#
.#.###.#.#.#####.#.#.#######.#####.###.###.#.###.#########.#####
...#.....#.#.....#...#.......#...#.....#...#.#...#.......#.....#
.#########.#.#############.###.#.#######.###.#.#####.###.#####.#
...........#............S#.....#.........#...........#.........#
################################################################
