16
...#.#...#.....#
.#.#.#.#.#.###.#
.#G..#.#.....#.#
.#####.#######.#
.....#.....#...#
.###.###.###.#.#
.#.#...#.#...#.#
.#.#.###.#.###.#
...#.#...#...#.#
####.#.#####.#.#
.....#.#.....#.#
.#####.#.#####.#
.#.....#...#.#.#
.#.#######.#.#.#
.....#S....#...#
################
