8
...#..G#
.#.###.#
S#.#...#
##.#.#.#
.#.#.#.#
.#.#.#.#
.....#.#
########
