64
.....#.........#.....#.......#.......................#.....#...#
.#.###.#.#####.#.###.#.#.#.###.#.###################.#.###.#.#.#
.#.....#...#...#.#...#.#.#.#...#.#.....#...........#...#.#...#.#
.#########.#.#####.###.#.###.###.#.#.###.#########.#####.#####.#
...#.......#.....#.....#...#...#.#.#.........#.............#...#
####.###########.###.#####.###.#.#######.#####.###########.#.###
...#.....#.....#...#G..#.....#.#.#.....#.#...#.........#...#.#.#
.#.#####.###.#####.#####.#####.#.#.###.###.#.#.#######.#####.#.#
.#...#...#...#...#.#.....#.....#.#...#.....#.#.#.....#...#...#.#
.###.#.###.###.#.#.#.#####.#####.###.#######.#.#.###.###.#.###.#
...#...#.......#.....#.........#.#...#.....#.#.#...#...#...#...#
##.#####.#########.###.#########.#.#######.#.#.#####.#.#######.#
...#.........#...#.#.....#.......#.......#.#.#.....#.#.......#.#
.###########.#.#.###.#####.#####.#######.#.#.#####.###.#.###.#.#
.#.........#.#.#...#...#...#...#.#.....#...#...#.#...#.#.#.#.#.#
.#.#######.#.#.###.###.#.#.#.#.###.###.#.#####.#.###.###.#.#.#.#
.........#.#.#...#.....#.#.#.#.....#...#.#.....#...#.....#.#...#
.#########.#.###.#######.#.#.#######.#.#.#.#####.#########.###.#
.#.#...#...#...#...#.....#.#...#...#.#.#.#.#...#.......#.......#
.#.#.#.#.#####.###.#.###.#####.#.###.###.#.#.###.###.#.#.#######
.#.#.#.#.....#.#...#.#.#.#.....#...#.....#.#...#...#.#.#.....#.#
.#.#.#.#.###.###.###.#.#.#.#####.#.#######.#.#.###.#.#######.#.#
...#.#.#...#.#.....#.#.#.#...#...#.......#.#.#.....#.......#...#
.###.#.#####.#.#####.#.#.###.###.#######.#.#######.#####.#.###.#
.#...#.....#...#.....#.#.#.#...#...#.....#.......#...#...#.#...#
.#.#######.#####.#####.#.#.###.#####.###########.#####.#####.###
.#.#.......#.....#...........#...#...#.......#.#.....#.#.....#.#
##.#####.###.#####.#############.#.###.###.#.#.#####.#.#.#####.#
...#...#...#.#...#.....#.........#...#.#...#.#.....#.#.....#...#
.###.#.###.#.#.#.###.###.#########.#.#.#.###.#.###.#.#####.#.#.#
.....#.#.#...#.#.....#...#.....#...#...#.#.....#...#...#.#.#.#.#
.#####.#.#####.#######.###.###.#########.#############.#.#.#.#.#
.#.....#.#...........#.....#.#...........#.........#...#...#.#.#
.#.#####.#.#################.#.###########.#######.#.###.###.#.#
.#.....#.#.#...#.......#.....#.#...........#.#...#...#.#.#...#.#
.#####.#.#.###.#.###.###.###.#.#.###########.#.#.#####.#.#.#####
.#...#.#.......#...#.#.....#...#.#...#.....#.#.#.........#.....#
.#.#.#.#######.###.#.#.#####.###.#.#.#.#.#.#.#.###############.#
.#.#.#.#...#...#...#.#.#...#.#.#.#.#...#.#...#.....#...........#
.###.#.#.#.#####.###.#.#.#.#.#.#.###.###.#########.#####.#####.#
.#...#...#...#.....#...#.#.#.#.#...#.#...#.........#.....#.#...#
.#.#########.#.#########.#.#.#.###.###.#.#.#########.#####.#.###
.#.#.......#...#.....#...#.#.....#.#...#.#...#...........#.#...#
.#.#.###.#.#####.###.#.###.#####.#.#.###.###.###########.#.###.#
.#...#...#.....#...#...#.#...#...#.#.#...#...#.....#.....#.....#
.#####.#.#########.#####.###.###.#.#.#####.###.###.#.#####.#####
.....#.#.#.......#.#.......#...#.#.#.#...#.#...#...#.#...#...#.#
####.#.###.#####.#.#.#.###.###.###.#.#.#.#.###.#.###.#.#####.#.#
...#.#...#.....#.#.#.#.#.#...#.#...#.#.#.#...#.#.....#.....#...#
.###.#.#.#####.#.#.#.#.#.###.#.#.###.#.#.###.#.###########.###.#
...#.#.#.....#.#.#.#.#.#...#.#...#.#...#.....#...#...........#.#
##.#.#####.###.#.#.#.#.#.###.#####.#.###########.#####.#######.#
...#.....#.#...#.#.#.#.#...#.#.....#...#.........#...#.........#
.#.#####.#.#.###.#.###.#.#.#.#####.###.#.#########.#.###.#######
.#...#...#.#...#...#...#.#...........#.#...........#...#.......#
.###.#.###.###.#####.#################.#####.#########.#######.#
...#.#.#...#...#.....#...#...........#.....#.#...#...#.....#.#.#
.#.###.#.#.#.###.###.#.#.#.#########.#####.#.#.#.#.#.#.###.#.#.#
.#.#...#.#.#...#...#...#.#.#......S#.......#...#.#.#.#.#...#...#
.#.#.###.#.###.###.#####.#.#.#######.#############.#.###.###.###
.#...#...#.#.#.#...#...#...#.#...#...#...#.......#.#.#...#.#.#.#
.#######.#.#.#.#####.#.#####.#.#.#.###.#.#.#####.#.#.#.###.#.#.#
.........#...#.......#.......#.#.......#...#.......#...#.......#
################################################################
