64
...........#.........#.......#.#.......#.....#S#.....#.......#.#
.#########.#.#######.#.###.#.#.#.#.#####.###.#.#.###.#.#####.#.#
...#...#...#...#.....#.#.#.#.#...#.#.....#...#...#.#...#...#.#.#
.#.#.###.#####.#######.#.#.#.#####.#.#####.#.#####.#####.###.#.#
.#.#.........#.#.......#.#.#.......#.....#.#.#.....#...#...#.#.#
##.#########.#.#.#######.#.#######.#.#####.#.#.#####.#.#.#.#.#.#
...#.......#.#.#.#...#...#.#.......#.#.....#...#.....#...#...#.#
.#.#.#####.#.#.#.#.#.#.#.#.###.#####.#.#######.#.#############.#
.#.#.#...#.#...#.#.#...#.#...#...#...#.....#...#...#.....#.....#
.###.#.###.###.#.#.#####.###.#####.#######.#######.###.#.#####.#
.#.....#...#.#.#.#...#.#.#.#.....#.#.....#.#.....#.....#.....#.#
.#.#####.###.#.#.###.#.#.#.#####.#.#####.#.#.###.###########.#.#
.....#...#.#...#.....#...#...#...#.....#.#.#...#.......#...#...#
.#####.###.#.#########.###.###.#######.#.#.###.#.#####.#.#####.#
.#.....#...#.#.......#...#...#.......#.#.#...#.#...#...#.#.....#
.#.#####.###.#.#.###.###.#.#.#####.###.#.###.#.###.#.###.#.#####
.#.#.......#.#.#.#...#...#.#...#.#...#...#...#...#.#.#...#.....#
.#.#######.#.#.#.###.#.#####.#.#.###.###.#.#####.#.#.###.#####.#
.#.#.....#...#.#...#.#.....#.#.....#.....#.....#.#.#...#...#...#
.#.#.###.###.#.###.#######.#.#####.###########.#.#.###.#.#.#.###
.#.#...#...#.#...#.......#.#...#.......#...#...#.#.#.#...#.#...#
.#.###.###.#####.###.#####.#.#.#######.#.#.#.#.#.#.#.#####.###.#
.#...#.#.#.....#.#.#.......#.#...#...#.#.#...#.#.#.#...#...#...#
.#.###.#.#####.#.#.#############.#.###.#.#######.#.###.#.###.###
.#.#...#.....#...#.....#.........#...#.#.#.......#.#...#...#.#.#
##.#.#####.#######.#####.###.#####.#.#.#.#.#######.#.#####.#.#.#
...#.....#.......#.#.......#.#...#.#.#.#...#.....#.#.......#.#.#
.#######.#.#.###.#.#.#######.#.###.#.#.#####.###.#.#.#######.#.#
...#.....#.#.#.#.#.#...#.....#.#...#...#...#...#.#.#.#.......#.#
.#.#.#####.#.#.#.#.###.#.#####.#.#######.###.#.###.###.#######.#
.#...#.#...#.#.#.#.....#.#.....#.....#...#...#...#...#.#.....#.#
.#####.#.###.#.#.#.#####.###.#.#####.#.###.#####.###.#.#.###.#.#
.....#...#...#.#.#...#.#...#.#.....#.#...#.#.......#.#.#...#...#
####.#####.###.#.###.#.###.#.#####.#.#.#.#.#.#######.#.#.#.###.#
...#.....#.#...#...#...#...#.#.....#.#.#...#...#.....#.#.#...#.#
.#.#####.#.#.#.###.###.#.###.#######.#.#######.#.#####.###.#.###
.#.....#.#.#.#...#...#.#...#...#.....#.#.#.....#.....#...#.#...#
####.#.#.#.#.#######.#####.#.#.#.#####.#.#.###.#####.###.###.#.#
.....#.#...#...#...#...#...#.#...#.....#.#.#...#...#...#...#.#.#
.#####.#####.#.#.#.###.#.###.#####.#####.#.###.###.###.###.###.#
.#...#...#.#.#...#.#...#.#.#.#...#.#...#.#...#...#.#.....#.....#
.#.#.###.#.#.#####.#.###.#.#.#.#.#.#.#.#.###.###.#.#.#########.#
...#.#.....#...#.#.#...#.#.#.#.#.....#...#.#.#...#.#.........#.#
####.#.#######.#.#.###.#.#.#.###########.#.#.#.###.#####.#####.#
.....#...#.......#...#...#...#.....#.....#.#.#...#.....#.....#.#
.#####.###.#######.#.#####.###.###.#####.#.#.###.#.###.#####.#.#
.#.....#...#.......#.#.....#...#.#.....#...#.#...#...#.....#...#
.###.###.###.#######.#.#####.###.#####.#####.#.###.#.#####.#####
...#.#.#.#.#...#.....#.......#.....#...#.....#.#.#.#...#...#...#
.#.#.#.#.#.###.###############.#####.###.#####.#.#.###.#.###.###
.#.#...#.#...#...#G..........#.....#.#...#...#.#.#...#.#...#...#
.#.#####.#.#.###.#.#######.###.###.#.#.###.#.#.#.###.#.###.###.#
.#.#.....#.#...#...#.....#.....#.#...#.....#.#.#.....#.#.#.....#
.#.#.#####.###.#######.#.#######.#####.#####.#.#######.#.#####.#
.#.#.#.#...#.#.........#.#...#...........#...#...#.....#.....#.#
.#.#.#.#.#.#.###########.#.###.###########.#####.#.#####.#.###.#
.#.#.#...#.#...........#.#.....#...#.....#.#.......#.....#.#...#
.#.#.#.###.#.###########.#.#####.#.#.###.#.#########.#####.#.###
.#...#...#.#...........#.#.....#.#...#...#.......#...#...#.#.#.#
.#########.#.#########.#.#####.#.#####.###.#####.#.###.#.###.#.#
...#.......#...#.....#.#.#.....#...#...#...#...#.#.#...#...#...#
##.#.#########.#####.#.#.#########.#.#######.#.#.#.#.#####.###.#
.....#...............#.............#.........#...#.......#.....#
################################################################
