64
.....#...........#.....#...#.....#.............#.........#...#.#
.###.#.###.###.###.#.#.#.###.###.#.#.#########.###.#####.#.#.#.#
G#...#.#.#...#.#...#.#...#.....#...#.#.....#.......#.#...#.#.#.#
.#.#.#.#.###.#.#.###.#####.#######.#.#.###.#########.#.###.#.#.#
.#.#.#.....#.#.#.#.#.#.......#...#.#.#...#...#.......#.#...#...#
.#.#.#####.#.###.#.#.#.#######.#.###.###.###.#.#.#####.#.#.###.#
.#.#.#...#.#.....#.#.#...#.....#...#...#...#.#.#.#.....#.#...#.#
##.#.#.#.#.#######.#.###.#.#######.#.#.###.#.#.###.#####.###.###
...#...#.#.#...#...#...#.#...#.......#.#...#.#.......#.....#...#
.#########.#.#.#.#.#.#.#.###.###.#######.###.#######.#.#####.#.#
.....#.....#.#...#.#.#.#...#...#...#.....#.#.....#.#.#.#...#.#.#
.###.#.#####.#####.#.#####.###.#####.#####.#####.#.#.#.#.#.###.#
...#...#.....#.....#.#.....#.#...#...#.#.....#...#...#.#.#...#.#
##.#####.###.#######.#.#####.###.#.###.#.#.###.#####.###.###.#.#
.#.#.......#.......#.#.#.......#...#.....#...#.....#.....#.....#
.#.###############.#.#.#.#####.#####.#######.#####.#####.#######
.#.................#.#.#.#...#.....#.....#.....#...#.....#.....#
.#################.#.#.#.#.#.#####.#######.###.#.#########.###.#
...#.......#...#...#.#.#.#.#.....#.#.......#.#.#.#.....#...#...#
.###.###.###.#.#.###.#.#.#.###.#.#.#.#######.#.#.#.###.#.###.#.#
.#...#...#...#...#...#...#.#.#.#.#...#.........#.#.#.#.#.#.#.#.#
.#.###.###.#######.#.#####.#.#.#######.#########.#.#.#.#.#.#.#.#
.#...#.....#.......#.#...#.#.#.#...#...#.....#...#...#...#.#.#.#
.###.#######.#######.#.#.#.#.#.#.#.#.###.###.#.#.###.#####.#.#.#
.#...#.....#...#...#.#.#.#.#.#...#.#.#...#...#.#...#.......#.#.#
.#.#####.#.###.#.#.#.#.#.#.#.#####.#.#.###.###.###########.#.#.#
...#.....#...#.#.#...#.#...#.....#...#.#.#...#...#.........#.#.#
.###.#.#####.#.#######.#######.#.#####.#.###.#.#.#.#####.###.#.#
...#.#.....#.#.#.......#.......#.#.....#...#.#.#.#.#...#...#.#.#
##.#######.#.#.#.#########.#####.#.#####.#.#.###.#.#.#.#####.#.#
.#.........#.#...#...#.....#.....#.#...#.#.#...#...#.#.......#.#
.###########.#####.#.#.#####.#####.###.#.#.###.#.###.#########.#
.........#...#.....#.#.....#.#...#...#...#.....#.#...#.#.......#
####.###.#.###.#####.#.###.#.#.#####.#.###########.###.#.#######
.....#.#.#.#...#.#...#...#.#.#.....#.#.............#...#.#.....#
.#####.#.#.#.###.#.#######.#.###.###.#####.#########.#.#.#####.#
...#...#.#.#.#.............#...#.#...#.....#...#.....#.#.......#
##.#.###.#.#.#################.#.#.###.#####.#.#.#####.#######.#
...#.....#.#.#...#...........#...#.#...#...#.#S#.#...#.#.....#.#
.#####.###.#.#.#.#.#########.###.#.#.###.#.#.###.###.#.###.###.#
.....#.#...#.#.#.#.#.......#.....#.#.#...#.#.#...#...#.....#...#
.###.###.###.#.#.###.#####.#.#####.#.###.###.#.###.#.#####.#.###
.#...#...#.....#.#...#...#.#...#...#.....#...#.#...#.....#.#...#
.#.#.#.###.#####.#.###.###.#####.#########.###.#.#########.###.#
.#.#.#.#...#.....#...#.#...#.....#.......#.#...#.#.........#.#.#
.#.###.#.###.###.###.#.#.###.###.#.#####.#.#.###.#.#########.#.#
.#...#.#...#.#.....#...#.#...#...#.....#...#.#.....#.....#...#.#
####.#.###.#.#########.#.#.###.#######.#####.#.#####.###.###.#.#
.....#...#.#...#.....#.#.#...#.......#.#.....#...#...#.#.#...#.#
.#######.#.###.#.###.#.#.###.#########.#.#######.#.###.#.#.###.#
.......#.#.#.#...#.#...#.#...#.....#...#.#...#...#.#.......#...#
####.###.#.#.#####.#####.#.###.###.#.###.###.#.###.#########.###
.....#...#.#.....#.....#.#...#.#.#...#.#...#...#...........#.#.#
.#####.###.#.###.#####.#.###.#.#.#####.#.#.#.###########.#.#.#.#
.#.....#...#.#.#.......#...#.#...#...#...#.#...........#.#.#.#.#
.#.#####.###.#.###.#####.###.###.#.###.###.###########.###.#.#.#
.#.#...#.....#.....#.....#.....#.#...#.#...#.....#.......#.#.#.#
.#.#.###.###########.###.#.#####.#.#.#.#.###.###.#######.#.#.#.#
...#.....#...#...#...#...#.#.....#.#...#.#...#...#...#.....#.#.#
.#####.###.#.#.#.#.###.###.#.#####.#####.#.###.#.#.#.#######.#.#
.#...#.#...#...#...#.#.#.#.#.....#...#...#.#.#.#.#.#...#...#.#.#
.#.#.###.###########.#.#.#.#####.###.#.###.#.#.###.###.#.#.#.#.#
...#.....#...............#.......#...#.......#.......#...#.....#
################################################################
