16
...#.....#.....#
.#.#####.#.#.###
S#.....#...#...#
######.#######.#
.....#...#.....#
.#.#####.#.###.#
.#.....#...#...#
.###.#.#####.###
.#...#.....#...#
.#.###########.#
.#.#...#.....#.#
.#.#.#.#.###.#.#
.#.#.#.#.#.#...#
.#.#.#.#.#.#####
.#...#..G......#
################
