8
......G#
.###.###
...#...#
.#####.#
.#S..#.#
.###.#.#
...#...#
########
