16
.....#.........#
.###.#.###.#####
.#...#.#.#.#G..#
.#.###.#.#.#.#.#
.#...#...#...#.#
.###.#.#######.#
...#...#...#...#
.#####.#.#.#.#.#
.#...#.#.#...#.#
##.#.###.#####.#
...#.....#.....#
.#########.#####
.#..S#.#...#...#
.#.###.#.#####.#
...#...........#
################
