16
...........#...#
####.###.###.#.#
...#...#.#...#.#
.#.#####.#.###.#
.#S#...#...#.#.#
.###.#.#.###.#.#
.....#.#.....#.#
######.###.###.#
.....#...#.#...#
####.###.###.#.#
.......#...#.#.#
.#####.###.#.###
.#...#.#..G#...#
.#.#.###.#####.#
...#...........#
################
