32
...#.....#.......#.......#.....#
.###.#.###.#####.#.###.#.#.###.#
.....#.....#...#...#...#...#...#
.###########.#.#.###.#######.###
..G#.........#.#.#...#.........#
.###.#########.#.#.###.#######.#
.#...#.....#...#.#.#...#...#...#
##.#####.###.###.#.#####.#.###.#
...#...#.....#...#.......#...#.#
.###.#.###.#####.###########.#.#
.#...#...#.....#.#.......#.#.#.#
.#.#####.#####.#.###.###.#.#.###
.#...#.#.#.....#...#.#.#.#.#...#
.###.#.#.###.#####.#.#.#.#.###.#
.#...#.#...#...#.....#.....#...#
.#.###.###.###.#.###########.#.#
...#...#...#.#.#...#...#.....#.#
.###.###.###.#.#####.#.#.#####.#
.....#...#...........#...#...#.#
####.#.#####.#####.#######.###.#
.....#.....#.#...#.#...#.....#.#
.#########.###.#.#.#.#.###.#.#.#
.#.......#.#...#.#.#.#...#.#.#.#
.###.#.###.#.###.###.###.#.#.#.#
.....#.#...#.#.#.#S..#.#.#.#.#.#
######.#.###.#.#.#####.#.#.#.#.#
.#.....#.....#.#.#.....#.#.#...#
.#.###########.#.#.#.#.#.###.###
.#.#.......#...#...#.#.#...#.#.#
.#.#####.#.###.#####.#####.#.#.#
.........#.........#.......#...#
################################
