64
.....#...........#.........#...#.......#.......#.......#.......#
.#####.###.#####.#.#.#####.#.###.###.###.###.###.###.#.#####.#.#
.......#...#...#.#.#.#...#.#...#...#.....#.#...#.#.#.#.#...#.#.#
.#######.###.#.#.#.###.#.#.###.###.#######.###.#.#.#.#.#.#.###.#
...#...#...#.#...#.....#.#.#...#...#.........#...#.#.#.#.#G..#.#
##.#.#####.#.###########.#.#.###.###.#.#####.#####.#.#.#.###.#.#
...#...#...#.............#.#.#...#...#.#...#.#.....#.#...#.#.#.#
.###.#.#.#################.#.#.#######.#.###.#.#.###.#####.#.#.#
.#...#.#...#...........#.#...#.........#.#...#.#.#...#.....#...#
.#####.###.#.#########.#.###.###########.#.###.#.#.#####.#.###.#
.........#.#.....#.#...#...#.#.....#.....#...#.#.#.....#.#.#...#
.#########.#####.#.#.###.#.#.#.###.#.###.###.###.#####.###.#.###
.#...#...#...#...#.#.#...#.#...#...#.#.....#.#...#...#.#...#...#
.#.#.#.#.#.###.###.#.#.###.#####.###.#######.#.#.#.#.#.#.#####.#
.#.#...#.#.#...#...#.#.#...#...#.....#.....#...#.#.#...#.......#
.#.#####.#.#.#####.#.#.#####.#.#####.#.###.#.#####.#####.#####.#
.#.#...#...#.#.....#.#.......#.....#.#...#.#.#...#.#.....#...#.#
.#.#.#.###.#.###.#.#.#.#########.#.#.###.#.#.#.#.#.#######.#.#.#
.#...#.#...#.....#.#.#.....#...#.#...#...#...#.#.#.........#.#.#
######.#.#######.###.#######.#.#######.#######.#.#########.#.#.#
.......#.#.......#...#.....#.#.......#.#.......#.........#.#.#.#
.#######.#.#######.###.###.#.#######.#.#.###############.#.#.###
.....#...#.#...#...#.....#...#.....#...#.#...#.....#.....#.#...#
####.#.###.###.#.#.#.#######.#.###.#####.#.#.#.#.#.#.#####.###.#
.....#.#.#.....#.#.#...#...#.#.#.........#.#.#.#.#.#.#.....#...#
.#####.#.#####.#.#####.#.#.###.#########.#.#.#.#.###.#######.###
.#...#.#.#...#.#.......#.#...#.#.....#.#.#.#.#.#.....#.....#...#
.#.#.#.#.#.#.#.#########.###.#.#.###.#.#.#.#.#.#######.###.#.#.#
...#.#...#.#.#.........#.#.#.#.#.#.#.#...#.#.#.....#.....#.#.#.#
####.###.#.#.#####.#####.#.#.#.#.#.#.#.###.#.#####.#.###.#.###.#
.....#...#.#...#...#.....#.....#...#.#...#.#...#.#.#...#.#...#.#
.#########.###.#.###.#########.###.#.#.###.###.#.#.#####.###.#.#
.#.........#.#.#.#.#.#.....#...#...#.#.#...#.#.#.#.....#...#...#
.#.#########.#.#.#.#.#.###.###.#.###.###.###.#.#.#####.#.#.###.#
.#.#.........#.#.#.#...#.#...#.#...#.#...#...#.#.....#.#.#.#...#
.#.#.###.###.#.#.#.#####.###.#####.#.#.###.###.#.###.#.###.###.#
...#.#...#...#.#.#.....#...#.....#.#.#.....#...#...#.#...#...#.#
.#####.###.###.#.#.###.#.#.###.###.#.#####.#.###.#.#####.#.#.#.#
.....#.#.....#...#...#...#...#.....#...#...#.#.#.#...#...#.#.#.#
####.#.#####.#######.#####.#####.###.###.###.#.#.###.#.###.#.###
.#...#...#.........#.#...#.#..S#...#.....#...#.....#.#.#...#...#
.#.#####.#########.#.#.###.#.#####.#######.#########.#.###.###.#
.#.....#.....#...#.#.#.....#.#.......#.....#...#...#.#...#.#.#.#
.#####.#.###.#.#.#.#.#.#####.#########.#####.#.#.#.#.###.#.#.#.#
.....#.#.#.#.#.#.#.#.#...#.#...........#.....#...#...#...#...#.#
.###.#.#.#.#.###.#.#.###.#.#############.#.#######.###.###.###.#
...#.#.#.#.#...#.#...#.#.........#...#...#.....#...#...#...#...#
##.#.#.#.#.###.#.#####.###.#####.#.#.#.#######.###.#.#######.#.#
...#.#.#.....#.#...........#...#...#.#...#...#...#.#.#.....#.#.#
.#####.#####.#.#########.###.#.#########.#.#.###.#.#.#.###.#.#.#
.....#.....#.#.....#...#.#...#.........#...#.#...#.#.#.#.#...#.#
.###.#####.#.#####.#.#.###.#######.###.#####.#.#.###.#.#.#####.#
.#.#.....#.#.....#...#.......#...#.#.......#.#.#.#...#.#.......#
.#.###.#.#.###########.#######.#.###.###.###.#.###.###.###.#####
.#...#.#.#...........#.....#...#...#.#...#...#.....#.#...#.#...#
.###.#.#.###########.#######.#####.#.#.###.#########.#.#.#.#.#.#
.....#.#...........#.......#.....#...#.#...#.......#...#.#...#.#
####.#.###################.#####.###.###.###.#####.#####.#####.#
.....#...............#...#.#...#...#.#...#...#...#.......#.....#
.#################.#.#.#.#.#.#.###.#.#.#####.###.#########.#####
.........#...#...#.#...#.#.#.#...#.#.#.#.....#.....#.....#.....#
########.#.#.###.#.#######.#.###.#.#.#.###.###.#####.#.#######.#
...........#.....#...........#.....#.#.....#.........#.........#
################################################################
