64
.......#.......#.....................#.#...#...................#
.#####.#.###.###.###.###############.#.#.#.#.#####.###########.#
.#...#.#.#.#.....#...#.....#.......#.#...#.......#.#.........#.#
.#.#.#.#.#.#######.###.###.#.#####.#.#############.#####.###.#.#
.#.#...#...#.....#.....#...#...#...#...#.....#...#.....#.#...#.#
.#.#######.#####.#######.#####.#.#####.#.###.#.#.#####.###.###.#
.#.......#...#...#.....#.....#.#.....#.#.#.....#.....#...#.#...#
.#####.#####.#.#.#.###.#####.#.###.###.#.###########.#.#.#.#.###
...#.#.........#...#...#...#.#...#.#...#.........#...#.#.#.#...#
##.#.###############.###.#.#.###.#.#.###.#######.#.###.#.#.###.#
.#.......#.....#.#...#.#.#...#...#.#.#.#...#...#.#...#.#.#.#...#
.###.#####.###.#.#.###.#.#####.#####.#.###.#.#.#.###.#.#.#.#.###
.....#...#...#.#.......#...#...#.....#.#...#.#.#.#...#.#.#.#...#
.#####.#.###.#.###########.#.###.#####.#.###.#.#.###.###.#.###.#
.....#.#.....#...#.......#.#.....#...#...#...#.#...#...#.#.....#
.#####.#########.#.#####.#.#.#####.#.###.###.#.###.###.#.#.#####
.#.....#...#.......#...#.#.#.#.....#...#...#.#...#...#...#.....#
.#.#####.###.#######.###.#.#.#.#.#####.###.#.#####.#.#####.#####
.#.#.......#...#...#.......#.#.#.#...#...#...#...#.#...#...#...#
.#.#.#####.###.#.#.#########.###.#.#####.#.###.#.###.#.#####.#.#
.#.#.#...#.....#.#.......#.....#.#.....#.#.#...#...#.#.......#.#
##.#.#.#########.#######.#####.#.###.###.###.#####.###########.#
...#...#.........#.....#.....#.#...#...#.....#...#...........#.#
.#.#####.#########.#########.#.###.###.#######.#.###########.#.#
.#.#...#.#.........#...#.....#.....#...#.....#.#.#.#.......#...#
.###.#.#.#.#########.#.#.###########.#.###.#.#.#.#.#.###.#####.#
...#.#...#...........#.#...#.....#...#.....#...#...#...#.#...#.#
.#.#.#######.#########.###.###.#.###.#########.#######.#.#.#.#.#
.#.#...#...#.........#...#...#.#...#.#.....#...#.......#.#.#...#
##.###.#.#.#########.#.#.###.#.###.#.#.###.#####.#######.#.#####
...#...#.#...#.......#.#.#S#.#...#.#.#...#.....#.#.....#...#...#
.###.###.###.#.#######.###.#.###.#.#.###.#####.#.###.#.#####.#.#
...#.....#.#.#.#.....#...#...#...#.#.#...#...#.#.....#.#.....#.#
.#.#######.#.#.#.###.#.#.#####.###.#.#.###.#.#.#######.#.#.#####
.#...#.....#.#.#...#.#.#.......#...#.#.#...#.#.......#.#.#.....#
####.#.#.###.#.###.#.###.#######.###.#.#####.###.#####.#######.#
...#.#.#.....#.#.#.#.#...#.#...#...#.#.....#.#...#.....#.......#
.#.#.#.#######.#.#.#.#.###.#.#.###.#.#####.#.#.#.#.#####.#####.#
.#.#.#...#...#.#.#.#...#.....#.......#.....#.#.#.#.#.....#.#...#
.#.#.###.#.###.#.#.###########.#######.#####.#.###.#.#####.#.###
.#...#...#...#.#.#...#.......#...#...#.#.....#.....#.#.....#...#
.###.#.#####.#.#.###.#.#####.###.#.#.#.#.###.#######.###.#####.#
...#.#...#...#.#...#.#...#...#...#.#.#...#.#...#.......#.#...#.#
.#.#.###.#.#.#.###.#.###.#.#######.#.#####.###.#######.#.#.#.#.#
.#.#.#...#.#.#.#...#.#...#.#.....#.#.....#...#.........#...#.#.#
.#.###.###.#.#.#.#.#.#.###.#.###.#.###.#.###.###############.#.#
.#.#...#...#.#.#.#.#.#.#.#.#...#...#.#.#.....#.........#.....#.#
##.#.###.#.###.#.#.#.#.#.#.###.#####.#.#####.#.#######.#.#####.#
...#...#.#.#.....#.#.....#.#...#.....#.#.......#...#.....#.....#
.#####.#.###.#############.#.#######.#.#########.#.#######.#####
.#.....#.....#.......#.....#.......#.#...#.......#...#...#.#...#
.#.#####.#####.#####.#.###.#######.#.###.#.#########.#.#.#.#.#.#
.#...#.#.#.#...#...#...#...#.....#.#...#.#.#.......#...#.#.#.#.#
.###.#.#.#.#.###.#######.###.#.###.#.#.#.#.###.###.#####.#.#.#.#
.....#.#.#.#...#.....#...#...#.....#.#.#.#...#.#...#...#...#.#.#
######.#.#.###.#####.#.###.#########.###.###.#.###.###.#####.#.#
.......#.#...#.....#.#...#...#.........#.....#...#...#.....#.#.#
.#######.#.#.#####.#.###.###.#.#######.#######.#.###.#.#.#.###.#
.#...#...#.#.#.....#.....#...#.#.....#...#.....#.#.#.#.#.#.#...#
.#.#.#.#####.#.#########.#.###.#####.#.###.#####.#.#.###.#.#.#.#
...#...#...#.#.#.......#.#...#.......#.....#.....#.#...#.#.#.#.#
.#######.#.#.#.#.#####.#####.###############.#####.###.#.#.#.#.#
.........#...#.......#.......................#...........#..G#.#
################################################################
