32
.......#.#.........#...........#
.#.###.#.#.###.###.###.#########
.#.#..G..#...#...#...#...#.....#
.#.#########.###.###.#.#.#.###.#
.#.......#.....#.#...#.#.....#.#
.#######.#.#####.#.###########.#
.#.....#...#.....#.#...#...#...#
.#####.#####.#####.#.#.#.#.#.###
...#.......#.#.#...#.#...#.#...#
##.#.#######.#.#.###.#####.###.#
.....#...#...#.#...#.#...#.....#
######.#.#.###.###.#.#.#######.#
.....#.#.#.#.....#.#.#.......#.#
.###.#.#.#.#.###.#.#.#####.#.#.#
...#...#...#.#.#.#.#.....#.#.#.#
##.#########.#.#.#.#####.#.#.#.#
...#.........#.#...#.....#.#...#
.###.#########.#####.#######.###
...#.........#.......#.....#...#
.#.#########.#.#######.###.###.#
.#...#...#.#.#...#.....#...#...#
.###.#.#.#.#.#.#.#.#####.###.###
...#.#.#.#...#.#...#.....#...#.#
####.#.#.#.#########.#####.###.#
...#...#.#...#...#...#...#.....#
.#.#####.###.#.#.#.###.#######.#
.#...#...#.....#...#...........#
.###.#.###.#########.###########
.#.....#...#....S#...#.........#
.###########.#####.#####.#####.#
.............#...........#.....#
################################
