16
.#......G....#.#
.#.###.#####.#.#
.....#...#.#...#
.#######.#.###.#
.#.......#...#.#
##.#######.#.#.#
...#...#...#.#.#
.###.#.#.#.#.#.#
...#.#...#.#.#.#
##.#.#####.###.#
...#...#...#...#
.#####.#.###.###
.....#.#.....#.#
.###.###.#####.#
...#..S#.......#
################
