16
.....#.........#
.###.#######.#.#
G#.#.........#.#
.#.###.#########
.#.....#.....#S#
.#######.###.#.#
.#.....#...#.#.#
.#.###.###.#.#.#
.#...#.....#...#
.###.###########
.#...#.........#
.#.###########.#
.#.#...........#
.#.#.#########.#
.....#.........#
################
