8
.#.....#
.#.###.#
.#..S#.#
.#####.#
.....#.#
.#####.#
G......#
########
