64
...#.................#...#.......#...........#.........#.......#
##.#.#.###############.#.#.###.#.#.###.#####.#.#.#####.#######.#
...#.#...#.............#.....#.#.#...#.#...#.#.#.#...#.........#
.#.#.###.#.###################.#.###.#.#.#.###.#.#.#.###.#######
.#.#.#.#...#...........#...#...#...#.#...#.....#.#.#.....#.....#
.###.#.#####.#######.#.#.#.#.#####.#.###########.#.#######.###.#
.....#.#...#.#.......#.#.#.#...#...#.#...#.#.....#.....#.....#.#
.#####.#.#.#.#.#######.#.#####.#.###.#.#.#.#.###########.#####.#
.....#...#...#...#.....#...#...#...#.#.#...#.....#.......#.#...#
####.#####.#####.#.#######.#.#######.#.#########.#.#######.#.###
...#.....#.....#.#.#.......#...#...#...#...#...#.#...#.....#...#
.#######.###.###.#.#####.#####.#.#.###.#.#.#.#.#.###.#.###.###.#
.......#.#.#.#...#.....#.#...#...#.....#.#.#S#.#.....#.#.....#.#
.###.###.#.#.#.#######.#.#.#.#########.#.#.###.###.###.#####.#.#
...#.#...#...#...#.....#...#.....#...#.#.#...#...#...#...#.#.#.#
####.#.###.#####.#.#####.#######.#.#.###.###.###.###.###.#.#.#.#
.....#.#.#.....#.#.....#.#...#.#.#.#.....#.#...#...#...#.#...#.#
.#####.#.#####.#.#####.#.#.#.#.#.#.#######.#.#####.###.#.#.###.#
.......#.......#.....#.#...#...#.#.#.......#.....#...#.#.#.#...#
.#######.###########.#.#####.###.#.#.#####.#####.###.#.#.#.#.#.#
.#.#.....#.....#.....#...#.#.#...#...#...#.#...#...#.#...#.#.#.#
.#.#.#####.###.#.#######.#.#.#.#.#####.###.#.#.#.#.#.#######.#.#
.#.#.....#.#.#...#...#...#.#.#.#.#.#.......#.#.#.#.#...#...#.#.#
.#.#####.#.#.#####.###.###.#.#.#.#.#.#######.###.#####.#.#.#.#.#
.#.#.....#.#.#.........#.....#.#...#.#.....#...#.....#.#.#.#.#.#
.#.#.#####.#.#.#########.#####.#####.#.###.###.#####.#.#.#.#.###
.#.#.#...#.#.#.#.......#...#...#.....#.#.#.#...#...#.#...#.#...#
.#.#.#.###.#.#.#####.#.#####.###.#####.#.#.#.#.###.#.#####.#.#.#
.#.....#...#...#...#.#...#...#...#.....#...#.#.....#...#...#.#.#
.#######.###.###.#.#.###.#.#.#.#####.###.###.#####.###.#.#####.#
.........#.#.#...#.#...#...#.#.....#...#.....#.....#...#.#.....#
##########.#.###.#.###.#####.#####.###.#######.#####.###.#.###.#
...#.......#.....#.....#...#...#.#.....#.....#.#...#.....#.#.#.#
##.#.#####.#############.#.###.#.#######.#.#.#.###.#######.#.#.#
...#.#.#.......#...#.....#.#...#.......#.#.#.#.....#...#...#...#
.###.#.#.#####.###.#.#####.#.###.#######.#.#.#####.#.###.#.#.###
.....#.#...#.......#.#...#.#...#.#.......#.#.#...#.#.....#.#.#.#
.#####.###.#########.#.#.#.###.#.#.#######.###.#.#.#.#####.#.#.#
.#...#...#.....#...#.#.#.#.#.....#.#.....#.....#...#.#.....#...#
.#.#.#.#.#####.#.#.#.###.#.#.#####.#.###############.#.#######.#
...#.#.#...#...#.#.#...#.#...#...#.#.......#.......#.#.#.......#
####.#.###.#.###.#.###.#.#####.#.#.#.###.#.#.#####.#.#.#####.###
.....#.#...#.....#...#.#...#...#.#.#.#.#.#...#...#.#.#.....#...#
.#######.#########.#.#.#.###.###.#.#.#.#.#####.#.#.#######.#####
.#.....#.#...#.....#.#.#...#...#...#.#.#.#...#.#.#.......#.....#
.#.###.#.#.#.#.#.#####.#.#.###.#####.#.#.#.###.#.#######.#.###.#
.#.#.#...#.#...#.#...#.#.#...#.#...#...#.#.....#.....#...#...#.#
.#.#.###.#.#######.#.#.#####.#.###.###.#.#.#########.#.#######.#
...#...#.#.........#.........#.#...#...#.#.#.......#...#.....#.#
######.#.###################.#.#.###.###.#.###.#.#######.###.#.#
.......#..G..#...#.......#.#.#.#.....#...#...#.#.......#...#...#
.###########.#.#.#.#####.#.#.#.#.#####.#####.#######.#.#.#.###.#
.......#.....#.#...#.#...#...#.#.....#.#.............#.#.#...#.#
######.#.#####.#####.#.#######.#######.###############.#####.#.#
.......#...#...#.....#.........#.....#.....#...#.....#.......#.#
.#.#######.#.#####.#.###########.###.#####.#.#.###.#.#########.#
.#.#.....#.#.#...#.#...#.........#.#...#...#.#...#.#.........#.#
.###.#.#.#.#.#.#.#.#.#.###.#######.###.#.###.###.#.#######.###.#
.....#.#.#.#.#.#.#.#.#...#...#.#.....#.#...#.#.#.#.#...#...#...#
.#####.###.#.#.#.#.#.###.###.#.#.###.#.#.#.#.#.#.#.#.#.#.###.###
.....#...#.#.#.#.#.#...#.....#.#...#...#.#.#.#.....#.#.#...#.#.#
####.###.#.#.#.#.#####.#######.###.#######.#.#######.#.#####.#.#
.......#...#...#.......#...................#.........#.........#
################################################################
