8
.....#G#
.###.#.#
.#...#.#
.###.#.#
..S#...#
######.#
.......#
########
