16
...........#...#
####.#######.#.#
..S#...#...#.#.#
.###.#.#.#.#.#.#
.#...#...#...#.#
.#########.###.#
...#.....#...#G#
##.#.###.###.#.#
.#.#.#.#...#.#.#
.#.#.#.###.###.#
...#.#...#.#...#
.###.###.#.#.###
.#.....#.#.#...#
.#####.#.#.###.#
.......#.......#
################
