8
.......#
.#####.#
.#..S#.#
.#.###.#
.#.#...#
.#.#.###
G..#...#
########
