64
.#.......#...........#.......#.....#.............#.............#
.#.#.#####.#####.#####.###.#.#.###.###.#####.###.#.###########.#
...#.......#.....#.......#.#...#.#...#.#...#...#.#.#.........#.#
.###########.#.###.#######.#####.###.#.#.#.###.#.#.#.#########.#
.#.........#.#.#...#.....#.#.#.....#.#...#.#...#.#.#...#.....#.#
.#.#.#####.#.#.#.###.###.#.#.#.#.###.#####.#.#####.###.#.###.#.#
.#.#.#.....#.#.#.#.#...#...#.#.#...#.....#.#...........#...#...#
.#.#.#####.#.###.#.###.#####.#.###.#####.###############.#.#####
.#.#.....#.#.#...#.#...#.......#.#.....#.#.........#...#.#.....#
.#######.#.#.#.###.#.###.#######.###.#.#.#.#######.#.#.###.###.#
.....#...#.#.#.#...#...#.#.........#.#.#.#.#.....#...#...#...#.#
####.#.#.###.#.#.#.###.#.#.###.###.#.###.#.#.###.#######.#####.#
...#.#.#.#...#...#.#...#.#...#.#...#.#...#.#...#.........#.....#
.###.#.#.#.#####.###.###.###.#.#.###.#.###.###.###########.###.#
...#...#.#...#...#...#...#...#.#.#...#.#...#.#.#...........#...#
.#.#.#######.#.###.###.###.###.###.#.#.###.#.#.#.#####.###.#.###
.#...#....S#...#...#...#.#.#...#...#.#.....#.#.#.#...#...#.#.#.#
.#####.#####.###.###.###.#.#.#.#.###.#######.#.###.#.###.#.#.#.#
.#...#.....#...#.#.#.#...#.#.#.#...#.#.......#.....#.#.#.#.#...#
.#.#.#####.#.###.#.#.#.#.#.#.#####.###.#.###.#######.#.#.#.###.#
.#.#...#.#.#.#...#...#.#...#.#...#.#...#...#.......#.#...#...#.#
.###.#.#.#.#.#.###.#####.###.#.#.#.#.#####.#####.###.#.#####.#.#
.....#...#.#.#.#.......#...#.#.#...#.#...#.#.....#...#.....#.#.#
##########.#.#.#######.###.#.#.###.#.###.#.#.#####.###.#####.#.#
...#.......#.#...#...#.#.#.#.#...#.#.....#.#.....#.#...#.....#.#
.#.#.#######.###.#.###.#.#.#.###.#######.#.#######.###.#.#####.#
.#.#.#.....#.#.#.#...#.#.#.#...#...#.....#.......#...#.#.#.....#
.#.#.#.###.#.#.#.#.#.#.#.#.###.###.#.###########.###.###.#####.#
.#...#.#.#.#.#.#.#.#...#.#...#...#...#...#.........#...#.....#.#
.#####.#.#.#.#.#.###.###.###.###.#######.#.#######.###.#####.#.#
.#.....#.#.#...#...#...#.#...#.#.........#...#.......#...#...#.#
.###.###.#.#.#####.###.#.#.###.#######.#.###.###########.#.#####
.....#...#.#.#.....#...#.......#.#.....#...#...........#.#.....#
########.#.###.#####.#########.#.#.#################.#.#.#####.#
.........#.....#...#.......#.....#.....#.........#...#.#.......#
.#####.#.#######.#.#######.#.#####.###.#.###.###.#.###########.#
.#.....#...#...#.#.......#.#.#...#.#...#.#.#.#...#.............#
.#.#######.#.#.#####.#####.#.#.#.#.#.###.#.#.#.#################
.#.#.....#...#.....#.#.....#.#.#.#.#.......#.#...#...........#.#
.#.#.###.#########.#.#.#######.#.###########.###.#.#########.#.#
.#.#...#.#.......#.#.#...#...#.#.............#...#...#.....#.#.#
.#.###.#.#.#.#####.#.###.#.#.#.###############.#####.#.###.#.#.#
.#...#.#.#.#...........#...#...#.........#...#.#.....#...#.#...#
.###.#.###.#####################.###.###.#.#.#.#.###.###.#.###.#
...#.#.....#...#.............#.....#...#.#.#...#...#...#.#...#.#
##.#.#.#####.#.#.#######.###.#########.#.#.#####.#.###.#.###.###
.#.#.#.....#.#.#.#.....#...#.....#...#.#.#.#...#.#...#.#...#...#
.#.#.#######.#.#.#.#.#####.#####.#.#.#.#.#.#.#.#####.#####.###.#
.#.#.........#...#.#.....#.....#...#.#.#.#...#.....#.......#.#.#
.#.###############.###.#.#####.#####.#.#.#########.#.#######.#.#
.#.#.........#.......#.#.....#.....#...#.......#.#.#.#...#...#.#
.#.#.#####.#.#####.###.#####.#####.###########.#.#.#.#.#.###.#.#
...#.#.....#.....#.#...#...#...#.#.......#...#.#.#.#.#.#.....#.#
.###.#.#########.###.###.#.###.#.#######.#.#.#.#.#.#.#.#######.#
...#.#.....#...#.....#...#.#.#.#.....#.#...#.#...#.#...#.......#
##.#.#####.###.#########.#.#.#.###.#.#.#####.###.#.###.#.#######
...#...#...#.............#.#.#.....#.#.....#.#...#...#.#.......#
.#######.###.#.###########.#.#######.#####.#.#######.#########.#
.#.....#.#...#.#.........#.#...#....G#...#.#.......#.#.....#...#
.#.###.#.#.#.###.#######.#.#.#.#.#####.#.#.#####.#.#.#.###.#.#.#
.#...#...#.#...#...#.#...#...#.#...#...#.....#.#.#.#.#...#...#.#
.###.#####.###.###.#.#.###########.#.#######.#.#.###.###.#####.#
.....#.......#.......#...............#.........#.........#.....#
################################################################
