16
.#...#........G#
.#.#.#.#######.#
.#.#...#.....#.#
.#.#####.###.#.#
.#.#...#.#.....#
.#.#.#.#.#######
.#.#.#.#...#...#
.#.#.###.#.#.#.#
.#...#S#.#...#.#
.#.###.#######.#
.#.#...#...#...#
.#.#.###.#.#.#.#
...#.#...#.#.#.#
.###.###.#.#.#.#
...#.....#...#.#
################
