64
..G..#...........#.............#.........#.......#.............#
##.###.#######.#.#.#.#########.#.#######.#.#####.#.#######.###.#
...#...#...#...#.#.#.#.....#...#.....#...#.#...#...#...#.#.#...#
.###.#####.#.#####.#.#.###.#.#####.###.#.#.#.#######.#.#.#.###.#
.....#.....#.......#...#.#.#.#...#.#...#.#.#.........#...#...#.#
.#####.#################.#.#.#.#.#.#.###.#.###.###.#####.###.#.#
...#...#.......#.........#.#...#.#.#.#...#...#...#...#.....#.#.#
##.#.###.###.###.#.#####.#.#####.#.#.#######.#######.#######.#.#
.#.#.......#.....#.#.....#.#.....#.#...#...#...#...#.#.......#.#
.#.#.#####.#######.#####.#.#.#########.#.#.###.#.#.#.#.#######.#
...#.#...#.......#.....#.#.#.#.......#.#.#.......#...#.#.....#.#
.#####.#.#.#####.#####.#.#.#.#.#####.#.#.###########.#.#.###.#.#
.#...#.#.#.#...#...#...#.#.#.#.....#.#.....#...#...#.#.#...#.#.#
.#.#.#.#.#.#.#.#####.#.###.#.#####.#.#####.###.#.#.###.###.#.#.#
...#...#.#.#.#.......#.#...#.......#.....#.#...#.#.....#...#.#.#
########.#.#.#####.#####.###############.#.#.#.#.###########.#.#
.......#.#.#.#.....#.....#...........#.#.#...#.#.....#.......#.#
.###.###.###.#.#####.#####.#########.#.#.###########.#.###.###.#
.#.#.#...#...#.....#...#.#...#.....#...#...#.........#.#...#...#
.#.#.#.###.#######.###.#.#.#.#.###.###.###.#.#########.#####.###
.#.#...#.....#...#.#...#.#.#...#.#...#...#.#...#.....#.......#.#
.#.#########.#.#.###.###.#.#####.###.#####.#.#.#####.#.#######.#
.........#...#.#.#...#...#.........#.#.....#.#.....#.......#...#
########.#.###.#.#.###.#.#########.#.#.#####.#####.#######.###.#
.#.........#...#.#.#...#.......#...#.#.#...#.#...#...#.........#
.#.#########.###.#.###########.#.###.#.###.#.###.###.#.#########
.......#.....#.#.#.#.........#.....#.#...#.#...#...#.#.#.......#
########.#####.#.#.#.#######.###.###.###.#.###.#.#.#.###.#####.#
.........#.....#...#.#.....#...#.#...#...#...#.#.#.#.#...#.....#
.#########.#.#######.#.###.###.###.###.###.###.#.#.#.#.###.###.#
.#.....#...#.........#...#...#...#.#...#.......#.#.#...#...#...#
.#.###.#######.#######.#.#######.#.#.###.#######.#.#####.#######
...#.#.......#.....#...#.....#...#.#.#...#...#...#.....#.......#
.###.#######.#.###.#.#######.#.###.#.###.#.#.###.#####.#######.#
.....#.......#...#.#.......#...#...#...#...#...#...#.#...#...#.#
######.#######.###.#.#########.#.#.###.#######.###.#.###.#.#.#.#
.......#.......#...#.#.......#...#.#.#.#.....#.#...#.....#.#.#.#
.#######.#######.#####.#####.#####.#.#.#.#.#.#.#.#####.###.###.#
.#.#...#.....#...#.....#...#.#.....#.#.#.#.#.#.#.....#...#.#...#
.#.#.#.#####.#.#.#.#####.###.###.###.#.###.###.#####.###.#.#.###
.#...#.....#.#.#.#...#.....#...#.....#...#...#.......#...#.#...#
.#.#####.#.#.#.#####.#####.###.#####.###.#.#.#########.###.###.#
.#...#.#.#.#.#...#...#.......#...#.....#.#.#.......#...#.....#.#
.###.#.#.###.###.#.###.#####.###.#####.#.#########.#.#######.#.#
...#.#.#.....#.#...#...#...#...#...#...#.#.......#.#.#...#...#.#
.#.#.#.#######.#######.#.#####.###.#.###.#.#####.#.#.#.#.#.###.#
.#.#.#.#...............#.#.....#...#...#.#...#...#.....#...#...#
##.#.#.#.#########.#####.#.#####.#####.#.#.#.#.###########.#.###
...#.#...#.....#...#...........#.....#.#.#.#.#.....#.....#.#...#
.###.#####.###.#.###.###########.###.###.###.#####.#.###.#####.#
.#.......#...#.#...#.#.#.......#...#.#...#...#.....#...#...#...#
.#######.###.#.###.#.#.#.#####.#####.#.###.#####.#####.###.#.###
.#...#.......#.#...#...#...#.#S#.....#...#.#...#...#...#.#.#...#
.#.#.#########.#.#####.###.#.###.#######.#.#.#.###.#.###.#.###.#
...#...#.....#...#.......#.#.......#...#.#.#.#.#...#.#.........#
######.#.###.###########.#.###.###.#.#.#.#.#.#.#.###.###########
.......#.#.#.........#...#...#...#...#...#...#.#...#...........#
.#######.#.#########.#######.###.#########.###.###.###########.#
.#.....#.#.......#.#...#...#...#.....#.....#...#.#.#.........#.#
.#.###.#.#.#####.#.###.#.#.###.#####.#######.###.#.#.#######.#.#
.#...#.#...#...#.#...#...#.....#...#.....#...#...#.#.#.#...#.#.#
.###.#.#####.#.#.#.#.###########.#.#####.#.###.###.#.#.#.#.#.#.#
.....#.......#...#.#.............#.........#.........#...#.....#
################################################################
