64
.......#.......#.....................#.#.....#...........#.....#
.#.###.###.#.###.#############.#.###.#.#.#.#.#.#####.###.#.###.#
.#...#.....#.#...#...#...#...#.#.#.....#.#.#.#...#...#.#...#...#
.###.#########.#####.#.#.#.#.###.#######.#.#.#.###.###.#####.###
...#.......#.........#.#...#...#.#.....#.#.#.#.#...#.........#.#
.#########.#.#########.#######.#.#.###.#.#.###.#.#########.###.#
.#.......#...#.#.....#...#.#...#...#.#...#.#...#...#.....#.....#
.#.#####.###.#.#.###.###.#.#.###.###.#####.#.#####.#.###.#####.#
.#...#.#...#...#...#.#.....#.#...........#.#...#...#...#.....#.#
.###.#.###.###.###.#.#.#####.#######.#####.###.#.###.#######.#.#
.#.#.#...#...#.#...#.#...#...#.....#.#...#.....#.#...#.......#.#
.#.#.###.###.#.#.###.###.#.#.#.###.###.#.#######.#.###.#######.#
.#.#...#...#.#.#.#.....#.#.#.#...#.#...#...#...#...#.#.#.....#.#
.#.###.#.#.#.###.#.#####.#.#####.#.#.#####.#.#.###.#.#.#.#.###.#
.#...#.#.#.#.....#.....#.#.......#.#...#.....#...#...#.#.#.....#
.###.#.#.#############.#.#########.###.#########.###.#.#########
.#...#...#...#...#.....#.#.#.....#...#.....#...#...#.#.........#
.#.#.###.#.#.#.#.#.#####.#.#.#.#####.#.###.#.#.###.#####.#####.#
...#...#.#.#...#...#.....#.#.#.....#.#.#...#.#...#.#...#.....#.#
########.#.#######.#.#####.#.###.#.#.###.###.###.#.#.#.#######.#
.........#...#...#.#.....#.#.#.#.#.#...#...#...#...#.#...#...#.#
.###########.#.#.#.#####.#.#.#.#.#####.###.#######.#.###.#.#.#.#
...#.....#.#.#.#.....#...#.#.#.#.....#...#.#.....#...#.#...#...#
##.###.#.#.#.#######.#.###.#.#.###.#####.#.#.###.#####.#######.#
.#.#...#...#.......#.#.#...#.#...#.....#.#.#...#.#.............#
.#.#.#######.#####.###.#.#.#.###.#####.#.#.###.#.#######.#######
...#.#.....#...#...#...#.#.#.#.......#.#.#.....#.......#.#.....#
.###.#.###.#####.###.#####.#.#.#.#####.#.#########.###.#.#.#.###
.....#.#.........#...#...#.#.#.#.#.....#.........#.#...#.#.#...#
##.###.#########.#.###.#.#.#.#.#.#.###.#########.#.#.###.#.###.#
.#.#...#...#.....#.#...#...#...#.#.#.....#.....#.#.#.#...#.#.#.#
.#.#.###.#.#######.#.#####.#.#####.#####.#.#.###.#.#.###.#.#.#.#
.#.#.....#.#.......#.#.....#.#.....#...#...#.#...#.#...#.#...#.#
.#.#######.#.#######.###.###.#.#####.#.#####.#.###.###.#.#.###.#
.#...#...#...#.........#.#...#.....#.#.....#.#..S#...#.#.#.#...#
.###.###.#####.#######.#.#.#######.#.#####.#.#########.#.#.#.#.#
...#.....#.........#...#.#.#.....#...#...#.#...........#.#.#.#.#
##.#####.###.#######.#.###.#.###.#####.#.#.#############.#.#.###
...#...#...#.#.......#.#...#.#.#.......#.#.#.............#.#...#
.#.###.###.###.#########.###.#.#######.###.#########.#########.#
.#...#...#...#.#...#...#...#.#.#.......#...#...#...#...#.......#
.###.#.#.###.#.#.#.#.#.###.#.#.#.#######.###.#.#.#.###.###.###.#
.#.....#...#.#.#.#.#.#...#...#.#.#.....#.....#...#.#.#...#...#.#
.###########.#.#.#.#.###.#####.#.#.###.###########.#.###.###.###
.#.......#...#...#.....#.......#...#...#.........#.#...#...#...#
.#.#####.#.###.#########.###########.###.#######.#.#.#.###.#.#.#
.#.....#.#.#.#...#...#...#.........#.#...#.......#.#.#...#.#.#.#
.#.#####.#.#.###.#.#.#.#.#.###.#####.#.#.#.#######.#.#.###.###.#
...#.....#.#...#.#.#.#.#.#...#.....#.#.#.#.....#...#.#...#.....#
.###.#####.#.#.#.#.#.#.#####.#####.#.#.#.#.#####.#######.#####.#
.#...#.....#.#.....#.#...#...#...#...#.#.#.#...#.......#.......#
##.#.#.###########.#####.#.#####.#######.###.#.#######.#.#######
...#.#...#.....#.#.#.....#.......#.....#.....#.......#.#.#.....#
.#.#####.###.#.#.#.#.###########.#.###.#####.###.#.###.#.#####.#
.#.#.....#...#.#...#...............#.#.#...#...#.#.#...#.....#.#
.#.#.#####.###.#.###########.#######.#.#.#.#####.###.#######.#.#
.#.#.......#...#.#.#.......#.#...#.......#.......#...#.......#.#
.###########.###.#.#.#####.###.#.###############.#.###.#######.#
.....#.#...#.#.....#...#.#.#...#.....#...........#.#.#.......#.#
.#.#.#.#.#.#.#########.#.#.#.#######.#######.#####.#.#######.#.#
.#.#...#.#G..#.......#.#.#...#.....#.#.....#.#...#.#.......#...#
.#.#####.#####.#####.#.#.#####.#.###.#.###.###.#.#.#.#.#######.#
.#.............#.......#.......#.......#.......#...#.#.........#
################################################################
