64
.....#.........#...........#.......#...#.............#.....#...#
.###.#.###.###.#.#.#########.###.###.#.#.#########.#.#.###.#.#.#
.#...#.#...#.....#.#...........#.#...#.#.#.....#...#.#.#.#.#.#.#
.#.#.#.#.###########.#########.#.#.###.#.###.#.#.###.#.#.#.#.#.#
.#.#.#.#G....#.......#.......#.#.....#.......#.#.#.....#.....#.#
.#.###.#####.#.#######.#####.#####.###########.#.#############.#
.#...#...#.#.....#...#...#...#...#.#...#.....#.#.#.........#...#
.###.###.#.#######.#.###.#.###.#.###.#.###.#.#.#.#.#######.#.###
...#.......#.......#...#.#...#.#.....#...#.#...#.#.....#...#...#
##.#########.#########.#.###.#.#########.#######.#####.#.#######
.......#.....#.#.....#...#.#.#.#...#...#.............#.#.......#
.#######.#####.#.#.#.#####.#.#.#.#.#.#.###########.###.#######.#
.#.....#.#.......#.#...#...#...#.#...#.........#...#...#...#...#
.#.###.#.#######.#.###.#.#.#.###.#############.#.###.#####.#.#.#
.#.#.#...#.....#.#.#.....#.#.#...#...........#.#...#.......#.#.#
##.#.#.###.###.###.#########.#.###.#########.#.#######.#####.###
...#...#.....#...#.........#.#.....#.........#.#.......#...#...#
.#######.#######.#.#######.#.#######.#########.#.#######.#.###.#
.........#.....#.#.#.....#.#...#.....#.......#...#.......#.#...#
.#########.###.#.#.###.###.###.#.#####.#####.#####.#######.#.###
.#...#...#...#...#.#...#...#...#.#.....#...#.....#.#...#.#...#.#
.#.#.#.#.###.#####.#.###.#.#.###.#.#.###.#.#######.#.#.#.#####.#
.#.#.#.#.#...#...#...#...#.#...#.#.#.#...#.#.......#.#.........#
.#.#.#.#.#.###.#.#####.#######.#.###.#.###.#.#######.#########.#
.#.#...#.#.....#.#.....#...#...#.....#.#.....#.#.....#...#...#.#
##.#####.#######.#.#.###.#.#.#######.#.#######.#.#.###.#.###.#.#
...#.....#.....#.#.#.#...#.#.....#...#.......#...#.#...#...#...#
.###.#####.###.#.#.###.###.#.#####.#########.#.###.#.#####.#####
...#.#.....#.#...#.....#.#...#...#.#...#.#...#...#.#...#.#.#...#
##.#.#.###.#.#####.#####.#####.#.#.#.#.#.#.#######.###.#.#.#.#.#
...#.#.#...#.....#.......#.#...#.#...#...#.#.....#...#...#...#.#
.###.###.###.###########.#.#.###.#######.#.#.###.###.###.#####.#
.#.......#...#.......#...#.#.#.#...#.....#.#...#...#.....#.....#
.###########.#.#####.#.###.#.#.###.#.#####.###.###.#.#####.###.#
.#...#.......#...#.#.#.....#.....#...#...#...#.#...#...#...#...#
.#.#.###.#######.#.#.#####.#####.#####.#.#.#.#.#.###.###.###.###
.#.#...#.......#...#.....#.#.....#...#.#.#.#.#.#.#...#...#.#...#
.#.###.#.###.#####.#####.#.#.#######.#.#.###.#.#.#####.###.###.#
.#.#.#.#...#.........#.#...#.....#...#.#.....#.#.....#...#.....#
.#.#.#.#############.#.#########.#.###.#######.#####.###.#######
...#.#...#.........#.#.....#...#.#.#S..#.......#...#.#...#.....#
.###.###.#.#######.#.###.#.#.#.#.#.#######.#####.###.#.#.#.###.#
.#.....#...#.....#.#.....#...#.#...#.#.....#.....#...#.#.#.#.#.#
.###.#.#########.#.###########.###.#.#.#.#####.#.#.###.###.#.#.#
...#.#.........#.#.#.#.......#.#...#...#.....#.#...#.....#.#.#.#
##.#.#########.#.#.#.#.#.#####.#.###########.#.#########.#.#.#.#
.#.#.#...#...#.#.#.#...#.......#.#.......#...#.........#.....#.#
.#.#.#.#.#.###.#.#.###.#########.#.#####.#.###########.#####.#.#
.#...#.#.#.#...#.#...#.#.....#...#.#...#...#.........#.....#.#.#
.#####.#.#.#.###.###.#.#####.#.###.#.#.#####.#.#####.#####.#.#.#
.......#...#.#.....#.#.......#...#.#.#...#...#...#...#.....#.#.#
.#.#######.#.#####.#.###########.#.###.#.#######.#.###.#######.#
.#.....#...#.......#.#.........#.#...#.#.......#.#.#...#.......#
.#####.#.#########.#.#.#######.#.#.#.#.#######.#.#.#.#######.###
.#.....#...#...#...#...#.....#...#.#.#.....#.....#.#.......#...#
.#.#.#####.#.###.#######.###.#######.#.###.#.#############.###.#
.#.#.#...#.#.#...#.......#.#.......#.#.#.#.#.#.........#...#...#
.#.#.#.#.#.#.#.#########.#.#######.#.#.#.#.###.#####.#.#.###.###
.#.#.#.#.#...#.#.....#...#.......#...#.#.#.....#...#.#.#...#...#
.#.###.#.###.#.#.###.#.###.#####.#####.#.#########.#.#####.###.#
.#.#...#...#.#...#.#.#.#...#.....#...#.....#.......#.....#...#.#
.#.#.#####.#######.#.#.#.#########.#.#####.#.#####.#####.###.#.#
.#.......#.............#...........#.........#.........#.......#
################################################################
