16
...........#...#
##.#.#######.#.#
...#.#.....#.#.#
.#####.###.#.#.#
.#G..#.#.#...#.#
.#.#.#.#.#####.#
.#.#.......#...#
.#.#######.#.###
...#.#...#.#...#
.###.#.#.#####.#
.#...#.#.....#.#
.#.#.#.#####.#.#
.#.#.#.....#...#
.#.#.#####.###.#
...#.....#..S#.#
################
