32
.........#.........#.....#.....#
.#########.###.###.#.#.###.#.#.#
...#.......#...#...#.#.....#.#.#
.#.#.#######.###.#######.###.#.#
.#...#.....#...#.#.....#.#...#G#
.#####.#.#####.#.#.###.###.###.#
.#.....#.#.....#.#...#.....#...#
.#.#####.#.#####.###.#######.###
...#...#.#.#...#...#.#.....#.#.#
####.###.#.#.#.###.#.#.###.#.#.#
...#.....#.#.#...#...#.#...#.#.#
.###.#####.#.#.#.#####.#.#.#.#.#
.#...#...#.#.#.#...#...#.#.#.#.#
.#.###.###.#.#.#####.###.#.#.#.#
.#.#.....#.#.#.#...#.#.#.#.#...#
.#.#####.#.#.#.#.#.#.#.#.#.###.#
.......#.#.#.#...#.....#.#.#...#
######.#.#.#####.#######.#.#.###
...#...#.#.....#.....#...#.#.#.#
.#.#.###.#####.#.#####.###.#.#.#
.#.#.....#...#.#.#...#.#...#.#.#
.#.#####.###.#.###.#.#.#####.#.#
S#.#.........#.....#.#...#...#.#
##.#.#######.#######.###.#.###.#
.#.#.#...#...#.#.....#...#...#.#
.#.###.#.#.###.#.#####.#####.#.#
.#.....#.#.....#...#.#.......#.#
.#######.#######.#.#.#.#######.#
.#.....#.......#.#.#.#...#.....#
.#.#.#########.###.#.###.#.###.#
...#...............#.......#...#
################################
