32
.......#.........#.......#.....#
.#####.#.#######.#.#####.#.#####
.#.....#.......#...#...#.#.....#
.#.#.#########.#####.#.#.#####.#
.#.#.#.....#...#.....#.#..S#...#
.#.###.###.#.###.###########.#.#
.#...#...#.#...#.....#...#...#.#
.###.###.#.###.#.###.#.#.#.#.###
...#.....#...#.#...#...#...#...#
##########.#.#.###.#######.###.#
.........#.#.#...#.#.....#.#...#
.#######.#.#.###.###.###.#.#.###
.......#...#...#.....#.#.#.#...#
.#####.#######.#######.#.#####.#
.#...#.#.......#.......#.#.....#
.#.#.#.#######.#.#####.#.#.###.#
.#.#.#.......#.#.....#.#...#...#
.#.#.#######.#####.###.#####.###
.#.#.......#.......#.....#.#...#
.#.#####.###########.###.#.###.#
.#...#.#...........#.#.....#...#
.###.#.#########.###.#.#####.###
.#.......#.....#.#...#...#...#.#
.#########.###.#.#.#######.###.#
...........#.#.#.#.........#...#
############.#.#.#############.#
.......#....G..#...........#...#
.###.#.#.#############.###.#.###
.#...#.#.#...#.......#.#.#.#...#
.#.#####.#.#.#.#####.#.#.#.###.#
.#.........#...#.......#.......#
################################
