16
...#...........#
.###.#########.#
...#.#...#...#.#
##.#.#.#.#.#.#.#
...#...#S#.#...#
.#########.#####
.#.......#.#...#
.#.#####.#.#.#.#
.....#...#.#.#.#
######.###.#.###
.......#...#...#
.#######.#####.#
.......#.#.....#
.#####.#.#.###.#
.....#.....#..G#
################
