16
.......#...#...#
######.#.#.###.#
.......#.#...#.#
.###.###.###.#.#
...#.#...#...#.#
.#.###.###.###.#
.#...#.#.#.#S#.#
####.#.#.#.#.#.#
.....#...#...#.#
.#######.#####.#
.........#.....#
.#########.###.#
.#G....#...#...#
.#.###.#.###.###
...#.....#.....#
################
