32
...........#...........#.......#
########.#.#.###.#####.#.#.###.#
.........#.#.#...#.....#.#...#.#
.#######.###.#.#########.###.###
...#.....#...#.........#.#.#...#
.#.#######.###########.#.#.###.#
.#.......#.....#.....#.....#..G#
.#######.#####.###.#########.#.#
...#...#.....#...#...#.......#.#
##.###.#.#######.###.#.#######.#
.#.#...#.......#.....#.#...#...#
.#.#.#########.#####.#.#.#.#.###
...#.........#.#.....#.#.#.#...#
.###.#######.#.#.#####.#.#####.#
.#.....#.....#.......#.#.....#.#
.#######.#####.#######.###.###.#
.......#.#...#...#...#...#.#...#
######.#.#.#.#####.#.#.#.#.#.###
...#...#.#.#.......#.#.#.#.#.#.#
##.#.###.#.#########.#.#.#.#.#.#
...#.#...#.....#...#.#.#.#.....#
.###.#.#######.###.#.###.#######
.......#.....#...#.#...#.......#
.#######.###.###.#.###.#######.#
.#...#...#.....#.#...#.#.....#.#
.###.#.#######.#.#.###.#.###.#.#
.....#.....#.#.#.#...#...#...#.#
####.#####.#.#.#.###.#####.###.#
.......#...#.#.#...#.#...#...#.#
.#######.###.#.###.#.#.#.###.#.#
.#S......#.........#...#.......#
################################
