64
.........#.....#.......#.............#...........#.#...........#
.#.#######.#.#.#.###.###.#.#########.#.#######.#.#.#.###.#####.#
.#.........#.#.#.#...#...#.#.....#...#.#...#...#...#.#.#...#...#
.#####.#####.#.#.#.###.###.#.###.#.#####.#.#.#####.#.#.###.#.###
.#...#...#...#.#.#.....#...#...#.#.......#...#...#.#.#...#.#...#
##.#.#####.#####.#######.#####.#.#############.###.#.#.#.#.###.#
...#.....#...#...#...#.#...#.#.#.........#.........#.#.#.#.#...#
.#######.###.#.###.#.#.###.#.#.#####.###.#.#########.#.#.#.#.###
.#.....#.....#.....#...#...#.#.#...#.#...#.#.......#.#.#.#.#.#.#
.###.#####.###########.#.###.#.#.###.#.###.#####.###.#.#.#.#.#.#
...#.......#.....#...#.#.#...#.#.#...#.#...#...#...#.#.#.#.#.#.#
.#.#.#######.#.#.#.#.#.#.#.#.#.#.#.#####.###.#.###.#.###.#.#.#.#
.#.#.#...#...#.#.#.#...#.#.#.#.#.#.....#.....#...#.#...#.#.#...#
##.#.#.###.###.###.#####.###.#.#.#####.#########.#.###.#.#.###.#
...#...#...#...#...#...#...#.#.#...#.#.....#.........#.#.#.#.#.#
.#######.###.#.#.###.#.###.#.#.#.#.#.#.#####.#########.#.#.#.#.#
...#...#.#...#.#.#.#.#...#.#.#.#.#...#...#.......#.......#.#...#
.#.#.#.#.#.#####.#.#.###.#.#.#.#.###.###.#.#######.#######.#.###
.#.#.#...#.......#.#...#...#...#.#...#.#...#...#...#.#.....#.#.#
##.#.#############.###.#####.###.#.###.#####.#.#.###.#.#####.#.#
...#.#....G......#...#...#.......#.#.....#.#.#...#...#...#.#.#.#
.###.#.#.#######.###.###.#########.###.#.#.#.#######.###.#.#.#.#
...#.#.#.#...#...#.....#.....#.........#...#.#.....#.#...#.....#
.#.#.#.###.#.#.###.#########.#########.#####.#.###.#.#.#########
.#.#.#.....#.#.#.........#...#...#...#.#.......#.....#.........#
.#.#.###.###.#.###.###.###.###.#.#.#.###.###########.#########.#
.#.#...#.#...#...#...#...#.#...#...#.....#.......#...........#.#
.#.###.###.#####.###.###.#.#.#############.#####.###########.#.#
.#...#...#...#.#.#...#...#.#...........#...#.......#.#...#...#.#
.#.#.###.###.#.#.#.###.#.#.###########.#.#########.#.#.#.#.###.#
.#.#.#.#.#...#.#.#...#.#.#...........#.#.#...#...#.#...#...#...#
.#.#.#.#.#.###.#.###.#.#####.#########.#.#.#.#.#.#.###.#####.#.#
.#.#...#...#...#...#.#.....#.#.....#...#...#.#.#.#...#...#...#.#
.#.###########.###.#####.#.#.#.###.#.#######.#.#.###.#.###.###.#
.#.#.........#.#...#.....#.#.....#.#.....#.#...#.#.#.#.#...#.#.#
.#.#.#####.#.#.#.###.#####.#######.#####.#.#####.#.#.###.###.#.#
.#...#.#...#.#.#.#.....#...#...........#.#.....#.#.......#...#.#
.#####.#.###.#.#.#.###.#.###.#####.#####.#####.#.#########.###.#
...#...#.#.....#.#.#...#.#.#.#...#.#...#.#.....#.....#...#...#.#
##.#.###.#####.#.###.###.#.#.#.#.###.#.#.#.###.#####.#.#.#.#.#.#
.#.#...#...#...#...#.#.#...#...#.....#...#...#.....#.#.#.#.#...#
.#.###.###.#######.#.#.###.###############.#.#####.#.#.###.#####
.#...#...#...#.....#.#.............#.....#.#...#...#.#.........#
.###.#.#.###.#.#####.#########.#####.###.#.###.#.###.###.#######
.....#.#...#.#.#.....#...#.....#...#...#.....#.#...#...#.#.....#
.#########.#.#.###.###.#.###.###.#.###.#####.#.###.###.###.###.#
.....#...#.#...#...#...#...#...#.#...#.#...#.#...#...#...#.#...#
####.#.#.#.#####.#.#.#####.#####.#.###.#.#.#####.#.#####.#.#.#.#
...#...#.#.......#.#...#...#.....#.#...#.#.......#.#...#...#.#.#
.#.#####.###.#########.#.###.#####.#.###.#########.#.#.#.###.###
.#.....#...#...........#...#.....#.....#...#.#.....#.#.#...#...#
.###.#####.#.#############.#####.#########.#.#.#####.#.#####.#.#
...#.#.....#.......#...#.#...#...#.....#...#...#.#S..#.#...#.#.#
##.#.#.###########.#.#.#.###.#.###.###.#.###.###.#####.#.#.#.#.#
.#.#.#.#.......#.....#.....#.....#.#...#...#...#...#...#.#.#.#.#
.#.#.#.#####.#.#################.#.#.#####.###.###.#.###.#.###.#
...#.#.#.....#...#...#.......#...#.#...#...#.#.....#.....#.#...#
.###.#.#.#######.#.#.#.#####.#####.###.#.###.#####.#######.#.###
...#.#...#.....#...#.#.#...#.#...#...#...#...#.....#.....#...#.#
##.#.#####.#.#######.#.###.#.#.#.###.#####.#.#.#######.#######.#
...#.#...#.#.......#.#...#.#.#.#...#...#.#.#.#.#.....#.....#...#
.###.#.#.#.#######.#.###.#.#.#.###.###.#.#.#.#.#.###.###.#.#.#.#
...#...#.........#.......#.....#.......#...#.....#.......#...#.#
################################################################
