32
.....#...#.....#.....#....G....#
.###.#.#.###.#.###.#.#######.#.#
.#.#...#.....#.....#...#.....#.#
.#.###################.#.#####.#
.#.#...........#.#...#...#.#...#
.#.#.###.#####.#.#.#.#####.#.###
.#.#...#.#.....#...#.#.......#.#
.#.###.#.###.#######.#.#######.#
.#.....#...#.........#.....#...#
.###.#####.#########.#####.###.#
...#.#...#.........#...#.#.....#
.#.#.###.#########.###.#.#####.#
.#.#...#.#.......#...#.......#.#
##.###.#.#.#####.###.#######.#.#
...#.#...#.#...#.....#.......#.#
.###.###.#.#.#.#######.#######.#
.#.....#.#...#.#.........#.#...#
.#.###.#.#####.#.#######.#.#.###
.#...#...#.#...#.#...#.....#...#
.###.#####.#.#.###.#.#########.#
.#.........#.#.#...#.........#.#
.###########.#.#.#########.#.#.#
.#.......#...#.#.#.....#.#.#.#.#
.#.#####.#.###.#.###.#.#.#.###.#
.#.#...#.#...#.#.....#.#.#.#...#
.#.#.###.#.#.#.#######.#.#.#.###
...#.#S..#.#.#.#.....#.#.#...#.#
####.#####.#.#.###.###.#.#####.#
.......#...#.#.....#...#.......#
.#######.###.#######.#########.#
...........#...................#
################################
