16
..G............#
.###############
.#.....#.......#
.#.###.#.#####.#
.#...#.......#.#
.#.###########.#
...#...........#
####.#.#######.#
.....#.#..S#...#
.#.#####.###.###
.#.#...#.#.#...#
.###.#.#.#.###.#
.....#.#.#...#.#
.#####.#.#.#.#.#
.....#...#.#...#
################
