16
.....#.......#.#
####.#.#####.#.#
.....#...#S#.#.#
.###.###.#.#.#.#
...#...#.#...#.#
##.###.#.#####.#
...#...#...#...#
.###.#####.#.#.#
G#...#...#...#.#
.#.###.#.#####.#
.#.#...#...#...#
.#.#.#####.#.###
.#.#.#...#.#.#.#
.###.###.#.#.#.#
.........#.....#
################
