8
..S#...#
.###.###
...#...#
##.###.#
.#.#...#
.#.#.#.#
....G#.#
########
