64
.........#...........#.......#.......#.........#.......#.......#
.#######.#.###.#######.#####.#.#.###.#.#######.###.#.###.#.###.#
...#...#...#.#.#.....#...#...#.#...#...#.....#...#.#.....#...#.#
##.#.#.#####.#.#.###.###.#.###.###.#######.#.###.#########.#.###
.#.#.#...#...#...#.#...#.#.....#.#...#.....#.#.#.........#.#...#
.#.#.#.#.#.#######.###.#.#######.###.###.###.#.#########.#####.#
.#.#.#.#.#...........#...#.......#.#...#.#.....#.......#.#...#.#
.#.###.#.#######.#########.#####.#.###.#.#####.#####.#.#.#.#.#.#
.......#.......#...#.......#.....#...#.#.....#.....#.#.#...#.#.#
.#############.###.#.###.#####.###.###.#.###.#####.###.#####.#.#
...#.......#.#...#.....#.....#.....#...#...#.#...#.....#...#G..#
####.#####.#.###.#.#########.#####.#.#####.#.#.#.#####.###.###.#
.....#...#.#.....#.#.......#.#.#...#.....#.#...#.....#.#...#...#
.#####.###.#.#######.#####.#.#.#.#######.#.#########.#.#.###.###
.#...#.....#.#.......#.....#.#.....#.....#.#.......#.#...#...#.#
.#.#.#.#####.#####.#######.#.#######.#####.#####.#.#.###.#.###.#
.#.#...#...........#.....#...#.....#.....#.......#.#...#.#.....#
.#####.#########.###.###.###.#.###.#.###.#######.#####.#######.#
.....#.....#.....#...#.#.#...#.#...#...#...#.....#.....#...#...#
.###.#####.#######.###.#.#####.#.#########.#.#####.###.#.#.#.###
...#.#...#...#.....#.......#...#.#.......#.#.#...#.#.#.#.#.#.#.#
.###.#.#####.#.#####.#####.#.###.###.###.#.#.#.#.#.#.#.#.#.#.#.#
.#...#...#.....#...#.#...#...#.#.....#.#.#.#.#.#.#.#.#.#.#.#...#
.#.#####.#.#####.#.###.#.#####.#######.#.#.#.#.###.#.#.#.#.###.#
.#.....#.....#...#.....#.....#.....#.....#.#...#...#...#.#.....#
.#####.#######.#############.#.###.#.#####.#####.#######.#######
.....#...#.......#.........#.#...#.#...#.....#...#.....#.#.....#
####.###.#.#######.#######.#.###.#####.#####.#.###.###.#.#####.#
...#...#.#...#.....#.......#.#...#...#.......#.....#...#...#...#
.#####.#.#.###.#####.#######.#.###.#.###############.#.###.#.#.#
.#.....#.#.#...#...#.......#.#.#...#.....#.#.........#.#.#.#.#.#
.#.#####.#.#.###.#.#######.#.#.#.###.###.#.#.#.#######.#.#.#.###
.#.....#...#.....#.....#.#...#...#...#.#.#.#.#...#...#...#.#...#
.#####.###############.#.#####.###.###.#.#.#.###.#.#####.#.###.#
...#...#.........#.#...#.....#...#...#.#.#...#...#.#.....#...#.#
.#.#.#########.#.#.#.###.###.###.###.#.#.#.###.###.#.#######.#.#
.#.#.#.........#...#.#...#.....#...#.#.#.#.#.#.#...#.#...#.#...#
##.#.#.###########.#.#.#.#########.#.#.#.#.#.#.###.#.#.#.#.###.#
...#...#...........#.#.#.#.....#...#.#...#...#...#...#.#.#...#.#
.#####.###########.#.#.#.#.###.#.###.#.#######.#.###.#.#.###.#.#
.......#.........#.#.#.#...#.#...#...#.#.....#.#...#...#.....#.#
.#######.#.#####.###.#.#####.#####.###.#.###.#####.#.#######.#.#
.#.......#.#...#.....#.#.....#...#...#...#...#.....#.#.....#.#.#
.#.#######.#.#.#######.#.###.###.###.#####.###.#######.###.###.#
.#.....#...#.#.#...#...#.#.......#.#.....#...#.#.....#...#...#.#
.#####.#####.#.###.#.###.#.#####.#.#####.###.#.#.###.###.###.#.#
.#.....#.....#...#.#.....#.#...#...#...#...#.#.#.#.#...#...#...#
##.#####.#####.#.#.#######.#.#.#.###.#.###.#.#.#.#.#.#.###.#####
...#.....#...#.#.#.........#.#.#.#...#.....#.#.#...#.#...#.#...#
.###.#####.#.###.#.#########.#.###.#########.#.#.###.###.#.###.#
.#...#.#...#..S#.#...#...#...#...#.........#.#...#...#...#...#.#
.#.###.#.#######.#.###.#.#.#####.#########.#.#####.#.#######.#.#
.#.....#...#.....#.#...#.#.#.........#.....#.#...#.#.#.....#...#
.#####.###.#.#.###.#.###.#.#########.#.#####.#.#.#.#.#.#.#####.#
.#.....#...#.#...#.#...#...#.......#...#...#.#.#...#.#.#.......#
.#.#####.#######.#####.###.#.#####.#####.#.#.#.#####.#.#########
.#...#...#.......#.....#...#.#...#.....#.#...#.#.....#.#...#...#
.###.#.#####.#####.###.#####.#.#.#####.#.#####.#######.#.#.#.###
...#.#.......#...#...#.#...#...#.#.....#.......#.....#...#.#...#
.#.#.#########.#.#.#.#.#.#.#####.#.#######.#####.###.#####.#.#.#
.#.#.#...#.....#.#.#.#.#.#.#...#.#...#...#.#.....#.......#.#.#.#
.###.#.#.#.#.#####.#.###.#.#.#.#.###.#.#.###.#####.#######.###.#
.....#.#...#.......#.....#...#.....#...#.........#.............#
################################################################
