32
.........#.......#.....#.#.....#
.###.###.#.#####.#.###.#.#.#.#.#
...#.#...#.#...#.#...#...#.#.#.#
.###.#.###.###.#.###.#####.#.#.#
.#...#.#.#.#...#...#...#...#.#.#
.#.###.#.#.#.#####.#.#.#.###.#.#
.#.#.....#.#.....#S#.#...#...#.#
.#.#######.#.###.#####.###.#####
.#.....#...#.#...#...#...#.....#
######.#.###.#.#.#.#.###.#####.#
.......#...#.#.#...#...#.....#.#
.#.#######.#.#.#######.#####.#.#
.#.#...#...#.#.#.....#...#...#.#
.###.#.#.#####.#.###.###.#####.#
.#...#.#.#.....#...#.......#...#
.#.###.#.###.#####.#######.#.#.#
.#.#.#...#...#...#...#...#...#.#
.#.#.#####.###.#.#####.#.#####.#
.#.#.........#.#.#.....#...#...#
.#.#########.#.#.#.#######.###.#
.#.........#...#.#.......#...#.#
.#########.#.###.#####.#####.#.#
...#...#...#...#.......#...#.#.#
.#.#.#.#.#########.#####.#.#.#.#
.#...#.#.#.......#.#.....#...#.#
.#####.#.###.###.###.#########.#
.#.....#...#...#.....#...#...#.#
.#.#######.###.#######.#.###.#.#
.#.#.....#...#.....#...#.....#G#
.###.#.#####.#####.#.#.#######.#
.....#.............#.#.........#
################################
