32
...#.......#...#...#.....#...#.#
.#.#.#.#####.#.#.#.#.###.#.#.#.#
.#.#.#...#...#.#.#...#...#.#...#
.#.#.###.#.###.#.#####.###.#####
.#...#.#.#.#.#.....#...#.......#
.#####.#.#.#.#######.###.#####.#
.......#...#.....#...#.#.#...#.#
######.#########.#.###.#.#.#.#.#
.......#.......#.#.#...#...#.#.#
.#########.###.#.#.###.#.#####.#
.#.........#.#.#.#.#...#.#.....#
.###.###.###.#.#.#.#.###.#.#####
...#...#.#...#.#.#.#.....#.....#
##.###.#.#.#.#.#.#.#.#########.#
...#...#.#.#...#.#.#.#S#.....#.#
.#######.#.#####.#.###.#.###.#.#
.........#...#...#.....#.#...#.#
############.###.#######.###.#.#
...........#...#.#.........#...#
.#####.#######.#.#.#######.###.#
.#.....#.....#.#.#.#.....#.#.#.#
.#####.#.###.#.#.#.#.###.#.#.#.#
.#...#.#.#.#...#...#...#.#.#...#
.#.#.#.#.#.#####.#####.###.#.###
...#.#.#.#...........#.#...#...#
.###.###.#.#########.#.#.#####.#
.#.#.....#...#.....#...#.#...#.#
.#.###########.###.#.###.#.#.#.#
...#...........#.#.#.#...#.#.#.#
##.###.#########.#.###.###.###.#
......G#...............#.......#
################################
