64
..G..........#...#.....#...#.....#...........#.#...........#...#
.#########.#.###.#.###.#.#.#####.#.#.#######.#.#.###.#####.#.#.#
.#.....#...#.#...#.#.#...#.#...#...#.#...#...#.#.#.#.....#.#.#.#
.#.#####.###.#.###.#.#####.#.#.#.###.#.#.#.###.#.#.#####.#.#.#.#
.#.....#.#...#.#...#.....#...#.#...#...#.#...#.......#...#.#.#.#
.#####.#.#.###.#.###.###.#####.#########.###.#.#######.#.###.#.#
.......#.#.....#.#.....#.....#.........#...#.#...#.....#.#...#.#
.#######.#####.#.#########.###########.#.#.#.#####.###.###.###.#
.#.....#.#...#.#.#...#...#.#.........#.#.#.#.......#...#.....#.#
##.###.#.#.#.#.#.#.#.#.#.#.#.#.#####.#.#.#.###.#########.#####.#
...#.....#.#.#.#.#.#.#.#.#...#...#...#.#.#.#...#.....#.....#...#
.#######.#.#.###.#.#.#.#.#.#####.#.###.#.#.#.###.###.#.#####.#.#
...#...#.#.#...#...#...#.#.#...#.#.#...#.#.#...#.#.#...#.#...#.#
.#.#.#.###.###.#########.#.#.#.#.###.###.#.#####.#.#####.#.###.#
.#...#...#.#.#...#.....#.#.#.#.#...#...#.#...............#.#...#
.#######.#.#.#.#.###.###.#.###.###.###.#.#################.#.###
.#.....#.....#.#...#...#.#...#...#.....#...#...#.......#...#...#
.#####.#######.###.###.#.###.#.#.###########.#.#.#####.#.#####.#
.#.....#.....#...#...#.#...#.#.#.............#...#.....#.....#.#
.#.#.###.###.###.###.#.###.#.###.###.#############.#########.###
...#.#...#.#.....#.#.....#.#...#.#...#.........#...#.......#...#
##.###.###.#######.#####.#.###.###.###.#######.#.###.###.#.###.#
...#...#.....#...#.....#.#...#.....#...#.......#...#...#.#.....#
.###.#######.#.#.#.###.#.###.#######.###.#####.###.###.#.#####.#
...#.......#...#.#.#...#...#.#.....#...#.....#.#...#...#.....#.#
##.#######.#####.#.#.#.###.#.#.#.#####.#####.###.#####.#####.#.#
.#.#.....#.....#...#.#...#.#.#.#.....#...#.#...#.....#.#.....#.#
.#.#####.#####.###.#.#####.#.#####.#.###.#.###.#####.#.#.#######
.#.........#.#...#.#.#.....#.....#.#...#.#...#...#...#.#.......#
.#########.#.###.###.#.#########.#.###.#.#.#.###.#.###.#######.#
.#.........#...#...#.......#...#.#...#.#.#.#...#.#...#.#...#...#
.#.#########.#####.#######.###.#.#.###.#.#.#.###.###.#.###.#.#.#
...#.............#.......#.....#.#.#S#...#.#...#.#...#...#.#.#.#
.###.###########.#######.#######.###.#.###.###.#.#.#####.#.#.#.#
.#.#.#...#.....#.......#.......#.....#.#...#...#.#...#...#.#.#.#
.#.#.###.#.###.#####.#.#######.#######.###.#.###.###.#.###.#.#.#
.#.......#.#.....#...#.....#.....#...#...#.#.#.....#.#...#.#.#.#
.#########.#####.#.#######.#.###.#.#.###.#.#.#.#####.###.#.#.#.#
.........#...#...#.#...#...#...#...#...#.#.#.#...#...#.#.#.#.#.#
########.###.#.###.#.#.#.#####.#######.#.###.###.#.###.#.#.#.#.#
.......#...#.#.#...#.#.....#...#...#...#.......#.#...#.#.#.#.#.#
.#########.#.#.###.#########.###.###.#########.#.###.#.#.#.#.###
.#...#...#.#.#...#.#.......#...#.#...#.#...#...#...#.#.#.#.#...#
.#.#.#.#.#.#.###.#.#.#####.#.#.#.#.###.#.#.#.#####.#.#.#.#.###.#
...#...#.#.#.#.....#...#.#.#.#.#...#...#.#.#.#...#...#.......#.#
.#######.#.#.#######.#.#.#.#.#.#.#####.#.#.#.#.#.###########.#.#
...#...#.....#.....#.#.#...#.#.#.......#.#...#.#...#.......#.#.#
##.###.#######.###.###.#.###.#.#######.#.#####.###.###.###.###.#
.#.#...#.......#.#...#.#.#...#.....#.#.#.#.....#.#...#.#.#...#.#
.#.#.###.#######.###.#.#.#.#######.#.#.#.#####.#.###.#.#.###.#.#
.#.#...#.#.#.......#...#.#.#.......#...#.....#.#.....#.#...#.#.#
.#.###.#.#.#.#.#########.###.#######.#######.#.###.###.###.#.#.#
.#...#.#.#.#.#.........#...#.#.#.....#...#...#...#.#.....#.#...#
.###.#.#.#.#.#########.###.#.#.#.#####.#.#.#####.#.#####.#.###.#
.......#.#.#...#.....#.#.....#.....#...#.#.....#.#.......#.#...#
.#######.#.#.###.###.#.#.#########.###.#.#####.#.#########.#.###
.#...#...#...#...#...#...#.......#...#.#.....#.#...#.......#...#
.###.#.#######.###.#.#####.#####.###.###.###.#.###.###.#######.#
.....#.........#.#.#.#.....#.....#.....#...#.#.#...#...#...#...#
####.###########.#.#.#.#####.###.#####.###.#.#.#.###.###.#.#.###
.#...#.........#.#.#.#...#...#...#...#.....#.#.#.#.....#.#.#...#
.#.#####.#####.#.#.#####.#.#######.#.#########.#.#.###.#.#.###.#
.........#.......#.......#.........#.............#...#...#.....#
################################################################
