16
...#...#.#...#S#
.#.#.#.#.#.#.#.#
.#...#.#...#.#.#
.#####.#####.#.#
...#.........#.#
##.#######.###.#
...#...#.#.#...#
.###.#.#.#.#.###
.....#.#.#.#.#.#
######.#.#.#.#.#
.......#...#.#.#
.#######.###.#.#
...#.......#.#.#
.#.#########.#.#
G#.............#
################
