32
.......#...#.........#...#.....#
.#####.#.#.###.#####.#.###.###.#
.#...#.#.#.....#...#.#.....#...#
.#.#.###.#######.###.#####.#.#.#
.#.#.#S#...#.#...#...#...#.#.#.#
.#.#.#.###.#.#.#.#.###.#.###.#.#
.#.#...#...#...#.#...#.#.....#.#
.#.#####.#######.###.#.#########
.#...#...#.........#.#.....#...#
.###.#.#.#.#####.###.#.###.#.#.#
...#.#.#.#...#...#...#...#...#.#
.###.###.###.#.###.#########.#.#
...#...#.#...#.#...#.......#.#.#
.#.###.#.#.#####.###.#####.###.#
.#...#...#...#...#...#...#.#...#
.#.#########.#.###.###.#.#.#.###
.#...........#.....#...#...#...#
.#########.#.#######.#########.#
.....#.....#.....#...#.#.......#
##.###.#####.#####.###.#.#.###.#
...#...#...#.#.....#.....#.#...#
####.#.#.#.#.#.#####.#####.#.###
.....#.#.#.#.#.....#.#.#..G#.#.#
.###.###.#.#.#####.#.#.#.###.#.#
...#.#...#.#.#.....#...#.#...#.#
.#.###.###.###.#####.###.#.###.#
.#...#...#.....#.....#...#.....#
####.###.#############.#######.#
.......#.#.........#...#...#...#
.#######.#######.#.#.###.#.#.###
.................#...#...#.....#
################################
