8
G......#
.#####.#
.#.....#
.#.###.#
.#...#.#
.###.#.#
.#S..#.#
########
