64
.........#.......#.#...........#.#.........#...#...#..........G#
.#######.#####.#.#.#.###.#####.#.#.###.###.###.#.#.#.#####.#####
.#.....#.......#...#...#.#.......#...#.#.#...#...#.#...#.#.#...#
.#.###.#########.#####.#.#.#########.#.#.###.#.###.###.#.#.#.#.#
.#.#.#.#.......#.#...#.#.#.#.....#...#.#.....#...#...#.#.#.#.#.#
.#.#.#.###.###.#.#.#.#.#.###.###.#.###.#####.#####.###.#.#.#.#.#
...#.#...#.#...#.#.#...#.....#...#.#.#.....#.......#...#.#...#.#
.###.###.#.#.###.#.###########.###.#.#####.#.#####.#.###.#####.#
...#...#.#.#.....#.#...#...#...#...#.#.....#.#...#.#.#.....#...#
##.###.#.###.#####.#.#.#.#.#.###.###.#.#####.#.#.#.#.###.#.#.#.#
.#.....#...#...#.#.#.#.#.#...#...#...#...#...#.#.#.#...#.#.#.#.#
.#####.###.###.#.#.###.#.###.#.###.#####.###.#.#.#####.#.#.#.###
.....#...#...#...#.#...#.#...#.#.......#...#.#.#.....#.#.#.#...#
####.###.###.###.#.#.###.#####.#######.###.#.#.###.###.#.#####.#
...#.......#...#.#.#...#.#.....#.......#...#.#...#.#...#.#.....#
.#.#########.#.###.###.#.#.#####.#####.#.###.###.#.#.###.#.###.#
.#.........#.#.........#...#.....#.....#.#...#...#...#...#.#...#
.#########.###########.#########.#######.#####.#######.#.#.#.###
.#.......#.........#...#...#...#.#.......#.....#.....#.#.#.#.#.#
.#.###.#.#########.#.###.#.#.#.#.#.#####.#.#######.#.#.#.#.#.#.#
.#...#.#...#...#...#...#.#...#...#.....#.#.....#...#...#.#.#.#.#
.#####.###.#.#.#.#####.#.#######.#####.#######.#.#.#####.#.#.#.#
.......#.#.#.#.#.....#...#.....#.#...#.#.......#.#.#...#.#.#...#
########.#.#.#######.#####.###.#.###.#.#.#######.###.#.#.#.###.#
.......#.#.#.#.....#...#...#.#.#...#.#...#.......#...#.#.#.#.#.#
.#.###.#.#.#.#.###.###.#.###.#.###.#.#####.###.###.###.#.#.#.#.#
.#.#...#.#.#...#.#...#...#...#...#.#.......#.#.......#.#.#.#...#
.#.#.###.#.###.#.###.#####.#####.#.#######.#.#########.#.#.#.###
.#.#...#.#...#.....#.......#.....#.......#.......#.....#.#.#.#.#
##.###.#.###.###.#######.#.#.###########.#########.#.#####.#.#.#
...#.#...#...#...#.....#.#.#S#.....#...#...........#.#.....#...#
.###.###.#.#######.###.#.#######.#.#.#.#########.#####.#######.#
...#.....#.#.......#.#.#.......#.#...#.....#.....#...#.#.....#.#
##.#.#####.###.#####.#.###.###.#######.###.#.#####.#.#.#.###.#.#
...#.#...#.....#.....#...#.#...........#...#.#...#.#.#.#.#...#.#
.#####.#.#######.###.###.#.#.###########.###.#.#.#.#.#.#.#.###.#
.......#.....#...#.#.#.#.#.#...#.....#...#...#.#.#.#...#.#.#...#
.#########.#.###.#.#.#.#.#.###.#.###.#.###.###.#.#.#####.###.###
...#...#...#.#...#...#.#.#...#.#.#...#...#.#...#.#.#.........#.#
.###.#.#.###.#.#####.#.#.###.###.#.#####.#.#.#.###.#.#######.#.#
.#...#...#.#.#.....#...#...#.....#.#...#.#...#.#...#.#.....#...#
##.#######.#.#.###.###.###.#####.#.#.#.#######.#.#####.###.###.#
...#.......#.#.#...#.#...#.....#.#...#...#...#.#.......#...#...#
.###.#####.#.###.###.#.#######.#########.#.#.#.#########.#.#####
...#.....#.#...#...#...#.....#.........#.#.#...#.......#.#.#...#
.#.#.###.#####.###.#.###.#.###########.#.#.#####.#####.#.###.#.#
.#.#...#.....#.#...#...#.#.......#...#.#...#.....#...#.#.....#.#
.#.###.#####.#.#.#.#####.#####.#.#.#.#.#####.#####.#.#.#######.#
.#.#.#.#...#.....#.#.....#.....#.#.#...#...#.#...#.#...#.......#
##.#.#.#.#.#########.#####.#######.#####.#.#.#.#.#.#####.#####.#
...#.#.#.#.#.......#.....#...#.....#.....#.#...#.#.#.....#...#.#
.###.#.###.#.#####.#####.###.#.#####.#####.#####.#.#####.#.###.#
.#...#.....#...#.#...#...#...#.#.....#...#.#.....#.......#.#...#
.###.###.#####.#.#.###.###.#.#.###.###.###.#.#############.#.###
...#.....#.....#.#.......#.#.#.....#.......#...#...........#...#
.#.#######.#####.#########.#.#######.#######.#.#.#######.#####.#
.#.......#...#.........#...#.#...#...#.....#.#.#.......#.....#.#
.#######.###.#.#.#####.#.#####.#.#.###.#####.#.#######.#####.#.#
.....#...#...#.#.....#.#.#...#.#...#.........#.....#...#...#...#
####.#.###.###.#####.###.#.#.#.###########.#######.#.###.#######
...#.#...#...#.#...#.#...#.#...#.........#.#...#...#...#.....#.#
.#.#.###.###.###.#.#.#.###.#########.###.###.#.#.#####.###.#.#.#
.#.....#.........#...#...............#.......#...#.........#...#
################################################################
