64
.................#...#.........#...............................#
.#####.#########.#.#.#####.###.###.###########################.#
.....#.#.......#...#.....#.#.#.#...#...............#...........#
######.#.###.###########.#.#.#.#.#.#.#############.#########.###
.......#.#...#.........#.#.#.....#.#...#...#.....#.........#.#.#
.#######.#.#.#.#######.#.#.###########.#.#.###.###########.#.#.#
.#.....#.#.#.#.#.....#...#.#...........#.#...#...#.....#...#.#.#
.###.#.###.#.#.###.#.#####.#.###########.###.#.#.#.###.#.###.#.#
...#.#.....#.#...#.#.....#...#.......#...#.#.#.#...#.#.#.#.....#
.#.#.###########.#.#####.###.###.###.#.###.#.#.#####.#.#.#######
.#.#...........#...#...#...#G....#.#.#.#...#.#.......#.#.......#
.#.#.#######.#######.#####.#######.#.#.#.###.###.#####.#######.#
.#.#.#.#...#.#.......#.....#.........#.#.......#.#...#.......#.#
##.#.#.#.#.#.#.#.#.###.#####.#######.#.#######.###.#.#.#####.#.#
...#.#...#.#...#.#.#...#.....#.....#...#...#.......#.#...#...#.#
.###.#####.#####.#.#.#####.###.###.#####.#.#########.###.#.#.#.#
.#.........#.....#.#.#...#...#...#.#...#.#.#.....#.#...#.#.#.#.#
.#########.#.#######.#.#.#######.#.#.#.#.#.#.###.#.###.###.#.#.#
...#.#.....#.#...#.....#.........#.#.#...#...#...#...#.....#.#.#
.#.#.#.#####.#.#.#.###############.#.#########.###.#.#######.#.#
.#.#...#...#...#...#.............#...#.......#.#...#.........#.#
.#.###.###.#########.###########.#####.###.###.#.#############.#
.#...#.....#...#.....#.......#...#.....#...#...#...#.........#.#
####.#######.#.#.###########.#.#####.###.###.#####.#.#######.#.#
.....#.......#.#.#...........#.....#...#...#.#.....#.#.....#...#
.#####.#######.#.#.#########.#####.#.#.#####.#######.#.###.#####
.......#...#...#.#.#.#...#...#...#.#.#...........#...#...#.#...#
.#######.#.#.###.#.#.#.#.#.###.#.#.#############.#.#####.#.#.#.#
.....#...#.#.....#.#...#...#...#.#.........#...#...#.....#...#.#
####.#.###.#######.#######.#.###.#.#######.#.#.#.###.#########.#
...#.#...#.#...#.....#...#.#...#.#.......#.#.#...#...........#.#
.#.#.###.#.#.#.#.###.#.#.#####.#.#.#######.#.#####.###########.#
.#.#...#.#...#.....#.#.#.....#.#.#.#.......#.#.....#...........#
.#####.#.###########.#.###.###.#.###.#####.###.#####.#########.#
...#...#...#.....#...#.#.#.#...#.....#...#.#...#...#.#.......#.#
.#.#.#####.#.#####.###.#.#.#.#########.###.#.###.#.#.#.#####.#.#
.#.#...#.#.#.....#.......#.#.....#.......#.#...#.#.#.#...#...#.#
.#.###.#.#.#.###.#########.#####.#.#####.#.###.#.###.###.#.###.#
.#.#...#...#.#...#.#.......#.....#...#.#.#...#.#...#.#...#.....#
##.#.###.#####.#.#.#.#######.#######.#.#.###.#.###.#.#####.#####
...#...#.#.....#...#.#.......#.......#.#.....#...#.#.....#.....#
.#####.#.#.#.#######.#.#########.#####.#########.#.#####.#####.#
.#...#.#.#.#...#.....#.#.......#...............#.......#.#.....#
.#.#.#.#.#.###.#.#####.#.#####.###############.#######.#.#.#####
...#...#.#.#...#...#...#.#...#.#...........#...#...#...#.#.#...#
.#######.###.#####.#.###.###.#.###.#########.###.###.###.#.###.#
.#...#.......#.....#.#...#...#...#.#...#.........#...#...#.....#
.#.#.#########.#.###.#.###.#####.#.#.#.#.#########.###.#######.#
.#.#...........#.#...#...#.....#.#.#.#.#...#.........#...#...#.#
.#.###########.###.#.###.###.#.#.#.#.#.###.#.###########.#.#.###
.#...#.....#...#...#...#.....#.#.#...#.....#.#.....#...#...#...#
.###.#####.#.###.#####.#######.#.###########.#.###.#.#.#######.#
...#...#...#.#...#.#.....#.....#.......#.....#...#.#.#.........#
##.###.#.###.#.###.#.#####.###########.#.#####.#.#.#.#########.#
.#.....#.....#.#.....#.....#...#...#.#...#...#.#.#.#.#.#.......#
.#######.#####.#.#####.#####.#.#.#.#.#####.#.###.###.#.#.#######
...#.....#...#.#.#...#.......#.#.#...#.....#.....#...#.....#...#
.#.#.#######.#.#.#.###########.#.###.#.#.#####.###.#######.###.#
.#.#.#.......#.#...#.........#...#.#.#.#...#.#.#...#S..#.#.....#
.#.#.#.#####.#.#####.#####.#.#####.#.#####.#.#.#.#####.#.#####.#
.#...#...#.#.#.......#.....#.#...#...#.....#...#.....#.#...#...#
.#######.#.#.#########.#######.#.#.###.#####.#####.###.#.#.#.###
.........#...........#.........#.......#.........#.....#.#.....#
################################################################
