8
.....#.#
##.#.#.#
S#.#.#.#
.#.#.#.#
.#.#.#G#
.#.#.#.#
...#...#
########
