32
...........#.........#.....#...#
.#########.#.#####.#.###.#.#.#.#
.......#...#...#.#.#.....#.#.#.#
.#####.#.#####.#.#.#######.#.#.#
...#G..#.#...#...#.....#.#...#.#
.###.###.#.#####.#####.#.#####.#
.#...#...#...#...#...#.#.....#.#
##.#####.###.#.###.#.#.#.#.###.#
...#...#.....#.#...#.#.#.#.....#
.###.#.#######.###.#.#.#######.#
.#...#.......#.....#.#.......#.#
.#.#########.#######.#######.###
.#.#.....#.#...#.......#...#...#
.#.###.#.#.###.#.#######.#.#.#.#
...#...#.#...#...#.......#.#.#.#
.###.###.#.#######.#######.###.#
.#...#.#.#...#.....#.....#.....#
.#.###.#.###.#.#####.###.#######
...#...#...#.#.........#...#...#
####.#####.#.#########.###.#.#.#
...#.......#...#.....#.#.#...#.#
.###.#######.###.###.#.#.#####.#
.#...#.......#.....#.#...#...#.#
.#.###.#.#####.#####.###.#.#.#.#
.#.#...#.#...#.#.#...#.#.#.#.#.#
.#.#.#####.#.#.#.#.###.#.#.#.#.#
...#.....#.#...#.#...#...#.#...#
.#####.#.#.#####.###.#####.###.#
.#...#.#.#.........#....S#...#.#
.#.#.###.#########.#########.#.#
...#.............#...........#.#
################################
