16
.....#......G#.#
.###.#.#.###.#.#
.#.#.#.#.#.#.#.#
.#.#.#.#.#.#.#.#
S#.#.#.#.#.#.#.#
##.#.###.#.#.#.#
...#.....#...#.#
.#.#######.###.#
.#.......#...#.#
.#####.#####.#.#
.#.....#.....#.#
##.#.###.#####.#
...#.#...#...#.#
.#####.###.#.#.#
...........#...#
################
