8
..G....#
.#####.#
...#...#
##.#.###
...#...#
.#####.#
....S#.#
########
