64
.......#.......#...#...........#...............#.#.............#
.#.#####.#####.#.###.#######.#.#.###########.#.#.#.###.#######.#
.#.#...#.#...#S#.#...#.....#.#.#...#.....#...#.#...#...#...#...#
.###.#.#.#.#####.#.###.#####.#####.#.###.#.###.#####.###.###.###
.....#...#.......#.#...#...#.#.....#.#.....#.#.....#...#...#.#.#
.#############.###.#.#.#.#.#.#.#####.#######.#####.###.#.#.#.#.#
...#.........#.....#.#.#.#.#...#...#.......#.#...#...#.#.#.....#
##.#.#######.###.###.###.#.#####.#.#######.#.#.#.###.#.#.#######
...#.#.....#...#...#.#...#.....#.#.......#.#.#.#.......#.#.....#
.###.#.###.###.###.#.#.#####.#.#.#######.#.#.#.###########.###.#
.#...#...#...#.#...#...#.....#.#.#...#.....#.#.....#.........#.#
.###.#####.#.#.###.#####.#####.#.#.#.#######.#.#####.#########.#
.....#...#.#.#...#.#.....#...#.#...#.......#...#.....#...#...#.#
######.#.###.###.#.#.#.###.#.#######.#####.#####.#####.#.#.#.#.#
.......#...#.#...#...#.#...#...#...#.#...#.#.......#...#...#.#.#
.#########.#.#.#########.#####.#.#.###.#.#.#.#######.#######.#.#
.#...#...#.#.#.#.........#...#...#...#.#.#.....#.....#.#...#...#
.#.#.#.#.#.#.#.#.#.#######.#########.#.#.#######.#####.#.#.###.#
...#.#.#.#...#.#.#.....#.#.........#.#.#.......#...#.#...#.#...#
.###.#.#.#####.#.#####.#.#.#####.###.#.#######.###.#.#.###.#.###
.#.#...#.......#.#.....#...#...#.......#.....#.....#...#.#...#.#
.#.#############.#.#####.###.#.#############.#######.###.#####.#
...#.....#.....#.#...#.....#.#.....#.........#.....#.#.....#...#
##.###.#.###.###.###.#####.#.#####.###.#.#.###.###.#.#.###.###.#
.#.#...#...#.......#.....#.#.....#...#.#.#.#...#...#...#...#...#
.#.#.#####.#############.#.#####.###.#.#.###.###.#.#####.###.#.#
...#...#.....#...#.....#.#...#.....#.#.#.....#.#.#.....#.....#.#
.#####.#####.#.#.#.###.#.###.#.#####.#.#######.#.###.#########.#
.....#.....#...#...#.#.#...#.#.#.#...#.........#.#...#.....#...#
####.#####.#########.#.#.#.###.#.#.#######.#####.#####.###.#.###
...#...#...#.#.......#.#.#.#...#.#.....#...#.....#.....#.#.#.#.#
.#####.#.###.#.###.###.###.#.###.#####.###.#.#####.#####.#.#.#.#
.....#...#...#.#.#.....#...#.#.#.....#...#.#.............#.#...#
.###.#####.###.#.#######.###.#.#.###.###.#############.###.###.#
.#.#.......#...#.#...#.....#.#...#.....#.........#...#.#.....#.#
.#.###.#####.###.#.#.#.###.#.#####.###.#########.#.###.#.#####.#
.....#...#...#...#.#...#.#...#.....#...#...#.....#.#...#.......#
##.#####.#.###.#.#.#####.#####.#####.#####.#.#####.#.###########
.#.#.....#...#.#...#.....#.....#...#.......#.....#...#.........#
.#.#.###.###.#.#####.#.#.#.#####.#.#######.#####.#.###.#.#######
...#...#.#...#.....#.#.#.#...#...#...#.....#...#.#...#.#.#.....#
.#####.#.#.#######.###.#.###.#.#####.#.#######.#.###.#.#.#.###.#
.#.....#.#.....#.......#...#.#...#.#.#.........#.#...#.#...#...#
.#.#####.#####.###########.#.###.#.#.#########.#.###.#######.#.#
.#.#...#.....#.....#...#...#.#...#.#.......#...#...#.......#.#.#
.#.#.#.###########.#.#.#.###.#.###.#######.#.#####.#######.#.#.#
.#...#.........#...#.#.#.#...#.#.#.......#.#.#...#.#.....#...#.#
.#############.#.#####.#.###.#.#.#.#.#.###.#.###.#.#.###.#####.#
...#.......#...#.#.....#...#.#.#.#.#.#.#...#.....#.#...#.#.....#
##.###.#.#.#.###.#.###.###.#.#.#.#.#.###.#########.#####.#.#####
.#...#.#.#.#.....#...#.#.#...#.#...#.....#.......#.#...#.#.#...#
.###.#.#.#########.#.#.#.###.#.#.#########.#####.#.#.#.#.#.###.#
...#.#.#...........#.#.....#.#.#...#.......#...#...#.#.#.#.#...#
.###.###############.#######.#.###.#####.###.#.#####.#.#.#.#.#.#
.#...#...........#...#...#...#.#.......#...#.#.#.....#...#.#.#.#
.#.###.#########.#.###.#.#.###.#######.###.###.#.###.###.#.#.###
...#...#.......#.#.....#.#...#.....#.#.#...#...#...#...#.#.#...#
.#####.#.#####.#.###.###.###.#####.#.#.#.###.#.###.###.###.###.#
.......#...#...#...#...#...#.#...#.#.#.#.#...#...#.#.#...#.....#
########.#.#######.#####.###.#.#.#.#.#.#.#.#######.#.###.#####.#
...#.....#...#...#.#...#.......#.#.#...#.#.#.......#...#.....#.#
.###.#######.#.#.#.#.#.###########.#.###.#.#.#########.#####.#.#
...........#...#.....#.............#....G#.................#...#
################################################################
