16
.......#...#...#
.#.###.#.#.###.#
.#...#...#.....#
####.#########.#
.....#...#...#.#
.#####.#.#.#.###
.......#...#...#
.#############.#
.......#...#G..#
######.#.###.#.#
.....#...#...#.#
.###.###.#.###.#
.#.#.#...#.#.#.#
.#.#.#####.#.#.#
S#.........#...#
################
