64
.....#...#.#.........#...#...........#.....#.......#...........#
##.#.#.#.#.#.###.###.#.#.#.#######.#.#.###.#.###.#.###.#####.#.#
...#G..#...#.#...#.#...#.#...#.....#...#...#.#.#.#...#...#...#.#
.#####.#####.#.###.#####.###.#.#########.###.#.#.###.#####.###.#
...#.#.#.....#.#.#.....#...#.#.#...#.....#.....#...#.....#...#.#
##.#.#.#.#####.#.#.#.#####.#.#.#.#.#.#############.#####.###.#.#
...#.#.#.#.....#...#.#.....#.#.#.#.#.#.......#...#...#.#...#.#.#
.###.#.#.#.#.#####.#.#.#####.#.#.#.#.#.###.#.#.#.###.#.###.#.#.#
.#.....#.#.#.#...#.#...#.....#.#.#...#...#.#...#.....#.#...#.#.#
.#######.#.#.#.#.###.#########.#.#########.###########.#.###.#.#
...#.....#.#.#.#...#.........#.#...#.....#...#...............#.#
.#.#.#####.###.###.#########.#.###.#.###.#.#.#########.#######.#
.#.....#...#...#...#.....#.#.#...#...#.#.#.#.........#.#...#.#.#
########.###.###.#####.#.#.#.###.#####.#.#.#########.###.#.#.#.#
...#...#...#...#.....#.#...#.....#.#...#.#...#.....#...#.#.#...#
.#.#.#.#.#.###.#####.#.###########.#.#.#.###.###.#.###.#.#.#.###
.#...#.#.#...#.....#.#...........#.#.#...#.......#.#.#...#.#.#.#
.#####.###.#######.#.#.#####.###.#.#.#############.#.#####.#.#.#
.....#...#.#.......#.#.....#...#...#...#.......#.#.....#...#.#.#
####.###.#.#.#######.#####.###.###.###.#.#####.#.#.#####.###.#.#
.#...#.#.#.#...#...#...#.....#...#...#.#.#...#.#...#.....#.#...#
.#.###.#.#.#.###.#.###.#####.###.#.###.#.###.#.#####.#####.###.#
.#...#.....#.#...#.....#...#.#...#.#...#...#.#.......#.#.....#.#
.###.#######.#.#######.#.#.###.###.#.#####.#.#########.#.###.#.#
...#...#...#.#.......#.#.#...#.#...#.#...#.#.........#.#.#...#.#
.#.###.#.#.#.#######.#.#.###.#.#####.#.#.#.#.#####.#.#.#.#.###.#
.#...#...#.#.#...#...#.#...#.#.........#.#.#.....#.#...#.#.#...#
.###.#####.#.###.#.#######.#.#.#########.#.#####.#.#####.#.#.###
.#...#...#.#.#...#.........#.#...#.....#.#.#.....#.....#.#...#.#
##.#.###.#.#.#.#############.#####.###.#.#.###.#######.#.#####.#
...#.#...#.#.#.#...........#...#.....#.#.#...#.#...#...#.......#
.###.#.#.#.#.#.#.#########.###.#.#####.#.###.#.###.#.#########.#
...#.#.#.#...#...#.......#...#.#.#.....#.#...#.....#...........#
.#.#.#.#######.#####.###.#.###.#.#.#####.#.#######.#############
.#.#.#.......#.#.....#...#...#...#..S#.#...#.#.....#.........#.#
.#.#.#####.#.#.###.###.#####.#########.#####.#.#######.#####.#.#
.#.#.....#.#.#.....#.#...#.....#...#.#.........#.....#...#...#.#
.#.#####.#.#########.###.#.###.#.#.#.#.###########.#.#.#.#.###.#
.#...#...#.#...........#.#.#.....#...#.....#.......#.#.#.#.....#
.###.###.#.#.#####.#####.#.#########.#####.###.#####.#.#.#####.#
...#...#...#.#...#.......#.....#...#.#...#.....#...#.#.#...#...#
##.###.###.#.#.#.#############.#.###.###.#########.#.###.#.#####
.#...#.#...#.#.#.....#.....#.#.#...#.........#.....#...#.#.....#
.#.###.#.###.#.#####.#.###.#.#.###.#######.###.#.#####.#.#####.#
.#.#...#...#...#...#.#...#...#...#...#.....#...#.......#.....#.#
.#.#.###.#######.#.#.###.###.###.#.###.#####.###############.#.#
.#.#.#.#.#...#...#.#.....#.#...#.#.......#...#.......#...#.#.#.#
.#.#.#.#.#.#.#.###.#######.#.###.#########.###.#.###.#.#.#.#.#.#
...#.#...#.#.#...#.....#...#.#...#...#...#.#...#...#...#.#...#.#
.###.#####.#.###.#.#####.#.#.#.###.#.#.#.#.#.#####.#####.#####.#
...#.#.....#.....#.#.....#...#.#...#...#.#.#.....#.#...#.#.....#
.###.#.###########.#.#####.###.#.#######.#.#######.###.#.#.###.#
.#...#.......#...#.#.#...#.#...#.#.....#.#...#...#.#...#.#.#...#
##.###.#######.#.#.#.#.#.###.#.#.###.#.#.###.#.#.#.#.###.#.#.###
...#...#.......#.#...#.#...#.#.#.#...#.#...#...#...#.#...#.#.#.#
.###.###.#######.#.###.###.#.#.#.#.#######.#########.#.###.#.#.#
.......#...#.....#.#...#.....#.#.#.......#.......#.....#...#.#.#
.#########.#.#######.#########.#.###.###.###.#.###.#####.###.#.#
...#.......#.........#...#.....#...#...#...#.#.#...#.....#.#.#.#
##.#.#.#####.#########.#.#####.###.###.###.#.###.#####.###.#.#.#
.#.#.#.#...#.#.........#.#...#...#...#...#.#...#.#...#...#...#.#
.#.#.###.#.###.#########.#.#.#######.#####.###.#.#.#.###.#.###.#
...#.....#.............#...#.................#.....#.....#.....#
################################################################
