16
.#.....#.......#
.#.#.#.#.#####.#
...#G#.#.#.....#
.###.###.#.###.#
.#.#.....#...#.#
.#.#########.#.#
.#.........#.#.#
.#####.#####.###
.......#...#...#
######.#.#.###.#
.......#.#..S#.#
.#######.#####.#
.....#.#.#...#.#
####.#.#.#.#.#.#
.......#...#...#
################
