16
.....#...#.....#
.#####.#.###.#.#
...#...#...#.#.#
.#.#.#####.###.#
.#.#.#...#..S#.#
.#.#.###.#####.#
.#.#.#.....#...#
.#.#.#.###.#.#.#
.#.#...#.#.#.#.#
##.#####.#.#.#.#
.....#.....#.#.#
.###.#.#######.#
..G#.#.........#
.#.###########.#
.#.............#
################
