64
...........#.....#.......#.............#...#...#...........#...#
.#.#######.#.#.#.#####.#.#####.#######.#.#.#.###.#####.###.#.#.#
.#...#.#...#.#.#.......#.......#.#.....#.#.#...#...#.#.#...#.#.#
####.#.#.###.#.#######.#########.#.#####.#.###.###.#.#.#.###.#.#
.....#...#...#...#.....#.......#.#...#...#...#...#.#.#.#.....#.#
.#####.###.#####.#####.#.#####.#.###.#.#####.###.#.#.#.#########
.....#...#.#...#.....#.#...#...#.......#...#.#...#.#.#.........#
.###.#####.#.#.#####.#####.#.###########.#.#.#.#.#.#.#########.#
.#.#.....#...#...#.#.......#.........#.#.#...#.#.#.......#.#...#
.#.#####.#######.#.#################.#.#.#####.#########.#.#.###
...#...........#...........#...#.....#.#...#...........#.#.#...#
.###.#########.###########.#.###.#####.###.#####.#####.#.#.###.#
.#...#.....#...#.........#.#...#...#.......#...#.....#.#...#...#
##.#######.#.###.#######.#.#.#.###.#####.###.#.###.#.#####.#.#.#
...#.......#...#...#.....#.#.#...#.#...#.....#...#.#.....#.#.#.#
.#####.###.###.#####.#.###.#.#.#.#.#.#.#.#######.#####.#.#.#.###
...#G..#.#.#.#.#.....#.#...#.#.#.#.#.#.#.#.....#.....#.#.#.#...#
##.#.###.#.#.#.#.#.#####.###.#.#.#.#.#.###.###.#####.#.#.#.###.#
...#...#.....#...#.#.....#...#.#.#...#...#...#.#...#.#.#.#.#.#.#
.#####.#########.###.#####.###.#########.###.#.#.#.#.#.#.#.#.#.#
.#.....#.....#...#...#.#...#.#.........#...#.#...#.#...#.#...#.#
.#.#.###.###.#.###.###.#.###.#####.#.#####.#.#####.#######.###.#
.#.#...#.#.#...#.#...#.......#.....#.#...#.#.....#.......#.#...#
.###.#.#.#.#####.###.#####.###.###.###.#.#.#####.#######.#.#.#.#
...#.#.....#.....#.#...#...#...#.#.#...#...#...#.....#.#...#.#.#
.#.#######.###.#.#.###.#.###.###.#.#.#######.#.#####.#.#####.#.#
.#.#.....#.#...#.#...#.#.#...#.....#.....#...#...#...#.#.....#.#
.#.#.###.#.#.###.###.#.###.###.#########.#.#####.#.###.#.#.#####
.#...#...#.#...#.....#.....#.#.#.......#...#...#...#...#.#.#...#
.#####.###.###.#####.#######.#.###.###.#######.#######.#.###.#.#
.#.....#.#.#...#.#...#.......#.....#.#...#...#.......#.#.....#.#
.#.#####.#.#.###.#.###.#.###########.###.#.#.#.###.#.#.#######.#
.#.#.....#.#...#.#.#...#.#.......#...#...#.#.#...#.#.......#...#
##.#.#.###.###.#.#.###.###.###.#.#.#.#.###.#.#####.#######.#.#.#
...#.#.#...#...#.#...#.#...#.#.#...#.#.#...#.....#.#....S#.#.#.#
.#####.#.###.###.###.#.#.###.#.#######.###.#####.#.#.#####.#.#.#
...#...#.#.....#...#...#.....#.#.....#...#.....#.#.#.#...#.#.#.#
.#.#.#.#.#.###.#.#.###.#####.#.#.###.###.#####.#.#.#.###.#.#.###
.#.#.#.#.#.#...#.#...#.....#.#...#.#.....#.....#.#.#...#...#...#
##.#.###.#.#.###.#.#####.###.#####.#######.#####.#.###.#.#####.#
...#...#.#.#...#.#.#.....#...#.............#...#.#.#...#...#.#.#
.###.#.#.#.###.###.#.#####.###.#####.#.#####.#.#.#.#.#####.#.#.#
.#...#...#...#...#...#...#...#.#...#.#.#.#...#.#...#.#...#...#.#
.#####.#########.#####.#.###.###.#.###.#.#.###.###.#.#.#.#.###.#
.....#.....#...#.#...#.#...#.#...#...#.#.....#...#.#.#.#...#...#
.###.#####.#.#.#.#.#.#.###.#.#.#####.#.#######.###.#.#######.###
...#.#.......#...#.#...#.#.#...#.#...#.......#.....#...#.....#.#
####.#.###########.#####.#.#####.#.#####.###.###.#####.#.#####.#
.....#.#.......#...#.....#.......#.....#...#...#...#...#.#.....#
.#######.#####.#.###.#####.#####.#####.###.###.###.#.###.#.#.###
.#.....#.....#.#...#.#...#.....#.#...#.#.....#.#.#.#.#...#.#...#
.#.###.#.#####.###.#.#.#.#######.#.#.#.#.#####.#.#.#.#.###.###.#
...#.#.#.#.......#...#.#.......#.#.#...#.#.....#...#...#.#.#.#.#
.###.#.#.#.###.#####.#.#######.#.#.#####.#.#####.#######.#.#.#.#
...#.#...#.#.#.#...#.#.......#.#.#...#...#.#...#.#...#.....#.#.#
##.#.#####.#.#.#.#.#.#######.#.#.###.#####.#.###.#.#.#.#####.#.#
.#...#...#.#.#.#.#.#.#.....#.#.....#.......#...#.#.#.....#...#.#
.###.#.#.#.#.#.#.#.#.#.#.###.#####.###########.#.#######.###.#.#
.....#.#...#...#.#.#.#.#.#...#.....#...........#.....#.....#.#.#
.#####.###.#####.#.#.#.###.#.#####.#.#.###.#########.#####.#.#.#
.....#.#...#...#.#...#.#...#.#...#.#.#...#.#.......#.....#...#.#
####.#.#####.#.#.#####.#.#####.#.###.###.###.#####.#####.#####.#
.....#.......#.........#.......#.......#.........#.............#
################################################################
