16
...........#...#
.#########.###.#
.#S....#...#...#
.#####.#.###.#.#
...#.#...#...#.#
##.#.#######.#.#
...#.........#.#
.###.#####.###.#
...#.....#.#.#.#
##.#######.#.#.#
.#.#.......#.#.#
.#.#.#######.#.#
.#.#...#.....#.#
.#.###.#.#####.#
......G#.......#
################
