8
S#.....#
.#.###.#
.#...#.#
.#####.#
.......#
######.#
....G..#
########
