16
.........#...#.#
######.#.#.#.#.#
.....#.#.#.#.#.#
.###.#.#.#.#.#.#
.#.#...#...#.#.#
.#.#.#######.#.#
.#...#..S#.#.#.#
.#####.###.#.#.#
.#...#.#...#...#
.#.#.#.#.#.###.#
.#.#.#.#.#.#...#
.#.#.#.#.#.#.###
...#.#.#.#.#...#
.###.#.#.#####.#
G..#...#.......#
################
