16
.#.....#.......#
.#.###.###.###.#
...#...#...#...#
.###.###.###.###
...#S#...#...#.#
##.###.#.#.###.#
.#.#.#.#.#.#...#
.#.#.#.#.#.###.#
.#.#.#.#.#...#.#
.#.#.#.#.###.#.#
...#...#.#...#G#
.###.###.###.#.#
.#.....#...#.#.#
.#########.#.#.#
...........#...#
################
