32
G............#.................#
.#.#######.###.#.#############.#
.#.#.......#...#.....#.......#.#
.#.#########.#######.#.#####.###
.#.#.....#.........#.#.....#...#
.#.#.###.#.#########.#.#######.#
.#.....#...#.........#.#.......#
############.#######.#.#.#####.#
...#.......#.#.....#.#.#.#.....#
.#.#.#####.#.#.###.###.#.#####.#
.#.#.#.......#...#.....#.#...#.#
.#.#.#########.#########.#.#.#.#
.#...#.........#.......#...#.#.#
.#####.#########.#####.#####.#.#
...........#...#.#...#.....#.#.#
.#########.#.#.#.#.#######.#.###
.....#...#.#.#.#.#.........#...#
####.#.#.###.#.#.#########.###.#
...#.#.#...#.#...#.......#.....#
.#.#.#.###.#.#####.#####.#####.#
.#.#.#.#.#.#.#.........#...#.#.#
.###.#.#.#.#.#.###########.#.#.#
.#...#.#.#.#.#.#...#.......#.#.#
.#.###.#.#.#.#.###.#.#######.#.#
...#...#...#.......#.#...#...#.#
.###.###.###.#######.#.#.###.#.#
.#.#...#...#.#.....#...#...#.#.#
.#.###.###.###.###.#.#####.#.#.#
.#...#S#.#...#...#.#.#...#.#...#
.###.###.###.###.#.###.#.#.#.###
...........#.....#.....#...#...#
################################
