32
.....#...........#.......#.....#
.#.###.#######.#.#.#####.#.#####
.#.........#...#...#.....#.....#
.###########.#######.#####.###.#
.#...#...#...#...#...#...#...#.#
.#.###.#.#.###.#.#.###.###.###.#
...#...#...#S#.#.....#...#.#...#
##.#.###.###.#.#####.#.#.#.#.###
...#.#...#...#.#...#.#.#...#...#
####.#.###.#####.#.#.#####.###.#
.....#.#.#...#...#.#.....#.#...#
.#####.#.###.#.###.#####.#.#.###
...#.#.#...#...#.#...#...#.#...#
##.#.#.###.#####.###.###.#####.#
...#.......#.......#...#.......#
.#########.#.#########.#######.#
...#...#...#.#.........#.....#.#
##.#.#.###.#.#.#########.###.#.#
...#.#...#...#.#.......#.#...#.#
.#.#.###.#####.#####.#.###.###.#
.#.#...#.#...#...#...#...#...#.#
.#####.#.#.#.###.#.#####.###.#.#
.....#.#...#.#...#.#...#...#.#.#
.###.#.#####.#.###.###.###.#.#.#
...#...#...#.#...#...#...#.#...#
##.#####.#.#.###.###.#.###.#####
...#.....#...#.#.#...#..G#.....#
.###.#######.#.#.#.#####.#####.#
.#...#...#.....#...#.......#...#
.#.###.#.###########.#.#####.###
.#.....#.............#.........#
################################
