64
.........#.....#.........#...#.......#...#.......#.........#...#
.#######.#.###.#.#######.#.#.#.###.#.###.#.#.###.#.#######.#.#.#
.#.....#...#.....#...#...#.#...#...#...#...#...#.#.......#...#.#
.#.###.#####.#####.#.#.###.#####.#####.#######.#.#######.#####.#
...#.#.#.....#...#.#.#.#.......#.#...#...#.....#...#...#.#...#.#
####.#.#####.#.#.#.#.#.#####.###.#.#.###.#.#######.#.###.#.#.#.#
.....#.#...#.#.#...#.#.....#.#...#.#.#...#.#.......#.#...#.#.#.#
.#####.#.#.###.#####.#####.###.###.###.###.#.#######.#.###.#.#.#
...#...#.#.......#...#...#.....#.....#.#...#.....#...#.#...#.#.#
.#.#.###.#########.###.#############.#.#.#######.#.###.###.#.#.#
.#.#...#.#.#.......#.................#...#.......#.........#.#.#
##.###.#.#.#.#######.#########.#####.#####.###################.#
...#.#...#.#S#.....#.#.......#...#...#.#...#.....#.......#.....#
.#.#.#####.###.#####.#.#.#######.#.###.#.###.#.#.#.#####.#.###.#
.#.....#...#.........#.#...#.....#.....#...#.#.#...#.#...#...#.#
.#######.#.#.#############.#.#####.#######.###.#####.#.#####.#.#
.#.......#.#.....#.....#...#.#.....#.....#.....#.....#.......#.#
.#.#######.#####.###.#.#.###.#######.#.#########.###.#########.#
...#...#.......#.....#...#...#.....#.#.....#...#...#...........#
.#####.#.#####.#######.###.###.###.#.###.#.#.#####.#############
...#...#...#...#.....#.#...#...#.#...#...#...#.....#.....#.....#
##.#.#.###.###.#.###.#.#.###.###.#####.#######.#####.###.#.#.#.#
.#...#...#...#.#.#.#...#...#.#.......#.......#.#.....#...#.#.#.#
.#######.###.###.#.#######.#.#.#####.#######.#.###.###.###.#.#.#
.......#...#.#...#...#...#...#.#.....#.......#...#.#...#...#.#.#
.#########.#.#.###.#.#.#######.#.#####.#####.###.#.#.#######.#.#
.#.......#.#...#...#.#.........#.#.....#.....#...#.#...#.....#.#
.#.#####.#.#####.#.#.#####.###.###.#.#####.###.###.###.#.#####.#
...#...#...#.....#.#.......#...#...#.#...#.#...#...#...#.#...#.#
.###.#.#########.#.#########.###.#.###.#.###.###.###.###.#.#.#.#
.#...#.#.......#.#.#.......#.#...#.#...#.....#.....#.....#.#.#.#
.###.#.###.###.###.#.#####.#.#.###.#.#########.###.#####.#.#.###
.....#...#.#.#...#.#...#...#.#...#.#.......#.#.#.#.....#.#.#...#
########.#.#.###.#.#####.###.###.#########.#.#.#.#####.###.###.#
.......#.#.#.....#.#...#...#.#.#.........#.#.#.#...#.#...#...#.#
.###.###.#.###.###.#.#.###.#.#.#########.#.#.#.#.#.#.###.###.#.#
.#...#...#...#.....#.#...#.#...#.......#.#.#.#.#.#.....#.....#.#
.#.###.#####.#######.###.#.###.#.#######.#.#.#.#.#####.#######.#
.#...#.#.....#...#.....#.....#.#.#.....#...#.#.#.#...#.......#.#
####.#.#.#####.#.#.###.#######.#.#.###.#####.#.#.#.#.#####.###.#
...#.#.#.#.....#.#...#.....#...#...#.#.......#.#.#.#.....#.#G..#
.#.#.#.#.#.###.#####.#####.#.###.###.###.#.###.#.#.#####.###.#.#
.#...#...#.#...#.....#.#...#...#.#.....#.#.#.....#.#...#.#...#.#
.###########.#.#.#####.#.#.###.#.#####.#.###.#####.#.#.#.#.###.#
.............#.#.#.....#.#.#...#...#...#.....#...#.#.#.#...#.#.#
.#########.#####.#.#.###.#.#.#####.#.#.#####.#.#.#.#.#######.#.#
.#...#.....#.....#.#...#.#.#.....#...#.#...#.#.#...#.......#...#
.###.#.#.###.#####.###.#.#######.#####.#.#.###.#####.###.#.#.###
.#...#.#.#...#...#...#.#...#...#.#.....#.#.....#...#.#...#.#.#.#
.#.#.#.#.#.###.#####.#.###.#.#.#.#.#####.#######.#.#.#.#####.#.#
...#.#.#.#.#.#.......#...#...#.#.#...#...#...#...#.#.#.....#.#.#
####.#.###.#.#.#####.#.#######.#.#.###.###.#.#.#.#.#.#####.#.#.#
.....#.....#.#.#...#.#.......#...#.#...#...#.#.#.#.#.#.#...#.#.#
.###########.#.#.#.#######.#.#######.#####.###.#.#.#.#.#.#.#.#.#
...#.........#.#.#.......#.#.........#.....#...#.#.#...#.#.#...#
##.#######.###.#.#######.#.###########.#.###.###.#.###.#.#####.#
.#.....#...#...#.#.....#.#...#.........#.#...#.#.#.#...#.......#
.#####.#.###.###.#.###.#.###.#.#.#########.###.#.###.###########
...#...#.....#...#.#...#.....#.#...#.....#...#.#...#.#.......#.#
.#.#.#####.###.#####.#############.#.###.###.#.###.#.###.#.#.#.#
.#...#...#...#.#.....#.....#.......#.#.....#...#.#.#...#.#.#.#.#
.#####.#.#####.#.#####.###.#.#.#####.#.#######.#.#.###.###.#.#.#
.......#.......#.........#...#.......#...........#.........#...#
################################################################
