32
...................#.....#....G#
.#############.###.#.###.#.#.###
.#.............#...#...#.#.#...#
.#.#.###########.#####.#.#####.#
.#.#.#...#.....#.#.....#...#...#
.#.#.#.#.###.#.#.#.#######.#.#.#
.#.#.#.#.#...#.#.#.....#.#...#.#
##.#.#.#.#.###.#.#####.#.#####.#
...#.#.#.#...#.#.#...#.#.....#.#
.#####.#.###.###.#.#.#.#.###.#.#
.......#...#.......#...#.#...#.#
##########.#############.#####.#
.........#...........#.#.......#
.#.#.#########.#####.#.#.#######
.#.#.#...#S..#...#...#.#...#...#
.#.###.#.###.#####.###.###.###.#
.#...#.#.....#...#.#.....#.....#
.###.#.#######.#.#.#.###.#####.#
.#.#.#...#.....#...#.#.#...#...#
.#.#.###.###.#######.#.###.#.###
...#...#.....#.....#.#...#.#...#
.###.#.#######.#.###.#.#.#.###.#
.#...#.....#...#.#...#.#.#.....#
##.#######.#.###.#.###.#.#######
...#.#.......#...#.....#.......#
.###.#.#######.###############.#
.#.....#...#.........#...#...#.#
.#######.#.#######.###.#.#.#.#.#
...#.....#.#.....#.#...#...#.#.#
.#.#.#####.#.###.###.#######.#.#
.#.......#.....#...........#...#
################################
