8
.....#S#
####.#.#
.....#.#
.#####.#
.#.....#
.#.#####
..G....#
########
