8
.......#
.###.#.#
G..#.#.#
##.#.###
...#...#
.#####.#
.....#S#
########
