16
...........#..G#
.#########.#.#.#
.....#.#...#.#.#
####.#.#.#####.#
.....#.#...#...#
.#####.###.#.#.#
.#.........#.#.#
.###.#######.#.#
..S#.#.......#.#
####.#.###.###.#
...#.#.#...#...#
.#.#.###.###.###
.#...#...#.#...#
.#####.###.###.#
.......#.......#
################
