8
.......#
.#####.#
...#..G#
.#.#.###
.#.#.#.#
.#.#.#.#
.#S#...#
########
