8
S..#...#
##.###.#
.#.#...#
.#.#.#.#
.#...#G#
.#####.#
.......#
########
