64
.......#.......#...........#.................#.............#...#
.###.#.###.#.###.###.###.###.#######.#######.#.###.#######.###.#
.#...#.....#.#...#...#.#.#...#.....#.#.....#...#...#.....#.....#
##.###.#####.#.###.###.#.#.###.###.###.###.#.###.###.#########.#
...#...#...#.#...#...#...#...#.#.#...#.#.#.#.#...#.....#...#...#
.###.###.#.#####.###.###.###.#.#.###.#.#.#.###.#######.#.#.#.###
.#...#...#.#...#.#.#...#.#...#.#...#...#...#...#.....#...#.....#
.#.###.###.#.#.#.#.###.###.###.#.#######.###.###.###.#########.#
.#...#...#...#.#.#...#.....#...#.........#.#...#...#.........#.#
.###.###.#####.#.#.#.#######.###.#########.#.#.###.#########.###
...#...#.#...#.#...#.#.#.....#.#.#.....#.....#.....#.......#...#
.#.#####.#.#.#.#####.#.#.#####.#.###.#.#######.#####.###.#.###.#
.#.#.....#.#.#.........#.....#.....#.#.......#...#...#.#.#.#...#
.#.#.#####.#.#.#############.#####.#.#######.###.###.#.#.#.#.###
.#...#.....#.#.#...........#...#.#.#...#...#.#.....#...#.#.#...#
.#####.#####.#.#.#########.#.#.#.#.###.#.#.#.#####.#####.#.###.#
.#.....#.#...#.#...#.......#.#.#.#...#...#.#.....#.#.....#...#.#
##.#####.#.#######.#####.#####.#.###.#####.#####.#.#.#####.###.#
...#.....#...#...#.....#...#...#...#.......#...#.#...#.#...#...#
.###.###.###.#.#.#####.###.#.###.#.#########.###.#####.#.###.#.#
.#...#.#.....#.#.......#...#.#...#...#.#.....#...#.....#.#...#.#
.#.###.#######.#########.###.#####.#.#.#.###.#.###.#.###.#.#####
.#.......#.....#.........#.#.....#.#...#.#.#...#...#.....#.....#
.#######.###.###.#########.#.###.#.#####.#.###########.#######.#
.#.#.....#...#...#...#.........#.#...#...#...........#.#.....#.#
.#.#.#####.#####.###.#.#########.#.#.#.###.#########.###.###.#.#
.#.#.#...#.....#...#.......#...#.#.#.#.#...#...........#.#.#...#
.#.#.#.#.#####.###.#.#######.#.#.#.#.#.###.###########.#.#.###.#
.#...#.#.....#...#.#.#.....#.#...#.#.#.....#.........#...#.....#
.###.#.#####.###.#.###.###.#.#####.#.#####.#.#######.#####.#####
...#...#.........#...#.#...#.#...#.#.....#.#.#...#...#.#...#...#
##.#.###############.#.#.###.#.#.###.###.#.#.#.#.#.###.#.#####.#
...#.#.......#.........#.#.....#...#.#...#.#.#.#.#.#.....#.....#
.#####.#####.###########.#####.###.#.#####.#.#.#.#.#.#######.#.#
.....#.#...#...#.......#.....#.#...#.......#.#.#.#.#.#.......#.#
####.#.#.#.###.#.#####.#####.###.###########.#.###.#.#.#######.#
...#.#.#.#...#...#...#.#...#...#.#.........#.#.#...#...#S#.....#
##.#.#.#.#######.#.#.#.#.#####.#.#.#######.#.#.#.#######.#.#####
...#...#.#.....#.#.#.#.#.#.......#.#.....#...#.#.#.......#.....#
.#######.#.###.###.#.#.#.#.#####.#.#.#.#######.#.#.###########.#
.........#...#.....#...#...#...#.#.#.#.........#.#.....#...#...#
.#####.#.###.###########.###.#.###.#.###.#####.#.#####.#.#.#.###
.....#.#...#.#...........#...#.....#.#...#...#.#.......#.#.#...#
##.###.#####.#.###########.###########.###.###.###########.###.#
.#.#...#.....#...#.......#.......#.....#.#.....#.......#...#...#
.#.#.#.#.#######.###.###########.###.###.#.#####.#####.#.#.#.###
...#.#.#.#.....#...#.......#...#.#...#...#...#...#...#...#.#.#.#
.###.###.#.###.###.#####.#.#.#.#.#.###.#.###.#.###.#######.#.#.#
...#...#.#...#...#...#...#.#.#...#.#...#.......#...#.....#.#.#.#
.#####.#.###.#.#####.#.#####.#####.#.###########.#.#.###.#.#.#.#
.#.....#...#.#.....#.#.#.....#.#...#.#...#...#...#...#.#...#.#.#
.#.#######.#######.#.#.#.#####.#.#.#.###.#.#.#.#######.#####.#.#
.#.#.....#.......#.....#.....#.#.#.#.....#.#.#...#...#...#.#...#
.#.#.###.#######.###########.#.#.#.#####.#.#.###.#.#.#.#.#.###.#
.#.....#...#...#.......#.....#...#.#...#.#.#...#...#...#...#...#
.#######.#.#.#########.#.#####.###.#.#.###.###.###.#######.#.###
...#.....#...#.......#.#...#.#.#...#.#...#...#...#.#...#...#.#.#
##.#.#######.#.###.###.###.#.#.#.###.###.###.###.###.#.#####.#.#
...#G..#.....#.#.#...#.#...#.#.#.....#.#.......#.#...#.......#.#
.#####.#######.#.###.#.#.###.#.#######.#########.#.###########.#
...#.#.......#...#...#...#...#...#.........#.#...#...#...#.....#
##.#.#######.###.#.#######.#####.#######.#.#.#.#####.#.#.#.###.#
...........#.....#.......................#...#.........#...#...#
################################################################
