64
...............#.............#.......#.....#.#.........#.......#
.#######.#.#####.#.#########.#.#####.#.#.#.#.#.#####.#.###.###.#
...#.....#.#.....#.#.#.....#...#...#.#.#.#.#.....#...#.....#...#
####.###.###.#####.#.#.###.#####.#.#.###.#.#######.#########.###
.....#.#.#.......#.#.#...#...#...#.#.....#.........#.......#...#
.#####.#.#.#######.#.#.###.#.#####.#################.###.#####.#
...#.....#.#.......#...#...#.#.......#.........#.....#.#.....#.#
##.#.#####.#.#######.###.###.#.#######.#.#######.#####.###.###.#
...#.#.....#.....#.#.#...#...#.........#...#.....#.......#...#.#
.#####.#########.#.#.#.###.###.#########.#.#.#####.#####.###.#.#
.....#.....#.....#...#.#.#.#.....#.....#.#.#.#.....#..G#...#.#.#
.###.#####.#.#########.#.#.#######.###.###.#.###.###.#.###.#.#.#
...#.......#...#.....#.#...........#.......#...#.#...#...#.#.#.#
##.#########.#.#.###.#.#####.#################.#.#.#.#####.#.#.#
...#.......#.#.#.#.....#...#.#.................#...#.#...#.#...#
.###.#####.###.#.#######.#.#.#.###################.###.#.#.#####
.#...#.....#...#.........#.#.#.......#.......#...#.#...#.......#
.#.###.#####.###.#########.#.#######.#.#####.#.#.#.#.#########.#
.#.#.#...#.....#.......#...#.#...#.#...#...#.#.#.#.#...#.......#
##.#.###.#####.###.#####.###.#.#.#.#####.###.#.###.###.#######.#
S#.#...#...#...#...#...#.#.#.#.#...#...#...#.#...#.#.#...#...#.#
.#.#.#.###.#.#####.#.#.#.#.#.#.###.#.###.#.#.#.#.#.#.###.#.#.###
.#.#.#...#.#.#...#.#.#...#.#...#.....#...#.#.#.#.......#...#...#
.#.#.###.#.#.#.#.###.#####.#.#########.###.#.#################.#
...#...#.#.#...#...#.#...#...#...#.......#.#...................#
######.#.#.#######.#.#.#.#.###.#.#.#######.###################.#
.......#.#.......#.#.#.#.#.#...#...#...#.....#.........#.......#
.###.###########.#.#.#.#.#.#.#########.#.###.#.#####.###.#######
...#.#.........#...#.#.#...#...#.......#.#...#.....#...#.#.....#
.###.#.#.#.#########.#.#######.#.#####.#.#########.###.#.#####.#
.#...#.#.#.#...#.....#.#.....#.#...#.#.#.......#...#.#...#...#.#
.#.###.#.###.#.#.#.###.#.#.###.###.#.#.#######.#.###.#####.#.#.#
.#.....#.#...#.#.#...#.#.#.......#.#.....#...#.#.#.........#...#
########.#.###.#.###.###.#######.#.#.#####.#.#.#.#######.#.###.#
...#...#.#...#.#.#.#.......#...#...#.#.....#...#.......#.#...#.#
.#.#.#.#.###.#.#.#.#########.#.#######.#####.#########.#####.###
.#...#.#.#...#.#...#...#.....#.#.......#.....#.......#.....#...#
.#####.#.#.###.###.#.#.#.#####.#.#.###########.#####.#####.###.#
.#.......#.#.....#.#.#.#.#...#...#.#.....#.....#...#.#.....#...#
.#########.#.#####.#.###.#.###.#####.###.#.#####.#.#.#.#####.#.#
.....#.....#.......#...#.#.....#.....#.#.#.....#.#...#.....#.#.#
.###.#.###############.#.#######.#####.#.#####.#.#########.#.#.#
.#.#.#...#.............#...#...#.......#.......#...#...#...#.#.#
.#.#.###.#.#####.#########.#.#.#######.###########.#.#.#.###.#.#
.#.#...#.#.#.....#.........#.#.......#.......#...#.#.#.#.#...#.#
.#.#.###.###.#.###.#######.#.#.###.#########.#.#.#.#.#.#.#.###.#
...#...#...#.#.#...#.....#.#.#.#...#.....#...#.#...#.#.#.#.#...#
##.###.###.#.###.###.###.###.#.###.#.#.###.###.#####.#.#.#.#.###
.#.#.#.....#...#.......#...#.#...#.#.#.....#.#.#.....#.#...#...#
.#.#.#########.###########.#.###.###.#######.#.#.#####.#######.#
.#.#...............#.....#.#...#.#...#.....#.#...#...#.....#...#
.#.#.###.###########.###.#.#.###.#.###.###.#.#####.#.#.#####.###
.#.#...#.#.......#...#.#.#.#.#...#.#.....#...#.....#.#.#...#...#
.#.#####.#.#####.#.###.#.#.#.#.#.#.#.###.###.#####.###.#.#.###.#
.#.....#.#...#...#.#.......#.#.#.#.#.#...#.#.#...#.#...#.#.#...#
.#####.#.###.#.###.#######.#.#.#.#.#.#.###.#.#.#.#.#.###.#.#.###
.........#...#.....#.....#.#.#.#.#.#.#.#...#.#.#...#.#...#...#.#
########.#.#########.###.#.#.#.###.###.#.###.#.###.#.#.#######.#
...#...#.#.#.....#...#...#.#.#.....#...#.#...#.#.#.#...#.....#.#
.#.#.#.###.#.###.#.###.#####.#######.###.#.###.#.#.#####.###.#.#
.#...#.....#.#.#...#.#.......#.......#...#.#...#...#.....#...#.#
.###########.#.#####.###########.#####.###.###.#.###.#####.###.#
.................................#.............#.....#.........#
################################################################
