16
.....#.....#...#
##.#.###.#.#.#.#
...#.#...#G..#.#
.###.#.#######.#
...#...#...#...#
.#.#####.###.###
.#.#.......#.#.#
.#.#######.#.#.#
.#.#.......#...#
##.#.#########.#
...#.........#.#
.#######.###.#.#
...#...#...#...#
.#.#.#.###.#####
.#...#S#.......#
################
