8
......G#
.###.#.#
.#...#.#
##.###.#
S#.#.#.#
.#.#.#.#
...#...#
########
