64
...#.......#.......#.......#.............#.........#.#.....#...#
.#.#.#.#####.#.###.#.###.###.###.#######.#####.###.#.#.###.#.#.#
G#.#.#.......#.#...#.#.#.#...#.#.#...#.........#.....#...#...#.#
##.#.#########.###.#.#.#.#.###.#.#.#.###########.#######.#####.#
...#.#.......#...#.#.#.#.#.#...#...#.....#...#...#.#.........#.#
.#.#.###.#######.###.#.#.#.###.#########.#.#.#.###.#.#########.#
.#.#...#.......#.......#.#.............#.#.#.......#...#.....#.#
.#####.#.#####.#########.#############.#.#######.#####.#.###.#.#
.#.....#...#.......#...#.....#.....#...#.#...#...#.....#.#.....#
.#.#########.#.#####.#.###.#.#.###.#.###.#.#.###.#.#####.#######
.......#.....#.#.....#.....#.#...#.#...#...#...#.#...#.#.......#
######.#.#######.###########.#.#.#####.#######.#.###.#.#######.#
...#.....#.....#.#.....#.....#.#.....#.#.....#.#.#...#.#.....#.#
.#.#####.#.###.#.#####.#.###########.#.###.#.#.###.###.#.###.#.#
.#...#...#.#...#.....#.#.#.....#.....#.#...#.#.#...#...#.#S..#.#
.###.#####.###.#.###.#.#.###.#.#.#####.#.#.###.#.###.#.#.#####.#
...#.#...#...#.#...#.#.#...#.#...#...#...#.#...#.....#.#...#...#
##.#.#.#.###.#.#####.#.###.#.#.###.#.#####.#.#######.#####.#.###
...#...#...#.#.......#.....#.#.#...#.......#.........#.....#...#
.#.#######.#.#########.#####.###.###############.#####.#######.#
.#.#.....#...#...#.....#...#.#...#.#.......#...#...#...#.......#
.###.###.#####.#.#.#####.#.#.#.###.#.###.#.#.#.#####.###.#.#####
.....#.#...#...#.#...#...#...#...#.#...#.#.#.#.......#...#.....#
.#####.###.#####.###.#.#########.#.###.#.#.#.#################.#
...#.....#.....#.......#.........#.....#.#.#.#...........#.....#
##.#####.#####.#########.###############.#.#.###.#######.#.###.#
.#.....#.....#.......#...#.........#.....#.#.....#...#...#.#.#.#
.#####.###.#########.#.###.#.#####.#.#.###########.###.###.#.#.#
.....#...#.........#...#...#.#...#...#.#.........#.....#...#...#
.###.###.#.#######.#####.###.#.#.#.#####.#####.###.#####.###.###
.#.#...#.#.....#.......#...#...#.#.#.......#...#...#.#...#...#.#
.#.###.#.#####.#.#########.#####.#.#.#######.###.###.#.#.#.###.#
.#...#...#.....#.....#...#...#...#.#...#.....#...#.....#.#.....#
.#.#.#####.#########.#.#.###.#.#######.#.#####.#######.#.#######
.#.#.....#.#.......#...#.....#...#...#.#.#.....#.....#.#.#.....#
.#####.###.#####.#.#############.#.#.#.#.#.#####.###.#.#.#.###.#
...#...#.........#.........#.....#.#...#...#.....#...#.#.#...#.#
##.#.###.#####.#############.#.###.###########.###.###.#.#.###.#
.#.#.#...#...#.#.....#.......#.#...#...........#...#...#...#...#
.#.#.#.###.#.#.#.###.#.#####.###.###.###########.###.#######.###
...#.#...#.#.#.#...#...#...#.#...#...#.....#.....#.#.......#...#
.###.#.###.#.#####.#####.#.###.###.###.###.#.#####.#######.###.#
...#...#...#.......#.....#.....#.......#.#.#...#.........#.#.#.#
##.#.###.#########.#.#############.#####.#.###.#.#####.###.#.#.#
...#.#.#.#.......#.#.......#.....#.......#.#.#.#.#...#.#.....#.#
.###.#.#.#####.#.#.#######.#.###.#########.#.#.###.#.#.#.#####.#
.#.....#.#.....#.#...#.#...#...#...........#.#.....#.#...#...#.#
.###.###.#.###.#####.#.#.#####.#############.#######.#####.#.#.#
...#.#...#...#.#.......#.#.....#...#...........#...#.......#.#.#
##.#.#.###.#.#.#.#####.#.###.###.#.#.#######.#.#.#.#########.#.#
.#.#.#.#.#.#.#.#.#...#.#...#.#.#.#...#.#...#.#...#.#.#.....#...#
.#.###.#.#.#.###.#.#.#####.#.#.#.#####.#.#.#.#####.#.#.#.#######
.#...#.#...#.....#.#.#.....#.#...#.....#.#.#...#...#...#.......#
.###.#.###########.#.#.#####.#.###.###.#.#.###.#.#####.#####.###
...#.#.....#.....#.#...#.....#...#...#.#.#.....#.#...#.#...#...#
##.#.#####.#.###.#.#####.#######.###.###.#######.#.#.###.#.###.#
...#.....#.#...#...#.....#...#.....#...#...#...#.#.#.....#...#.#
.#.#####.#.###.#######.###.#.#####.###.###.#.###.#.#########.#.#
.#.#...#...#.#.#.......#...#...#...#.....#.#.....#.#...#...#...#
.#.#.#.###.#.#.###.#######.###.#.###.#####.#.#####.#.###.#.###.#
.#...#...#.#.#.....#.....#.#...#.....#.....#.#.....#.#...#...#.#
.#########.#.#########.#.#.#.#########.#####.#.#####.#.#####.#.#
.......................#...#...........#.......#...........#...#
################################################################
