8
.#.....#
.#.###.#
.#...#G#
.###.#.#
.....#.#
######.#
S......#
########
