16
..G....#.......#
####.#.#.#####.#
...#.#.#.#...#.#
.#.#.###.#.#.#.#
.#...#...#.#...#
.#####.###.#####
.....#.#.....#.#
.###.#.#####.#.#
.#...#...#.....#
##.#####.#####.#
...#.....#S..#.#
.#.#.#######.#.#
.#.#.........#.#
.#############.#
...............#
################
