16
.....#...#.....#
.###.#.###.#.#.#
.#...#.#...#.#.#
.#.###.#.###.#.#
.#.#...#.#...#.#
.#.#.###.#.#####
S#.#.....#.....#
##.#.#########.#
...#.#.....#...#
.#####.###.#.###
...#...#.#.#...#
##.#.###.#.###.#
...#.#...#.#...#
.###.#.###.#.#.#
.....#....G..#.#
################
