16
...#...#.......#
.#.#.#.#####.#.#
.#...#......G#.#
.#############.#
...#.......#...#
##.#.#######.###
S..#.#.......#.#
####.#.#######.#
.....#...#.....#
.#######.###.###
.#.....#...#...#
.#.#.#####.###.#
...#.#.....#...#
.###.#.#####.#.#
...#.........#.#
################
