64
...............#.......#.....#.....#.....#...............#.....#
.#####.#####.#.#.###.#.#.###.#.###.#.#.#.#.#######.#####.#.###.#
.#...#.....#.#.#.#.#.#...#...#...#.#.#.#.#.......#...#...#...#.#
.#.#.#####.#.###.#.#.#####.###.#.###.#.#.###########.#.#####.#.#
.#.#.#...#.#.......#...#...#...#.#...#.#.....#.......#.#...#.#.#
##.#.#.#.#.#########.#.#.###.###.#.###.#####.#.#######.#.###.#.#
...#...#.#.....#...#.#.#.#...#...#.#.#.#.......#.....#.#.....#.#
.#######.#######.#.###.#.#####.#.#.#.#.#############.#.#######.#
.....#.......#...#...#.#.....#.#.#.#.#.#.........#...#.#.......#
.###.#######.#.#####.#.#####.#.#.#.#.#.#.#######.#.###.#.#####.#
...#.......#.#.#.#...#.....#.#.#.#.#.#.....#.....#...#.#.#...#.#
##.#######.#.#.#.#.#####.#.#.#.#.#.#.#######.#####.#.#.#.#.#.###
...#.#.....#...#.#.....#.#.#.#.#.#.....#...#...#...#.#.#...#...#
.###.#.#.#######.#####.###.#.#.#.#####.#.#.###.#.###.#.#######.#
.....#.#.#.....#.....#...#.#...#.#.....#.#.#...#.#...#.........#
######.###.###.#####.###.#.#.#####.#####.#.#.#####.###########.#
.....#...#...#.....#.......#.#...#...#.#.#...#...#.........#...#
.###.#.#.#.#######.#####.#####.#.###.#.#.#####.#.#.#######.#.###
...#.#.#.#.#.....#.....#.#...#.#.#...#.#.......#.#.....#.#...#.#
##.#.###.#.#.###.#.###.###.#.#.#.#.###.#########.#####.#.#####.#
.#.#...#...#.#...#...#.....#...#.#.#.........#...#...#.....#...#
.#.###.#####.#.#####.###########.#.#####.###.#.###.#.#####.#.#.#
...#.#.......#...#...#...#.....#.#.......#...#.#...#.#...#.#.#.#
.###.###########.#.###.#.###.#.#.#########.###.#.###.#.#.#.#.#.#
.......#...#.....#.....#...#.#.#.....#...#.#.#.....#.#.#.#...#.#
######.#.###.#.###########.###.#####.#.#.#.#.#######.#.#######.#
.......#.#...#.#.....#..S#...#.....#...#.#...#.......#.....#...#
.#######.#.#####.###.#.#####.#####.#####.###.#.###########.#.###
.#.......#.......#.#...#...#...#.....#.#.....#.#...#.......#...#
.#.#####.#########.#######.###.#.###.#.#######.#.#.#.#.#######.#
.#.#...#.......#.....#.......#...#.#...#.....#...#.#.#.......#.#
.#.#.#.###.###.###.#.###.###.#####.###.#.###.#####.#.#######.#.#
.#.#.#...#.#...#...#.....#.#.#.......#.#.#...#...#.#.......#.#.#
.###.###.#.#.###.#########.#.#.#####.#.#.#.#.#.#.#.#.#######.#.#
...#.#.....#.#.......#...#...#.#.....#.#.#.#.#.#...#.#.....#...#
##.#.#######.#.#####.#.#.#.#####.###.#.###.#.#.#####.#.###.#####
...#...#...#.#.....#...#.#.......#...#.....#.#.#...#.#.#.#.....#
.#####.#.#.#.#########.#.#########.#######.###.#.###.#.#.#####.#
.#.....#.#.#.........#.#.#.....#...#.....#.#...#.....#.....#...#
.#.#######.#########.###.###.#.#.#####.#.#.#.#############.#.###
...#.#.........#...#...#...#.#.........#.#.#.............#.#...#
####.#.#.#######.#.###.#.#.###############.###########.###.###.#
.#...#.#.......#.#.....#.#...........#...#.#...#...#.#...#.#.#.#
.#.#.#.#######.#.#######.###########.#.#.#.#.#.#.#.#.###.#.#.#.#
.#.#.#.....#.#...#...#.........#.....#.#...#.#...#.....#.#...#.#
.#.#.#####.#.#####.###.#########.#####.#####.#########.#.###.#.#
.#.#.#.....#.............#.....#.#.....#.........#...#.#.....#.#
.#.#.#.###################.###.#.#.#####.#######.###.#.#######.#
...#...#.................#...#.#.....#...#...#.#...#...#.....#.#
.#######.###.###########.#.#.#.#####.#.###.#.#.###.#####.###.#.#
.#.....#.#...#.........#.#.#.#...#.#.#...#.#...#...#.....#.#...#
.#.###.###.###.#######.#.###.###.#.#.###.#.#####.#.#.#####.###.#
...#.#...#.#...#.#.....#.....#...#.#...#...#.....#.#.....#...#.#
####.###.#.#.###.#.###########.###.###.#####.#.#####.###.#.#.#.#
.#.....#...#...#.#.#.........#.#.#.....#...#.#.#...#.#...#.#...#
.#.###.#######.#.#.#.#######.#.#.#.#####.#.#.###.#.###.###.#####
.#.#.#.........#.#...#.....#...#.......#.#.#.#...#.#...#.#...#.#
.#.#.###########.#####.#.#############.#.#.#.#.###.#.###.###.#.#
.#...#...............#.#.........#.......#...#.#.....#...#...#.#
.###.#########.#####.#####.#####.###########.#.#######.###.###.#
.#...#.........#.....#...#.#...#...#.......#.#...#...#..G#.....#
.#.###.#########.#####.#.#.#.#.###.#.#####.#####.#.#.#.#.#####.#
.......#...............#...#.#.......#...........#.#...#.......#
################################################################
