64
...#...............#.............#...#.........#.............#.#
.###.#########.#.###.###########.#.#.#.#.#####.#.###.#######.#.#
.#G......#...#.#...#.#.....#.....#.#...#...#...#...#...#.....#.#
.#.#######.#.#.###.#.###.#.#.#####.#######.#.###.#####.#.#####.#
.#.#.#...#.#.#...#.#...#.#.#.#.........#...#...#.#.....#.....#.#
.#.#.#.#.#.#.###.#.###.###.#.#.#########.###.###.#.#########.#.#
...#.#.#...#...#.#...#.....#.#.....#...#.#...#...#.......#.#.#.#
.###.#.#######.###.#.#####.#.#####.#.#.#.#.###.#########.#.#.#.#
.#...#...#...#...#.#.....#.#...#...#.#...#...#.#...#...#.#...#.#
.###.###.#.#.###.#######.#.#.#.#.###.#######.#.#.#.#.#.#.###.#.#
...#...#.#.#...#.#.......#.#.#.#.#.#...#...#.#.#.#...#.#...#...#
##.#.###.#.###.#.#.###.###.#.#.#.#.###.#.###.#.#.#####.###.###.#
...#...#.#.#.#...#.#...#...#.#.#.....#.#.....#.#.#.....#.#...#.#
.###.#.#.#.#.#####.#####.###.#######.#.#.#####.#.#.#####.###.#.#
.#.#.#.#.#.......#.#.....#.#.......#.#.#...#.#.#.#.#.....#...#.#
.#.#.#.#.#######.#.#.#####.###.#####.#.###.#.#.#.#.#.#####.###.#
.#.#.#.#.......#...#.#.......#.....#.#.#.....#...#...#.....#...#
.#.#.#.#######.###.#.#####.#.#####.#.#.#######.#######.#####.###
.#...#.......#.#...#...#...#.....#...#.........#.......#...#...#
.#.###.#######.###.###.#.#######################.#######.#####.#
.#...#.......#...#...#.#...........#.......#.#...#...#.......#.#
.###########.###.#####.#.#######.#.#.#####.#.#.###.###.#####.#.#
.............#.#.......#...#.....#.#...#.#.#.#...#.........#...#
############.#.#############.#####.#.#.#.#.#.###.#.#####.#####.#
.#...........#...#.........#.....#.#.#.#.....#...#.#...#.#...#.#
.#.###########.#.#.#.#####.#.###.#.###.#.#####.#####.#.###.#.###
.#.#.......#...#.#.#.#...#.#.#...#.....#.#.....#...#.#.....#...#
.#.#.#.#####.#.###.#.###.#.###.#.#########.#####.#.#.#########.#
.#.#.#.....#.#.....#...#.#...#.#.#.......#.....#.#...#.....#...#
.#.#.#####.#.#########.#.###.#.#.#.#####.#####.#.#####.###.#.###
...#.#...#...........#.#.#.....#.#.#.#...#...#.#.#.......#.#...#
.###.###.#########.###.#.#.#####.#.#.#.###.#.#.#.#######.#.###.#
.#...........#...#.#...#.#.#...#.#.#.#.#...#.#.#.......#.#.#...#
.#########.###.#.###.###.#.#.#.#.#.#.#.#.###.#.#######.#.#.#.###
...#.......#...#.....#.....#.#.#.#.#...#...#.....#...#.#.#.#...#
##.#########.#####.#########.#.###.#.#####.#####.#.###.###.###.#
.#.....#.....#.....#.........#.....#...#...#...#...#...#...#...#
.#####.#.#####.#####.#################.#.#.#.#.#####.###.###.###
...#...#.....#.#.....#...............#...#.#.#.#...#.#.....#...#
##.#.#######.###.#.#########.#######.###.###.#.#.#.#.#.###.###.#
...#.#.....#...#.#.#.......#.#.....#.....#...#.#.#...#.#.#.....#
.###.###.#.###.#.###.#####.###.###.#######.###.#.#####.#.#######
...#.....#.....#.....#.....#...#...#.......#...#.#.#...#.......#
.#.###########.#######.###.#.###.###.#######.###.#.#.#####.###.#
.#.......#...#.......#...#.#...#...#.#.....#...#.#.#...#...#...#
.#.#####.#.#.#######.###.#####.###.#.#.#.#####.#.#.###.#.###.###
.#.....#...#.......#...#...#...#...#.#.#.....#...#...#...#...#.#
.#####.#########.#####.###.#.#####.#.###.#.#########.#####.###.#
.#.....#.#.....#.#.....#.#.#.....#.#...#.#...........#...#.#...#
##.#####.#.###.#.#.#####.#.#####.#.###.#.###.#######.###.#.#.#.#
...#.........#.#.#.#.....#.....#.#...#.#.#...#.....#...#.#.#.#.#
.###.#########.#.#.#####.#####.#.###.#.#.#.#.#.###.###.#.#.#.#.#
.#.....#.#...#...#.#.....#.....#...#.#.#.#.#.#...#.#.#...#.#.#.#
.#####.#.#.#.#.###.#.###.#.#######.#.#.#.#.#.#.###.#.###.#.###.#
.....#...#.#.#...#...#.#.#.#S#.....#...#.#.#.#.#...#.....#...#.#
.###.#####.#.#########.#.#.#.#.#########.#.###.#.#.#########.#.#
.#.#.......#...#.........#.#...#.......#.#...#.#.#.#.........#.#
.#.###########.#.#########.#####.#.#.###.###.#.#.###.#########.#
.....#.........#.#.......#...#...#.#.#...#...#.#.....#.........#
####.#.#######.#.###.#####.#.#.###.###.###.#.#.#######.#.#####.#
.....#.....#...#...#.#.....#.#.#.#.....#...#.#...#.....#.#.#...#
.#########.#######.#.#.#######.#.#######.#######.#######.#.#.###
.........#...........#.................#.................#.....#
################################################################
