64
...#...#.....#...#...........#.............#.........#.........#
.#.#.#.#.###.#.#.#######.#.###.###.#######.#######.#.#.#####.#.#
.#...#...#.#...#.......#.#.....#...#.......#.......#.#...#.#.#.#
.#########.###########.###.#####.#####.#####.#######.###.#.#.#.#
.....#.....#...#.....#...#.#...#.#...#.......#.......#.....#.#.#
.###.#.#.###.#.#.#.#####.#.#.#.#.#.#.#########.###########.#.###
...#.#.#.....#...#.....#.#...#.#...#.......#...........#.#.#...#
##.#.#####.###########.#.#####.#######.###.###########.#.#.###.#
...#.....#.#.......#...#.#...#...#...#...#.....#.....#.#.....#.#
.#######.#.#######.#.###.#.###.###.#.###.#####.#.###.#.#######.#
.#.......#.......#.#.....#.#...#...#.#.#.#.#...#.#...#...#.....#
##.#############.#.#######.#.###.###.#.#.#.#.###.#.#####.#.###.#
...#.........#...#...#.#.....#.#.#...#.....#...#.#.....#.#...#.#
.#####.#######.###.#.#.#.#####.#.###.#.#######.#.#####.#.###.#.#
S#.....#.......#...#...#.#.....#...#.#.#.....#.#.#...#...#...#.#
##.#####.#########.#.###.###.#.###.#.###.###.#.#.###.#####.#####
.........#.#.......#.#.......#...#.#...#.#.#...#.......#.......#
.#########.#.###.#####.#########.#.###.#.#.###.#######.#######.#
...#.....#.....#.....#.#.......#.#...#...#...#.#.....#.........#
##.#.###.#######.###.#.#.#####.#####.#######.#.#.###.###.#####.#
...#...#.......#...#.#.#...#...#.....#.....#...#...#...#.#...#.#
.#####.#######.###.#.#.###.#.###.#####.###.###.###.###.###.#.###
.#.....#.....#.#.#.#.....#.#.#.#.......#.#...#.#...#.#...#.#...#
.###.#.#####.#.#.#.#######.#.#.#.#######.###.###.###.###.#.###.#
...#.#.#...#...#.....#.....#.#.#.........#.#...........#.#.#...#
##.#.###.#.#.#######.#.#####.#.#########.#.#############.#.#.#.#
...#.#...#.#.......#.#.#.....#...#.....#.#...#.....#...#...#.#.#
.###.#.###.#######.###.#.#####.###.#.###.#.###.###.#.#.#.###.#.#
...#...#.#.#.........#.#...#...#...#...#.#...#.#...#.#.#...#.#.#
##.#.###.#.#########.#.###.###.#.#####.#.###.#.#.###.#.#####.#.#
.#.#.#...#.#.......#...#.#...#...#.#...#.....#.#.....#.......#.#
.#.#.###.#.#.#####.#####.###.#.###.#.###.#####.###############.#
...#.....#.......#.#.....#...#.....#.....#.....#.#.............#
.#################.#.###.#.#####.#########.#####.#.#############
.....#.............#.#...#.#.#...#.......#...#.....#...........#
####.#.###############.###.#.#.###.#####.#.#.#.###############.#
...#.#...#.............#...#...#...#...#.#.#.#...#.............#
.###.#.#.#.#######.#####.#######.#####.#.###.###.#.###########.#
.....#.#.#.#.....#.......#.....#.....#.......#.#...#.....#.....#
.#####.#.###.###.#.#######.###.#.###.#########.#####.#.###.#####
.#.....#...#.#.#.#.....#...#...#.#.#.....#...#.......#...#...#.#
.###.#####.#.#.#.#####.###.#.###.#.#####.#.###.#########.###.#.#
...#.#...#...#.#.#.#...#...#.#...#...#...#.....#.....#.#.#...#.#
##.#.#.#.#####.#.#.#.###.###.#.###.###.###.#######.#.#.#.#.###.#
...#...#.......#.#...#...#.#.#.....#G..#.#.#.....#.#.#.#.#.#...#
.#########.#####.#.###.#.#.#.#######.###.#.###.#.#.#.#.#.#.#.#.#
.........#.#.....#...#.#.#...#.......#...#.#...#.#.#...#.#.#.#.#
########.###.#######.###.#.###.#######.###.#.###.#.###.#.#.###.#
.......#.....#.......#...#.....#.........#.#.#.#.#...#.#.#...#.#
.#####.#######.#######.###.#####.#######.#.#.#.#.###.#.#.###.#.#
.....#.....#...#.....#...#.#...#.....#.#.#...#.#...#.#.#...#.#.#
.#######.#.#.###.#####.#.###.#.#####.#.#.#####.###.#.#####.#.#.#
.#...#...#.#.#.......#.#.....#...#.....#...#.....#.#.#.....#.#.#
.#.#.#.#####.#.#####.#.#########.#.#######.#.###.#.#.#.###.#.#.#
.#.#...#.....#.....#.....#.....#.#...#...#.#...#.#...#.#...#.#.#
.#.###.#.###########.#####.###.#.#####.#.#.###.#.###.#.#.###.#.#
.#.#...#...#.......#.#...#.#...#.....#.#.#.#...#.....#.#...#...#
.#.#######.#.#####.###.#.#.#.#######.#.#.#.#.#########.#######.#
.#.......#.#.....#...#.#.#.#.#.......#.#...#...#.....#...#.....#
.#######.#.#####.###.#.#.#.#.#.#######.#######.#.#######.#.#####
...#.#...#.....#...#.#.#.#.#...#.....#.......#.#.......#.#.#...#
##.#.#.#######.###.#.#.#.#.#####.#.###.###.###.#####.#.#.#.#.#.#
.....#.............#...#...#.....#.......#...........#.#.....#.#
################################################################
