32
.#.....#...........#...........#
.#.#.#.###.#######.###########.#
...#.#.....#.....#.....#.......#
.###.#######.###.#####.#.#####.#
.#.#.#.#.....#.#.#.....#.#...#.#
.#.#.#.#.#.###.#.#.#####.#.#.###
...#.#.#.#...#...#.#.....#.#...#
.###.#.#.###.###.#.###.###.###.#
.#...#.#.#.#...#.#...#...#.#.#.#
##.###.#.#.###.#####.###.#.#.#.#
...#.........#...#.......#.#.#.#
.###########.###.#.#######.#.#.#
...........#...#.....#...#...#.#
.#########.#######.###.#.###.#.#
.#.......#.#.....#.#...#.....#.#
.#######.#.#.###.###.#########.#
.#.......#...#.#.....#.......#.#
.#.###########.#######.#######.#
.#...........#.......#...#...#.#
.#######.###.#######.#.#.#.#.#.#
.......#.#.........#...#.#.#.#.#
######.#.#########.#####.#.#.#.#
.......#.....#.......#...#.#...#
##.#########.#######.#.###.#####
S#...#.....#.......#.#...#.#...#
.###.#.###.#######.#.###.#.#.#.#
...#.#.#.#.#.......#.....#...#.#
##.#.#.#.#.#.###########.#####.#
...#...#.....#.....#.....#...#G#
.#############.###.#######.#.#.#
...............#...........#...#
################################
