64
.....................#.........#.......#...........#...#.......#
######.#############.###.###.###.#.#.###.#######.#.###.#.#.#####
.......#...#.......#...#.#...#...#.#.#.....#.....#...#.#.#.....#
.#######.###.###.#.###.###.###.###.#.#.#####.#######.#.#.#####.#
.....#...#...#.#.#...#.#...#...#...#.#...#...#.....#.#...#.....#
.###.#.#.#.###.#.#####.#.###.###.#######.#.###.#####.###.#.#####
.#...#.#.#...#.#.......#...#.#.#...#.....#...#.....#...#.#.....#
.#.###.#####.#.###########.#.#.###.#.#######.#.###.###.#.#####.#
.#...#.....#.#...........#.#.#.#...#.#.#.....#...#...#.#...#.#.#
####.#.#.###.#.#.#######.#.#.#.#.#.#.#.#.#######.#.###.###.#.#.#
.....#.#.....#.#...#...#.#.#.#.#.#.#.#.#...#.....#...#.#.....#.#
.#####.#######.###.###.#.#.#.#.#.###.#.###.#.#######.#.#.#####.#
.#...#.#.....#...#...#.#...#...#...#.....#.#...#...#...#.#.....#
.###.#.#####.###.###.#.###.###.###.#.#####.###.###.#######.###.#
...#.#.#.......#.#...#...#...#.#.#...#.....#.#.......#.....#...#
##.#.#.#.#######.#.###.#.#.###.#.#####.#####.#######.#.#####.###
...#...#.#...#...#.#.#.#.#.#...#.....#.....#.........#...#...#.#
.###.###.#.#.#.###.#.#.#.#.#.#######.#####.#.#####.#####.#.###.#
.#.....#...#.....#.#.#.#.#.#.#...#.....#...#.#...#.#.....#...#.#
.#####.#.#######.#.#.#.#.#.#.#.#.#.###.#.#####.#.#.#.#######.#.#
...#.#.#...#...#.#.#...#...#.#.#...#...#.......#.#.#.#.....#...#
.#.#.#.#.###.#.#.#.###.#####.#.#####.#####.#####.#.#.#.#.#####.#
.#.#.#.#.#...#.#.#...#.....#...#...#.#...#...#.#.#...#.#.......#
##.#.#.###.###.#####.###########.#.#.#.#.###.#.#.#######.#######
...#...#...#.#.....#.............#.#.#.#.#.....#.......#.#...#.#
.###.###.###.#####.#.#######.#.#####.#.#.#######.#####.#.#.#.#.#
.#.......#.#.....#.#.#...#...#.#...#.#.#.......#.#.....#...#.#.#
.#########.#.#.###.#.###.#.#####.#.#.#.#######.#.#.#########.#.#
.#.....#...#.#...#.#.....#...#...#.#.#...#.....#.#.#.......#.#.#
.#.###.#.#.#.###.#.#########.#.###.#.###.#.#####.#.###.#.###.#.#
...#S..#.#...#.#.#.#.....#...#.#...#...#.#.....#.#...#.#.....#.#
########.#####.#.#.#.###.#.#.#.#.#####.#.#####.#####.#.#######.#
.......#.#.....#.#...#.#.#.#.#.#.....#.#.#...#...#...#...#.....#
.#######.#.###.#.#####.#.#.###.#####.#.#.###.###.#.#####.###.#.#
...#.......#.#.#.....#...#.....#...#...#...#...#.#.#.#...#...#.#
.#.#.#######.#.#.###.#.#########.#.#######.#.#.#.#.#.#.###.###.#
.#...#...#...#.#.#...#...........#...#.....#.#.#...#.#.#...#...#
.#####.#.###.#.#.#.#################.#.#######.#####.#.#.#.#.###
.#...#.#...#...#.#.....#...........#...#.......#...#...#.#.#...#
.#.###.###.#####.#####.#.#.#############.#.###.#.#.#.#####.###.#
.#.#...#...#...#...#.#.#.#.#.........#...#...#.#.#.#...#...#...#
.#.#.###.###.#.###.#.#.###.#.#####.###.#####.#.###.###.#.#####.#
.#.#...#.....#.....#.......#...#.#.#...#.....#...#...#.#.#...#.#
.#.###.#.#####################.#.#.#.###.#######.#.#.#.#.#.#.#.#
.#...#.#.#...#...........#...#...#.#.#...#...#...#.#.#.#...#.#.#
.#.#.#.###.#.#.#########.#.#.###.#.#.#.###.#.#.###.#.#.#####.#.#
...#.#.....#.#...#.....#...#.....#...#.#.#.#.#.#...#.#.#.....#.#
####.#######.###.#.###.###############.#.#.#.#.#.#.###.#.#####.#
...#.#.....#.....#...#...#.........#...#.#.#...#.#...#...#.....#
.###.#.###.#########.###.#.#######.#.###.#.#####.###.#####.#####
...#.#...#.........#...#...#.......#.#...#.#.....#.......#.#...#
##.#.###.#####.#####.#######.###.###.#.#.#.#.#####.#####.#.#.#.#
...#.#.#...#...#.....#.....#...#.#...#.#...#.#.....#...#.#...#.#
.###.#.###.#.###.#####.###.###.###.###.#######.#####.#.#.#####.#
.#...#...#.#.....#...#.#.....#.#...#...#.......#.....#.#.#...#.#
.#.###.###.#########.#.#####.#.#.###.###.#############.#.#.###.#
...#.......#...#.....#...#.#...#...#...#.............#...#.#...#
.#####.#####.#.###.#.###.#.###.###.###.#############.#.###.#.###
.....#.......#...#.#.#...#...#...#.#...............#.#.#...#...#
####.###########.#.#.#.###.#.###.#.###############.#.#.###.###.#
.....#.....#.......#.#...#.#...#.#.........#.....#...#G....#...#
.#####.###.#############.#.#.###.#########.#.###.###########.###
.......#.................#.#.............#.....#...............#
################################################################
