32
.....#.....#.....#.............#
.###.#.###.#####.#.#########.#.#
...#.....#.....#...#.......#.#.#
##.#########.#.#####.#####.#.#.#
...#.#.....#.#...........#.#.#.#
.###.#.###.###############.###.#
.....#.#.#...........#.....#...#
####.#.#.#.#########.#.#####.###
.#...#.#...#.......#.#.#S#.#...#
.#.###.#.###.#####.#.#.#.#.#.#.#
.....#.#...#.#...#.#...#.#...#.#
.#####.#####.#.###.#####.#####.#
.#.#...#.....#...#.....#...#...#
.#.#.###.#######.#####.###.#.###
.#.#...#.#...........#.....#...#
.#.###.#.#.#.#######.#########.#
.#...#...#.#.......#.....#.....#
.#.#.###########.#.###.###.#.#.#
.#.#...........#.#.#...#...#.#.#
.#.###########.###.#####.###.#.#
...#.....#...#...#.........#.#.#
########.#.#.###.#.#########.###
.........#.#...#.#...#.....#...#
.###.###.#.###.#.###.#.###.###.#
.#.#.#...#.#.#...#...#.#.#.....#
.#.#.#.###.#.#####.###.#.#####.#
...#.#G#...#...#.....#.#.....#.#
####.#.#.###.#.#######.###.###.#
.....#.#.#...#.#.....#.#...#...#
.#######.#.###.#.###.#.#.###.###
...........#.....#.....#.......#
################################
