16
...#S..........#
.#############.#
.........#.....#
####.#####.#####
.....#.....#...#
.###.#.#####.#.#
...#.#.......#.#
.#.###########.#
.#.....#.....#.#
.###.###.#.###.#
.#...#...#...#.#
.#.###.#####.#.#
.#...#.#...#G..#
.###.#.#.#.#####
...#.....#.....#
################
