32
.........#...........#...#.....#
.#########.#######.#.###.#.#.###
...#.....#.#.....#.#...#.#.#...#
##.#.###.#.#.###.#.###.#.#.###.#
...#.#.#...#.#.....#.....#...#.#
.#.#.#.#####.#############.###.#
.#.#.#...#...#.............#...#
.###.###.#.###.###########.#.###
.#...#...#.....#.........#.#...#
.#.###.#########.#######.#.###.#
.#.#...#.......#...#...#.#...#.#
.#.#.###.#.###.###.#.#.#.#####.#
.#.#.....#...#...#...#.#.......#
.#.###.#####.###.#####.#########
.#...#.#.....#S#.#.....#.......#
.###.###.###.#.###.#######.#.#.#
...#...#.#.#.#.....#.....#.#.#.#
.#.###.#.#.#.#######.###.#.#.#.#
.#...#...#.#...#.....#.#.#.#.#.#
.#########.###.###.###.#.#.#.###
.#...........#...#.#.....#.#...#
.#.#.###########.#.#.#########.#
...#...........#...#.#.....#...#
.###########.#.#####.#.###.#.#.#
.#...#.#...#.#.#...#...#.#.#.#.#
.#.#.#.#.#.#.#.#.#.#####.#.#.###
.#.#...#.#...#.#.#...#.....#...#
.#.#####.#.#####.#.#.#.#######.#
.#.#.....#.#...#.#.#.#.#.....#.#
.#.#.#######.#.#.#.###.#.###.#.#
...#.........#...#.......#....G#
################################
