8
..S#...#
.###.#.#
.#...#.#
.#####.#
.....#.#
####.#.#
......G#
########
