64
.....#.......#...........#.....#.....#.........#...........#...#
##.#.#####.#.#######.###.###.#.#####.#.#####.###.#######.#.#.#.#
...#G....#.#.#.......#.#.....#.#...#...#...#.#...#.#...#.#.#.#.#
.#######.#.#.#.#######.#######.#.#.#.###.#.#.#.###.#.#.#.#.#.###
.#...#.#...#.#.....#.....#...#...#.#.....#.#.#.....#.#...#.#...#
.#.#.#.#####.#.###.#.###.#.#######.#########.#####.#.#####.###.#
.#.#.#.....#.#...#.#.#...#.#.....#.........#.....#.#...#.#.#...#
.#.#.###.###.#####.#.#.###.#.#.###########.#.#####.###.#.#.#.#.#
...#...#.......#...#.#.....#.#.......#...#.#.#.......#.#.#.#.#.#
######.#######.#.###.#######.#####.#.#.#.#.#.#.#######.#.#.#.#.#
.......#...#.....#.#.......#...#...#.#.#...#.......#...#...#.#.#
.#####.#.#.#.#####.#.#####.###.#.###.#.#############.#####.#.#.#
.#.....#.#.#.#...#...#.....#...#...#.#...#...........#...#.#.#.#
.#######.#.#.#.#.#.###.#####.#####.#####.#.###########.#.#.#.#.#
.......#.#.#.#.#.#.#.#...#...#...#.....#.#.....#.......#.#...#.#
######.#.#.###.#.#.#.###.#.###.#.#####.#.#.###.#.#######.#####.#
...#...#.#.....#.#.....#.......#.....#.#.#...#.....#...#.#.....#
.#.#.###.#######.###########.#########.#.###########.#.#.#######
.#.#.....#.....#.........#...#.......#...........#...#.#.......#
.#########.#.###########.#####.#####.###########.#.###.#####.#.#
.....#...#.#...........#.#.........#...#...#...#...#.#.....#.#.#
.###.#.#.#.#########.#.#.#.###########.#.###.#.#####.#####.###.#
.#.#.#.#.#...#.....#.#.#...#.#.........#.....#.....#.....#.....#
.#.#.#.#.###.#.###.###.#####.#.#########.#########.#.#.#######.#
...#...#...#.#...#...#.......#.......#...#...#...#...#.....#...#
.#######.###.###.###.#.#####.#######.###.#.#.###.#########.#.###
.#.......#...#...#.#.#.#.......#...#...#...#...#.........#.#.#.#
##.#####.#.###.###.#.#.#.#####.###.###.#######.#########.#.#.#.#
...#...#.#.#...#.....#.#...#.........#.....#.#.....#.....#...#.#
.###.###.#.#.###.#########.#.#######.#####.#.#####.#.###.#####.#
.#.......#.#.#.#...#.......#...#...#...#...#...#...#.#...#.....#
.#.#######.#.#.###.###.#####.###.#.#####.#####.#.###.#####.###.#
.#.#.......#.#.......#.#.....#...#.#...#.#.....#...#.#.....#...#
.###.#######.#######.#.###.###.###.#.#.#.#.#.#.###.#.#.#####.#.#
...#.#.....#.#...#...#...#...#...#...#...#.#.#...#.#...#.....#.#
.#.#.#.###.#.#.#.#.#####.###.###.###########.#####.###.#.#######
.#.#.#...#.#...#.#.#...#.#.....#..S#.........#...#...#.#.......#
##.#.###.#.#####.#.#.#.#.#####.#####.#.#######.#.###.#######.#.#
...#.....#.#.....#...#.#...#.#.#.#...#...#.....#...#.......#.#.#
.#########.#.#########.###.#.#.#.#.#####.#.#######.#######.###.#
...#.......#...#.....#.....#...#...#.....#...#...#.......#.....#
##.#.#########.#.###########.#######.###.###.#.#########.#####.#
...#...#.....#.#...........#...#.....#.....#.#.....#.#.......#.#
.#####.#.#.#.#.#####.#####.###.#.#####.#####.###.#.#.#.#####.#.#
.....#.#.#.#.#.....#...#...#...#.....#...#...#...#...#.....#.#.#
##.###.#.#.#######.#.#.#####.#######.#####.###.#####.#####.###.#
...#...#.#...#.....#.#.#.....#.....#.#.....#.#.....#.....#.....#
.#.#.###.###.#.#######.#.#######.#.#.#.#####.#.###.#####.#######
.#.#...#.#...#.#.......#.#...#...#...#...#.......#...#.#.......#
.#.###.#.#.###.#####.#.#.#.#.#.###.#####.#.#########.#.#######.#
.#.#...#.#...#.....#.#.#.#.#...#.#.#.....#...#.......#.......#.#
.###.#######.#####.#.###.#.#####.#.#.#########.#########.###.#.#
...#.....#.......#.#...#.#...#...#.#.....#...#.........#...#.#.#
.#.#####.#.#####.#.###.#.###.#.###.#####.#.#.#.#######.#.###.#.#
.#...#...#.#...#.#...#.......#...#.....#.#.#.#.....#...#.#...#.#
.###.#.###.#.#.#####.#.#######.#.###.###.#.#.#######.#####.#.#.#
.#.#.#.#...#.#.#.....#.#.#...#.#.....#...#.#.....#...#.....#.#.#
.#.#.#.#.#.#.#.#.#####.#.#.#.#########.###.#####.#.###.###.###.#
.#.#...#.#...#.#.....#...#.#.......#...#...#.......#...#.#.#...#
.#.#####.#####.#####.#####.#######.#.###.#.#########.###.#.#.###
...#...#.....#...#...#...#.......#.#...#.#.....#.......#...#.#.#
##.#.#.#######.#.#.###.#.#######.#.###.#######.#.#####.#####.#.#
.....#.........#.#.....#.........#.............#.....#.........#
################################################################
