64
.......#...#...#...........#...#...#.......#.......#.........#.#
.#.#####.#.#.#.#.#.#######.#.#.#.#.#.#####.#.#.###.#.#####.#.#.#
.#...#...#.#.#...#...#...#...#...#.#S#.#...#.#.#...#.#.....#.#.#
.###.#.###.#.#######.#.#.#########.###.#.#####.#.#####.#####.#.#
.#.#.#...#.#.#...#...#.#.#.......#.....#.#.....#.#.....#...#...#
.#.#.###.#.#.###.#.#.#.#.#.#####.#######.#.#####.#.#####.#####.#
...#.....#.#.#...#.#.#.#.#...#.#.........#.#.....#.#.#.........#
.#########.#.#.#.#.###.#.###.#.###########.#####.#.#.#.#########
.#.....#...#...#.#...#.#...#...#.........#.....#.#.#.#...#.....#
##.###.#.#######.###.#.#.#####.#####.#.#.###.#.#.#.#.###.#.#.#.#
...#.#.#.......#.#...#.#...#...#...#.#.#...#.#.#...#.#...#.#.#.#
.###.#.###.###.#.#.###.###.#.###.#.###.###.#.#.#####.#.###.#.#.#
.#.#...#...#...#.#...#.#.#.#.#...#.....#...#.#...#.....#...#.#.#
.#.#.###.#######.###.#.#.#.#.#.#########.#######.#.#########.#.#
.#.#.#...#.......#.#...#.#.#...#.#.....#.#.....#.#.#.........#.#
.#.#.#.#.#.#######.#####.#.#####.#.#.#.#.###.#.#.#.#.#########.#
.#.#.#.#.#.#.............#.......#.#.#.#...#.#.#.#.#.#.........#
.#.#.###.#.#.#######.#######.#####.#.#.###.#.#.#.#.#.#.#####.###
.#.......#.#.#.....#.#.....#.#...#.#.#...#...#.#.#...#.#...#...#
.#######.#.###.###.#.#.###.#.#.#.#.#.#########.#.#####.#.#.###.#
.....#...#.....#...#.....#.#...#...#...#.....#.#.#.....#.#...#.#
.###.###########.#########.###########.#.#.#.#.#.#######.###.#.#
...#.#.......#...#.........#.....#...#.#.#.#.#.#...#.....#...#.#
##.#.#.#####.#.###.#######.#.###.#.#.#.#.#.###.#.#.#.#####.###.#
...#.#.#.....#.#...#.....#...#.#...#.#...#.#...#.#...#...#...#.#
.###.#.#.#####.###.#####.#####.#####.#####.#.###.#####.#####.#.#
...#...#.....#...#.#.........#.......#...#...#.........#.....#.#
##.#########.###.#.#.#.#####.#.#########.###############.#####.#
.#.......#.....#...#.#.#...#.#.#.....#.................#.#.....#
.#####.###.###.#####.###.#.###.#.###.#.###############.#.#####.#
.....#.#...#...#...#.....#.....#.#.....#.............#.#.....#.#
.#.###.#.###.###.###.###########.#######.#########.#.#.#####.#.#
.#...#.#...#.....#...#.........#...#...#...#.....#.#...#.....#.#
####.#.###.###.###.#########.#.###.#.#####.#.###.#####.#.#######
.....#.#.#.#...#...#.........#.....#.#.....#...#.....#.#.......#
.###.#.#.#.#####.###.###############.#.#######.#####.#.###.###.#
.#...#.#.#.......#...#.................#...#...#...#.#...#.#...#
.#####.#.#########.#######.#############.#.#.###.#.#.###.#.#.#.#
.#.....#...#.......#.....#.........#.#...#...#...#.#.#...#.#.#.#
.#.#####.#.#.#.###.#.###.#########.#.#.#########.###.#.#####.#.#
.#...#...#.#.#.#...#.#.#.......#...#.#.#.........#...#.....#.#.#
.###.#.#####.#.#####.#.#######.#.###.#.###.#####.#.#######.#.#.#
.#...#.#.....#.#.....#.......#.#.....#.....#.....#.#.....#...#.#
.#.###.#.#####.#.#####.#######.###.#########.#####.#####.#####.#
.#...#.....#...#...#...#.....#.#...#...#.........#.#.......#...#
.###.#######.#####.###.#.###.#.#####.#.#.#########.#.###.###.###
...#...#...#...........#.#...#.......#...#.........#.#...#...#.#
.#####.#.#.#########.###.#.#####.#####.###.#########.###.#.###.#
.......#.#.....#...#.#...#.....#.#...#...#.........#...#.#...#.#
.#######.#####.#.#.###.#######.#.#.#.#######.#####.###.#####.#.#
.......#...#.#.#.#...#...#.....#.#.#...#...#.....#...#G........#
######.###.#.#.#.###.#.#.#.#######.###.#.#.#######.#.#########.#
.....#.#...#...#...#.#.#.#.#.....#...#...#.......#.#.......#...#
##.###.#.###.###.#.#.###.#.###.#.#.#.###########.###.#####.###.#
...#...#.#.#.#...#.#...#.#.....#.#.#.........#.#...#.#...#...#.#
.###.###.#.#.###.#.###.#.#######.#.#########.#.###.###.#.###.#.#
...#.#...#.....#.#.#.#.#...#...#.#.....#.....#...#.....#.#...#.#
.#.#.#.#.#####.###.#.#.###.###.#.###.###.#####.#.#######.#.###.#
.#.#.#.#...#.#.....#.#.....#...#...#.#...#.....#...#.....#.#.#.#
.#.#.###.#.#.#######.#######.#.###.###.###.#.#####.#.#####.#.#.#
.#.#...#.#.#.......#.........#...#.....#.#.#.#.....#.#...#.#...#
.#.###.###.#.#.#####.#.#################.#.#.#######.#.#.#.#.###
.#.........#.#.......#.....................#...........#...#...#
################################################################
