32
.....#S......#.........#.......#
.#.#########.#.#######.#######.#
.#...#.....#.#.#.....#.......#.#
.###.#.#.#.#.#.#.###########.#.#
.#...#.#.#.#.#.#...........#.#.#
##.###.#.###.#.#.#####.#.#.#.#.#
...#...#...#...#.#...#.#.#.#.#.#
.###.#####.#####.#.#.###.#.#.#.#
.....#.......#...#.#.....#.#...#
.#####.#####.#.###.###########.#
.#...#.....#.#.#.#.........#...#
.###.#####.###.#.#########.#.###
...#...#.#...#.....#.....#...#.#
##.#.#.#.###.#####.###.#######.#
.#...#...#...#...#...#.........#
.#######.#.#.#.#.###.###.#.###.#
.......#.#.#.#.#...#...#.#.#.#.#
####.###.#.###.###.###.#.#.#.#.#
...#.....#.#...#.#...#.#.#.#.#.#
.#.#######.#.###.###.#.###.#.#.#
.#.......#.#.....#.#...#...#...#
.#.#####.#.#####.#.#####.###.###
.#.#...#.......#.....#G..#.#...#
.###.#.#######.#####.###.#.###.#
.#...#...#...#...#.#.#...#.#...#
.#.#####.#.#####.#.#.#.###.#.###
.#...#...#.........#...#.....#.#
.###.#.#################.#####.#
.....#.................#.......#
.###################.#########.#
...................#...........#
################################
