64
...#.....#.....#.............#...#...#.....#...#...........#...#
.#.#.###.#.###.#.#######.#####.#.#.#.#.###.###.#.#.#######.#.#.#
.#...#.#...#.#.#.#.....#.....#.#...#...#.#...#...#.#.#...#.#.#.#
.#####.#####.#.#.#.#########.#.#########.###.#.###.#.#.#.#.###.#
.....#...#...#...#...#.....#.#...#.....#.....#...#.#.#.#...#...#
####.#.#.#.#.#####.#.#.#.###.###.#.#.#.#.#####.###.#.#.#####.#.#
...#.#.#.#.#.....#.#.#.#.#.....#.#.#.#.#.#.....#...#.......#.#.#
##.#.#.#.###.###.#.#.#.#.#.#.###.#.#.###.#.#####.#########.#.###
...#...#.....#...#.#...#.#.#.#S..#.#.#...#.#.#...#...#...#.#...#
.#############.#######.#.#.#######.#.#.###.#.#.###.#.#.#.#.#.#.#
.....#.....#...#.....#.#.#.....#...#...#.#.#.#.....#...#.#.#.#.#
.#.###.#.#.#.###.###.###.#####.#.#######.#.#.#########.#.#.#.#.#
.#.....#.#.#.#...#.....#...#.#.#...#.............#...#.#.#.#.#.#
.#######.#.#.###.#####.#.#.#.#.###.#.###########.#.#.###.#.###.#
...#.....#.#.....#...#...#...#...#.#.#.........#.#.#.....#.....#
.###.###.#######.#.#.#########.###.#.#.#######.###.###########.#
.#...#...#.....#.#.#...#.......#...#.#.#...#.......#.#.....#...#
.#.#######.#.###.#.###.#.###.###.#####.#.#.#########.#.#.###.###
.#.#.......#.....#.#.....#.#.#...#.....#.#.........#...#...#.#.#
.#.#.#############.#######.#.#.###.###.#.#########.#####.#.#.#.#
.#.....#.......#...#.....#...#...#...#.#...#.....#.....#.#.....#
.#####.#.#####.#.###.###.#######.#.#.#####.#.###.#####.#########
.#...#.#.#.#.....#...#.#.........#.#.......#...#.....#...#.....#
##.#.#.#.#.#.#####.###.###############.#####.#.#####.###.#.###.#
...#.#.#.#.#.#.....#.......#.........#.....#.#.#...#...#.#.#.#.#
.###.###.#.#.#.###########.#.###.###.#####.#.#.###.#.###.#.#.#.#
.#.......#...#.#...........#.#.#.#.#.#.#...#.#...#...#...#...#.#
.#.###########.#####.#######.#.#.#.#.#.#.#######.###.#.#####.#.#
.#.#.........#.#...#...........#.#.#.#.#.......#...#.#.#.....#.#
.###.#######.#.#.#.#####.#######.#.#.#.#######.#.#.#.#.#.#####.#
.#...#.....#...#.#.....#.....#...#...#.....#.#.#.#.#.#.#.#...#.#
.#.###.#########.#####.#######.###.###.###.#.#.###.###.#.#.###.#
.#...#.........#.#...#.#.......#.#.#...#...#.#...#...#...#.#...#
.###.#.###.###.#.###.#.#.#######.#.#.#.#.###.###.#.#.#####.#.#.#
...#.#...#.#...#...#.....#.#.......#.#.#.#...#...#.#.......#.#.#
.###.###.#.###.###.#######.#.#########.#.#.#.#.#######.###.#.#.#
.....#...#...#...#...#...#...#.........#...#.#.#.......#...#.#.#
.#####.#####.###.###.#.###.#########.#######.#.###.#########.#.#
.#...#...#.#.#...#...#.....#.......#...#...#.#.....#...#.....#.#
.#.#.###.#.#.###.#.###.#####.#####.###.#.#.#.#####.#.#.#.#####.#
...#...#...#...#...#...#...#...#.#...#.#.#.#...#...#.#.#.#...#.#
######.#######.#####.###.#.###.#.###.#.#.#.###.#.###.#.#.#.#.###
...#...#.....#...#.#.#...#.....#.......#.#.....#...#.#...#.#...#
.#.#.###.###.#.#.#.#.###.###########.#############.#.#####.###.#
.#...#...#...#.#.#.#...#.......#...#.#...#.......#.#.......#...#
.#####.###.#####.#.###.#.#####.#.#.###.#.#.#####.#.#########.###
...#.....#...#...#.#...#.....#...#.....#.#.#...#...#.......#...#
##.#####.###.#.###.#.#######.###########.#.#.#.#####.#########.#
.#.....#...#...#...#.#...#...#.........#.#.#.#.#.....#...#.....#
.#####.###.#####.#.#.#.#.#.###########.#.#.#.#.#.#.###.#.#.###.#
.....#...#.#.....#.....#.#.....#.....#.#...#.#.#.#...#.#...#...#
####.###.#.#############.#####.#.###.#.#####.###.###.#.#####.###
.......#.#.#.....#.....#...#...#...#...#...........#.#.#.#...#.#
.#######.#.#.###.#.###.###.#.#####.###.###########.#.#.#.#.###.#
.#.......#...#.#...#...#...#.....#.#.#...#.......#.#.#.#.#.#...#
.#.#######.###.#####.###.#######.#.#.###.#.#####.###.#.#.#.#.###
.#.#.....#...#...#.#.#.......#.....#.......#.........#.#...#...#
.#.#.###.###.#.#.#.#.#######.###.###########.#######.#.#.#####.#
.#.#...#.......#...#.......#...#.#.......#...#..G#...#.#.......#
.#.###.#########.#####.###.###.#.#.#####.#####.#.#####.#######.#
.#.#...#...#...#.#...#...#.#...#.#.#...#...#...#.#...#.....#.#.#
.#.#####.#.#.#.###.#.#####.#.#####.#.#.###.#.###.#.#.#####.#.#.#
.........#...#.....#.......#.......#.#.......#.....#.......#...#
################################################################
