16
.#...#.........#
.#.#.#.#####.###
.#.#.#.#...#...#
.#.#.#.###.###.#
...#S#.....#...#
.#######.###.#.#
.#.......#...#.#
.#.#######.###.#
.#...#.....#...#
.#.###.#####.###
.#.#...#...#...#
.#.#.###.#.###.#
.#.#.....#.#.#.#
.#########.#.#.#
..........G#...#
################
