8
...#..G#
.###.#.#
.#...#.#
.#.###.#
.#S#.#.#
.###.#.#
.......#
########
