8
.#..S#.#
.#.###.#
.#...#.#
.###.#.#
...#.#.#
.#.#.#.#
.#G....#
########
