16
S..#...........#
##.#.#########.#
...#.#...#...#.#
.###.#.###.#.#.#
.#...#.....#...#
.#.###.#########
.#...#.#.......#
.###.#.###.#.###
.#...#...#.#...#
.#.#####.#####.#
...#...#.#.....#
####.###.#.###.#
.......#...#.#G#
.#####.#####.#.#
.....#.........#
################
