8
....G..#
##.###.#
...#...#
.###.###
S#...#.#
##.###.#
.......#
########
