16
.#..........G..#
.#.###########.#
.#.....#.......#
.#####.#.#####.#
.......#...#...#
##########.#.###
.....#.....#...#
.###.#.#######.#
..S#...#.......#
########.#######
.......#...#...#
.#########.#.#.#
.........#.#.#.#
.#######.#.###.#
.......#.......#
################
