64
.....#.........#.#.....#...#...............#...#.....#.......#.#
.###.#.#######.#.#.###.#.#.#.#######.#####.#.#.#####.#.#.###.#.#
.#.....#...#...#.....#...#.#.#...#...#.....#.#.#...#...#.#.#...#
.#.#######.#.#######.#####.#.#.#.#.###.#####.#.#.#.#####.#.###.#
.#...#...#...#.....#...#.#...#.#.#.#.#.#.....#...#.#...#.#.....#
.#####.#.#.###.###.###.#.#####.#.#.#.#.###.#######.#.#.#.#.#####
.......#.#.#...#...#...#.#.....#...#.......#.....#...#...#.#...#
########.#.#.#####.#.###.#.#####.###########.###.#########.###.#
.......#.#...#S..#.#.....#.....#.#.........#...#.......#...#...#
.#######.#######.#.###.#######.#.#.#######.#####.#.###.#.###.#.#
.......#.......#.#...#.#.......#.#.....#...#...#.#...#.#.#...#.#
####.#.#######.#.###.###.#########.#####.###.#.#####.#.#.#.###.#
...#.#.......#.#.#.#...#.....#.....#...#.#...#.#.....#.#...#...#
.#.#.#.#####.#.#.#.###.#####.#.#####.#.#.#.#.#.#.###########.###
.#.#.#...#...#.#.#...#.....#...#.....#...#.#.#...#.........#.#.#
.#.#.###.#.###.#.#.#######.#####.###########.###.#.#####.###.#.#
.#.#...#.#...#...#.......#.#...#...#.........#...#.#...#.....#.#
.#.#####.#.###########.#.#.#.#.###.#.#####.#######.#.#.#######.#
.#...#...#.#.........#.#.#...#...#.#.#...#.........#.#.#...#...#
.###.#.###.#.#####.#.#.#.#######.#.#.#.#.###########.#.#.#.###.#
...#...#...#...#.#.#...#.......#.#.#...#.#.......#...#.#.#...#.#
.#.###.#######.#.#.#####.#######.#.#####.#.#.#####.#.#.#.###.#.#
.#.#...#.....#.#.#...#...#.....#...#...#.#.#.#...#.#.#...#...#.#
.#.#####.#.###.#.###.#####.###.#####.###.#.###.#.#.#.#######.#.#
.#.#.....#.....#...#.......#.....#.....#.#.....#...#.......#.#.#
.#.#.###########.#.#########.#####.###.#.#########.#######.#.#.#
.#...#...#...#...#.#.#.....#.....#...#...#.......#.....#...#...#
.#####.#.###.#.#.#.#.#.#.#.#####.###.#####.#####.#####.#.#####.#
.#.....#...#...#.#...#.#.#...#...#...#.....#.......#...#.#...#.#
.#.#.#####.#.###.#####.#.###.#.###.###.###.#######.#.###.#.###.#
.#.#.#...#.#...#.......#.#...#.#...#...#.#...#...#.#.#...#.....#
.###.#.#.#.#.###########.#.###.#.###.###.###.#.#.#.###.###.#####
...#...#.#.#.#.....#...#.#.#.#...#.#.......#...#.#.....#...#...#
##.#.###.#.###.###.#.#.#.#.#.#####.#######.#####.#######.###.#.#
.#.#.#.#.#.....#...#.#...#.#.....#.........#...#.#.......#...#.#
.#.#.#.#.#########.#.#####.#####.#.#########.#.#.#.#######.###.#
.#.#.#.#...#.....#...#...#.....#.#.#...#...#.#...#...#.#...#...#
.#.#.#.###.#.###.#####.#.#####.#.#.#.#.#.#.#.#######.#.#.###.#.#
.#.#.#...#.#...#.#.....#.#...#.#.#.#.#.#.#.#.....#.....#.#.#.#.#
.#.#.###.#.###.#.#.#####.#.###.#.#.#.###.#.#####.#######.#.#.###
...#.#...#.....#...#...#.#.....#.#...#...#.#...#.......#...#...#
.###.#.#############.#.#.#.#####.###.#.###.#.#.#.#####.###.###.#
.#...#.........#...#.#...#.#.........#.#.#...#.#.....#.....#...#
.#.#######.#.###.#.#.#####.#.#########.#.#####.###.#########.#.#
.#.......#.#.#...#.#...#...#.......#...#.....#...#.#.........#.#
.#######.###.#.###.#.#.###.#########.###.###.###.###.#.#######.#
.#...........#.#.#.#.#...#.#.......#...#...#...#...#.#.#...#...#
.#############.#.#.#####.#.#.#####.###.#.#####.###.#.#.#.#.#.###
...#.......#...#.#.......#...#...#.....#.#.....#.#.#.#.#.#.#...#
##.#.#####.#.###.###############.#######.#.###.#.#.#.###.#.#####
...#.#...#.#.#.....#.................#...#.#.....#.#.#...#.#...#
.###.#.#.#.#.#.#####.#######.#.#######.###.#######.#.#.###.#.#.#
...#.#.#.....#...#...#.....#.#.#.........#.......#.#...#.#...#.#
##.#.###########.#.#######.#.#.#.#############.#.#.#.###.#####.#
.#.#...........#...#.....#.#.#.#...#...#.....#.#.#.#.....#.....#
.#.#.#########.#.#####.#.#.#.#####.#.#.#.###.###.#.#####.#.###.#
...#...#.....#.#.#...#.#...#.#.....#.#...#.#G#...#.#.....#.#...#
.#####.#####.#.#.#.#.#.#.###.#.#####.#####.#.#.#.#.#######.#.###
.#...........#.#.#.#...#.#...#...#.#...#.......#.#.........#...#
.#############.#.#.#####.#.#####.#.###.#########.#############.#
.#.......#...#.#.#...#.#.#.....#.#...#.......#.......#.......#.#
.#.#####.#.#.#.#.###.#.#.###.###.###.#######.#########.#####.#.#
...#.......#...#.....#.....#...............#...............#...#
################################################################
