32
...#...#.................#.....#
.###.#.#.###.###########.#.#####
...#.#...#.#.........#.#.#.....#
.#.#.#####.#########.#.#.#.###.#
.#.#...#.......#.....#...#.#...#
.#.###.###.###.#.#####.###.#.###
.#.........#...#.#...#.#.#.#...#
.###############.###.#.#.#.###.#
.#.....#.........#...#.#.....#.#
.#.#.###.#########.###.#.#####.#
...#.#...#...#.....#...#.#...#.#
####.#.###.#.#.#####.#####.#.#.#
.....#.....#.#...#.........#...#
##########.#.###.#.#############
.....#...#.#...#.#.#...........#
.###.#.#.#####.#.#.#.#########.#
.#.#.#.#.......#...#........S#.#
.#.#.#.#######.###############.#
.#.#...#.......#.....#.......#.#
.#.#####.#######.#.###.###.###.#
.#.....#.#.......#...#...#...#.#
.#.###.#.#.#########.###.###.#.#
.#...#...#.#.......#...#.#.#...#
.###.#####.#####.#.###.#.#.#####
...#...#...#.....#...#.#.......#
##.###.#.###.#######.#.#######.#
...#...#.....#.....#.#.......#.#
.#############.###.#.###.#####.#
.#...........#...#...#...#.....#
.#.#######.#####.#####.###.#####
..G......#...........#.........#
################################
