64
.....#.........#.#.............#.......#.#...........#.......#.#
.###.#.#.#####.#.#.###.#######.#.###.#.#.#.###.#####.#.#.###.#.#
.#.#...#.#.......#...#...#...#.#...#.#...#.#...#.#...#.#.#.#.#.#
.#.#####.#.#########.###.#.###.#####.#.###.#.###.#.###.#.#.#.#.#
...#...#.#.#.........#...#...#.#.....#.#...#.#.....#...#.#.#...#
##.#.#.#.###.#########.#####.#.#.#####.#.###.###.#######.#.###.#
.#...#.#.....#...#...#.#.....#.#.#...#.#...#...#...#...#.#.....#
.#####.#######.#.#.#.#.#.#####.#.#.###.#.#####.###.#.#.#.#.#####
.#...#.........#.#.#.#.#.........#.....#.#.....#.....#...#.....#
.#.#.###########.#.###.#.#########.#####.#.#####.#############.#
.#.#...........#...#...#.....#...#.#...#.#.#...#...#.......#...#
.#.#####.#########.#.#######.#.#.###.#.#.#.###.###.#.#####.#.###
...#...#.#.....#...#...#...#.#.#...#.#...#...#.....#.#...#.#...#
.###.#.#.#.###.#.#####.#.#.#.#.###.#.#######.#######.#.###.#####
.#...#.#.....#.#.....#.#.#...#.#...#...#...#.......#.#...#.....#
.#.###.#######.###.###.#.#####.#.#####.###.#######.#.#.#.#####.#
.#...#.........#...#...#.#.#...#.....#.....#.....#.#.#.#.....#.#
####.#########.#.###.###.#.#.#####.#######.#####.#.#.#.###.#.#.#
.....#.....#...#...#.#.....#.#...#.#.....#.....#.#...#...#.#.#.#
.#########.#.#####.#.#######.#.###.#.#.#.#####.#.#########.#.#.#
G..#.......#.#.#...#.........#...#...#.#.#.................#.#.#
.#.#.#.#####.#.#.###############.#####.###.#################.#.#
.#.#.#.....#.#.#.#.............#...#.#...#.#...#.........#...#.#
.#.#######.#.#.#.#######.#####.#.#.#.###.#.###.#.#######.#####.#
.#...#...#.....#.....#...#...#...#.#...#...#...#.#.....#...#...#
####.#.#.###########.#.###.#.#####.#.#.#####.#.#.###.#.###.#.###
.....#.#.....#.....#...#...#.......#.#...#...#.#...#.#...#.#...#
.#####.#####.#.#.#.#####.#############.#.#.###.###.###.#.#.###.#
...#...#...#...#.#.#.....#.#...........#...#.....#...#.#.#.#...#
.#.#.###.#.#####.###.#####.#.#####.#.###########.###.#.#.#.#.###
.#.#.#...#...#...#...#.#...#...#.#.#.#.........#.#...#.#...#...#
.#.#.#.#####.#.#.#.###.#.#.###.#.#.###.#######.###.###.#####.#.#
.#.#.#.#...#.#.#.#...#...#.....#.#.....#.......#...#.#.#.....#.#
##.#.#.#.###.#.#.###.#.#########.#######.#.#####.###.#.#.#####.#
...#.#.#.#...#.#.#...#...#.......#...#...#.#.....#...#.#.#...#.#
.#.#.#.#.#.###.#.#.#####.#####.#.###.#.#####.#####.###.#.#.#.#.#
.#.#...#...#.#.#.#.....#.#.....#.....#.#.....#.....#...#.#.#...#
.#.#####.###.#.#.#####.#.#.###.#######.#.#######.#.#.#####.###.#
.#...#.......#.#.....#.#...#...#.....#.#.....#...#.#.#...#.#...#
.#####.#######.###.###.#.#######.###.#.#####.#.#####.#.#.#.#.###
.#...#.#.#.....#...#...#.#.....#.#...#...#...#.........#...#.#.#
.#.#.#.#.#.#####.###.###.#.###.#.#.#####.#.#.#####.#########.#.#
...#...#.#.#.....#.#.#...#...#...#.......#.#.#...#...#.....#...#
.#######.#.###.###.#.#######.#.#########.#.###.#.#####.###.#####
.....#...#...#...#.#.....#...#.#.....#...#.....#.#.....#.#.....#
####.#.#####.###.#.#####.#.#####.###.#.#########.#.#####.#####.#
...#...#...#.#...#...#.....#.....#.#.#.....#.....#.......#...#.#
.#.###.#.#.#.###.###.#.#####.#####.#.#.#####.###########.#.#.#.#
.#.....#.#.#...#.....#.#.....#.#.....#.#...#.....#.....#.#.#.#.#
########.#.###.#.#####.#.#####.#.#######.#.#####.#.#.###.#.#.#.#
.........#...#.#.#.....#.#...............#.....#...#.....#.#.#.#
.###########.#.###.#####.#####################.#.#########.#.#.#
.#.......#.#.#...#.#...#...#.....#.........#.#.#.#.........#...#
.#.#####.#.#.###.#.#.#.###.#.###.#.#######.#.#.###.###########.#
.......#.#.......#.#.#.....#...#...#...#...#.#.....#...#.....#.#
########.#######.#.#.###.#####.#####.#.#.###.#########.#.#.###.#
.........#.....#.#.#.#...#...........#.#.#.............#.#.....#
.#######.#.###.###.#.#####.#############.#####.#########.#######
.....#...#.#.#.....#.......#.......#...#...#...#...#.....#.....#
####.#.###.#.###############.#####.#.#.###.#.###.#.#.#########.#
.....#...#.....#.....#.....#.....#...#.....#.#...#...#.......#.#
.#############.###.#.#####.#####.###########.#.#######.#####.#.#
...................#.......#S....#.....................#.......#
################################################################
