16
......G#.......#
.#####.#.#####.#
.#...#.#.#...#.#
.###.#.#.#.###.#
...#.#.....#...#
##.#.#######.#.#
.#.......#...#.#
.#.#######.###.#
...#.....#.#...#
.###.###.#.#.###
.#...#.#...#.#.#
.#.###.#####.#.#
.#.#.....#...#.#
##.#.###.#.###.#
S..#...#.......#
################
