8
..G#...#
.###.#.#
.#...#.#
.#.###.#
...#.#.#
.###.#.#
.....#S#
########
