32
.........#.....#.........#....G#
##.#####.###.#.#####.#####.###.#
...#.....#...#.....#.....#.#...#
.###.#####.#######.#####.#.#.###
.#.........#.......#...#...#...#
.###########.#######.#.#######.#
...#.....#.....#.....#.........#
##.#.###.#####.###.###########.#
...#.#.#.....#...#.#.....#.....#
.#.#.#.#####.###.#.#.###.#.#####
.#.#...#...#.#.#...#...#.....#.#
.###.###.#.#.#.#.###########.#.#
.....#...#.#.#...#...#.....#...#
.#####.###.#.#.###.#.#.###.###.#
...#...#.#...#...#.#...#.#.#.#.#
.###.###.###.#####.#####.#.#.#.#
.#...#.......#S....#.#.....#...#
.#.###.#############.#.#####.###
.#.#.....#.....#.....#...#.....#
.#.#####.#.#.#.#####.###.#####.#
.#.....#.#.#.#...#.....#...#...#
.#####.#.#.#.###.#.###.###.#####
...#...#.#.#...#...#.....#.....#
##.#.#####.###.###.###########.#
...#.....#.#.#...#.#.........#.#
.#######.#.#.###.###.#####.###.#
.#...#.#...#...#.#...#.....#...#
.#.#.#.#####.#.#.#.###.#####.###
...#.........#.#.#...#.#...#...#
##############.#.###.#.#.#.###.#
...............#.....#...#.....#
################################
