64
.#.........#.......#.................#.......#.....#.....#.....#
.#.#######.#.#.#####.###.#.###########.#.###.#.###.#.###.#.###.#
.........#.#.#...#...#.#.#.#...........#...#.#.#.#.#.#...#.#...#
##########.#.###.#.###.#.#.#.#############.###.#.#.#.#.###.#.###
.......#...#.#.#.......#.#.#.#...........#.#...#.#...#...#.#...#
.#####.#.###.#.#########.###.#.#.#######.#.#.###.#######.#.###.#
...#...#...........#.....#...#.#.#.......#.#.#.......#...#...#.#
##.#.#####.#########.#.###.#####.#.#######.#.#.#####.#.#######.#
..G#.#...#.#...#.....#.#...#.....#.#.....#...#.#.....#.#.....#.#
.###.#.#.###.#.#.#####.#.###.#####.#.###########.#####.#.###.#.#
.#...#.#.#...#...#.....#...#...#.#.#...#.........#...#...#...#.#
.###.#.#.#.#######.#######.###.#.#.#.#.#.#####.###.#.#####.###.#
...#...#...#...#.........#.#...#.#.#.#.....#...#...#...#...#...#
##.#####.#####.#.#########.#.###.#.#######.#.###.#####.#.###.###
...#...#.#...#.....#.......#.#...#.....#...#.........#.#.#.....#
.#####.#.#.#.#######.#######.###.#####.#.#####.#######.#.#####.#
.#...#.#.#.#...#.....#.........#.......#.#...#.#.......#.#...#.#
.#.#.#.#.#.###.#.#####.#######.#.#########.#.###.#####.#.#.#.#.#
.#.#.#...#.#.#...#...#.#...#...#.....#.....#.....#...#.#.#.#...#
.#.#.###.#.#.#####.###.#.#.#.#######.#.#########.#.#.###.#.#####
.#.#...#.#.....#.........#.#.....#...#.#.......#.#.#.....#.....#
.#.###.#.#####.#################.###.#.#.#####.###.###########.#
.....#.#.#...#.........#.......#...#...#.#...#.#...#.#.........#
######.#.#.###########.#.#####.###.#####.#.#.#.#.###.#.#.#####.#
.......#.#.......#...#...#...#...#.#.....#.#.#...#.#...#...#.#.#
.#######.#.#.#####.#.#######.###.#.#.#####.#######.#.#####.#.#.#
...#...#.#.#.#.....#.#.........#...#.#.............#.#.#...#.#.#
.#.#.###.###.#.#####.#.###.#######.#.#######.#.#####.#.#.###.#.#
.#.#.#...#...#...#.#.#...#.........#.......#.#.......#.#...#...#
.#.#.#.###.#####.#.#.###.#################.#########.#.###.###.#
.#.#.#.....#...#.#.#...#.#.......#.#.......#.......#.#...#...#.#
##.#.#.#####.#.#.#.###.#.#.#####.#.#.#######.#####.#.###.###.###
...#...#...#.#.#.....#.#.#.#...#.#.#.........#...#.#...#...#...#
.#.#####.#.#.#.###.###.#.#.#.#.#.#.#########.#.###.###.###.###.#
.#.#.....#...#.....#...#.#...#.#.#.....#S..#.#.#...#.......#...#
.#.#.###############.#.#.#####.#.#.###.###.#.#.#.###.#######.#.#
.#.#.#...#.....#.#...#.#.#.....#...#...#.#.#...#.#...#.......#.#
.###.#.#.#.###.#.#.#####.#.#########.###.#.#####.#####.#######.#
...#.#.#.#...#...#.#.....#.#.#.....#.....#.....#.....#...#...#.#
.#.#.#.#.###.###.#.#.#####.#.#.#.#######.#####.#####.###.#.###.#
.#...#.#...#.#...#...#.....#...#.............#.......#...#.....#
.#####.###.#.###.#####.#############.#################.###.#####
...#...#...#...#.#...#.........#...#.....#.......#.....#...#...#
##.###.#.#####.#.#.#.#.#######.#.#.#######.#.###.###.###.###.#.#
.#.....#.......#.#.#...#.#.....#.#.......#.#.#.#...#...#.....#.#
.###############.#.#####.#.#####.#######.#.#.#.###.###.#######.#
.#...........#.#.#.......#.......#.....#...#.#...#...#.....#...#
.#.#######.#.#.#.#######.#########.###.#####.###.###.###.#.#.###
.#.......#.#.#.#.#...#...#...#.....#.........#...#.#...#.#.#...#
.#######.#.#.#.#.#.#.#.###.#.#.###.###########.#.#.###.#.#.###.#
...#.....#.#.#.#...#.#.....#.#...#.#...#.......#...#...#.#...#.#
.###.#####.#.#.#####.#######.###.###.#.###.###.#.###.#######.#.#
.....#...#.#...#...#...#...#...#.#...#...#.#...#.#...#.......#.#
.#####.#.#.###.#.#.###.###.###.#.#.#####.#.#.#.###.###.#######.#
.#.....#.#.#...#.#...#.#...#...#...#...#.#.#.#.#...#.....#.....#
.###.###.#.###.#.###.#.#.###.#######.#.#.###.###.#######.#.#####
...#.#...#...#.#...#...#.......#...#.#.#...#.....#.....#.#.....#
##.#.###.###.#####.###########.#.#.#.#.###.###.###.###.#.#####.#
.#.#...#...#.....#.........#...#.#...#...#...#.#...#.#.#.#...#.#
.#.#.#.#.#####.###########.#####.#######.#.#.#.#.#.#.#.#.#.#.#.#
.#.#.#.#.#.....#...#...#...#...#.....#...#.#.#.#.#.#...#...#.#.#
.#.###.#.#.#####.#.#.#.#.###.#.#####.#.#####.#.###.#.#######.#.#
.......#.#.......#...#.......#.......#.......#.....#.........#.#
################################################################
