16
...#.........#.#
.#.#.#####.#.#.#
.#...#..S#.#.#.#
.#####.###.#.#.#
.....#.#...#...#
.#####.#.#.#####
.#...#.#.#.#...#
.#.#.#.###.#.#.#
.#.#.#...#...#.#
##.#.###.#.###.#
...#.....#...#.#
.###########.#.#
.#G........#.#.#
.#######.#.###.#
.........#.....#
################
