32
....G......#.....#.....#.......#
.###.#####.###.#.#####.#.#####.#
.#...#...#...#.#.#...#...#.....#
.#####.#.###.#.#.#.#.#####.###.#
.....#.#...#...#...#.......#...#
####.#.###.#################.###
.....#.#.#.........#...#...#...#
.#####.#.#########.###.#.#.###.#
.....#.#...#.....#.#...#.#...#.#
.###.#.#.###.###.#.#.#.#.#.#.#.#
...#...#.....#...#.#.#.#.#.#.#.#
##.#####.#####.#.#.#.#.#.#.###.#
.#...#...#...#.#.#.#.#.#.#...#.#
.###.#.###.#.#.###.#.###.###.#.#
.#...#.#...#.#...#.#.......#...#
.#.#####.###.#.#.#.#######.#####
.#.#.....#...#.#.#.....#.#.....#
.#.#.#####.###.#.#####.#.#####.#
.#...#...#...#.#.....#.#.....#.#
.#######.###.#####.#.#.#.###.#.#
.#.........#.....#.#.#.#...#.#.#
.#.#.###########.#.#.#.###.###.#
...#...............#.#...#.#...#
.#######################.#.#.###
...#.....#...#.........#.#...#.#
##.#.#####.#.#.#######.#.#.###.#
.#...#.....#...#.....#.#.#...#.#
.###.#.#############.#.#.###.#.#
.#...#.....#....S#...#...#.#.#.#
.#.#######.#.#####.#######.#.#.#
.........#...#.................#
################################
