64
.....#.......#...#.............#.#.......#...#.....#...#.......#
.###.#.#####.###.#.#.#########.#.#.#.###.#.#.###.#.#.###.#####.#
..S#.#.#...#...#...#.#...#.....#...#.#.#...#.....#.#.........#.#
####.#.#.#####.###.#.#.#.#.#####.###.#.###########.###########.#
...#.#.#.....#...#.#.#.#.#...#.#...#.#...........#.#...........#
.#.#.#.###.#####.#.#.#.#####.#.###.#.#######.#####.#.###########
.#...#...#.......#.#.#.....#.#.....#.......#.....#.#...........#
.#######.#.#########.#.###.#.#####.#######.#.###.#.#.#########.#
.......#.#...#.......#.#.#...#...#...#.....#...#...#.#.......#.#
######.#.###.###.#####.#.#####.#.#####.#######.#####.###.#####.#
.....#...#...#...#...#...#.....#.......#.....#.#.....#...#...#.#
.###.#####.###.###.#####.###.###########.###.#.###.###.#.#.#.#.#
...#.....#.#...#.......#.#...#.....#.......#.#...#.....#.#.#...#
.#.#######.#.#####.###.#.#.###.###.#.#######.###.#######.#.###.#
.#.#.......#.....#...#...#.#.....#.#.#.........#.......#.#.#.#.#
.#.#.#######.###.#####.###.#######.#.#.#######.#######.###.#.#.#
.#...#.#...#.#...#...#.....#.....#...#.#.#.....#...#...#...#...#
.#####.#.#.#.#.#.#.#.#######.###.#####.#.#.#######.#.###.#######
...#...#.#.#.#.#.#.#...#.....#.........#.....#.....#.#.........#
##.#.###.#.#.#.###.###.###.###.#############.#.###.#.#####.###.#
.#.#.....#...#.......#...#.#.#...#.........#...#.#.#.....#.#...#
.#.#.###################.#.#.###.#.#######.#####.#.#####.###.###
.#.#.#...............#...#.#.#...#.#.#...#...#.........#...#...#
.#.###.#############.#.###.#.#.###.#.#.#.###.#########.###.###.#
.#...#.#...#...#...#...#...#.#.#...#...#...#.........#...#.....#
.###.#.#.#.#.#.#.#.#######.#.#.#.###.###.###########.#########.#
...#...#.#...#.#.#.......#.#...#.#.....#.......#...#.........#.#
.#.#####.#####.#######.#.#.###.#.#####.#####.###.#.#########.#.#
.#.#.....#...#.#.....#.#.#...#.#.....#.....#.....#.........#.#.#
##.#.#.###.#.#.#.###.#.#.###.#.#####.#####.###########.#.###.#.#
...#.#.....#.#...#.....#.....#.#...#.#.....#...........#.#...#.#
.#.#.#######.#.###############.###.#.#.#####.#######.#####.#.#.#
.#.#.#...#.#.#.#...#.....#...#...#.#.#...#...#.....#.#.....#.#.#
.###.#.#.#.#.#.#.#.#####.#.#.###.#.#.#####.###.#.###.#.#######.#
.#...#.#...#.#.#.#.#...#...#...#.#.#.....#...#.#.....#.......#.#
.#.###.###.#.#.#.#.#.#.#####.###.#.#####.###.#.#############.#.#
.......#...#.#.#.#...#.#...#.......#...#...#.#.......#.....#...#
.#########.#.###.#####.#.#.#########.#.###.#.###.#####.###.#####
...#.....#.#.#...#...#...#...........#.#...#.#...#...#.#.#.....#
##.#.###.###.#.###.#.#################.#.###.#####.#.#.#.#####.#
.#.#...#.#...#...#.#.......#.#.......#...#.....#...#...#...#...#
.#.###.#.#.#####.#####.#.#.#.#.#.#############.#.#########.#.#.#
...#.#.#...#...#.....#.#.#...#.#.............#.#...#.......#.#.#
.###.#.#####.#.#####.#.#.#####.#######.#####.#.###.#.#####.#.#.#
.....#.#.....#.....#.#.#.#.....#.......#...#.#...#.#...#...#.#.#
##.###.#.#########.#.###.#.#####.#######.###.#.###.###.#.###.#.#
.#.#...#...#.....#.#.#...#.#...#.#.#.....#...#...#...#.#.#...#.#
.#.#.#####.#.#.###.#.#.###.#.#.#.#.#.#.###.###.#.###.#.#.#.###.#
.#.#.....#.#.#.#...#.#.....#.#.#.#...#.#...#.#.#...#...#.#.#.#.#
.#.###.###.###.#.###.#.#####.###.#.###.#.###.#.###.#####.#.#.#.#
.#.#...#...#...#.#...#.....#.#...#...#.#...#...#.#.#...#.#.#.#.#
.#.#.###.###.###.#.#######.#.#.#######.###.#.###.#.#.#.#.#.#.#.#
.#.#.....#.....#.#.#.....#...#.#.....#...#.#...#.#...#...#.#.#.#
.#.#######.###.#.#.#.###.###.#.###.#.#.#.#.###.#.#########.#.#.#
.#.....#.....#.#...#.#.#.#.#.#...#.#...#.#.#.#...#.#...#...#.#.#
.#####.#######.#####.#.#.#.#.###.#.###.###.#.###.#.#.#.#.###.#.#
...#...#.......#.....#...#...#...#.#.#.#...#.......#.#...#...#.#
##.#.###.#####.#.#.###.#######.###.#.#.#.###########.#####.#.#.#
...#...#.#.....#.#G..#.........#...#.#.#.#.....#...#.#.....#.#.#
.#####.#.###.###.###.###########.#.#.#.#.#.###.#.#.#.###.#.###.#
.....#.#...#...#.#...#...#.....#.#.#...#.#...#...#.#...#.#.....#
.###.#.###.###.###.###.###.###.#.#.#####.###.#####.###.#.#######
...#.......#.......#.........#...#...........#.........#.......#
################################################################
