8
.....#.#
.###.#.#
.#.#..G#
.#.###.#
.#.#...#
.#.#.###
S#.....#
########
