16
...#...#...#...#
.#.#.#.#.#.#.#.#
.#.#.#.#.#...#.#
.#.#.###.#####.#
.#...#...#.....#
.#####.###.###.#
.......#...#G#.#
.#######.###.#.#
...#...#...#...#
##.###.###.#####
.........#.#...#
########.#.#.#.#
..S#...#.#...#.#
.###.#.#######.#
.....#.........#
################
