8
G......#
.#######
.......#
######.#
....S#.#
.#####.#
.......#
########
