64
...................#.........#...#.#...#.....#.........#.......#
.#######.#########.###.#.###.#.#.#.#.#.#.#.###.#####.#.#######.#
...#...#.........#...#.#.#...#.#.#...#.#.#.....#.#...#.......#.#
##.###.#########.###.###.#.###.#.#####.#.#######.#.#########.#.#
.#.#.......#.....#.#.....#...#.#...#S#...#.....#.#.#.#.....#.#.#
.#.#.###.###.#####.#########.#.###.#.###.#.###.#.#.#.#.###.#.#.#
.#.#.#...#...#...............#.#...#...#...#...#.#.#.#.#.#...#.#
.#.#.#####.#########.#########.#.#####.#.#####.#.#.#.#.#.#####.#
.#.#.....#.#.......#...#.......#.....#.#.#...#...#.#.#.#.......#
.#.#.###.#.#.#####.#####.#########.#.#.###.#.###.#.#.#.#.#.###.#
.#.#.#...#...#...#...........#...#.#.#.#...#.#...#.#...#.#.#...#
.#.#.#.#.#######.#############.#.#.#.#.#.###.#.###.#.#####.#.###
...#.#.#.........#...#...#.....#...#.#.#...#.#.#...#.#.....#...#
.#####.#########.#.#.#.#.#.#.#########.###.#.###.###.#.#######.#
.......#.......#.#.#...#.#.#.#.......#.....#...#...#.#.......#.#
########.#####.#.#######.#.###.#####.#########.###.#.#######.###
.....#.......#.#...#.....#.......#...#.#.......#...#.......#...#
.#####.#######.###.#.###.#######.#.#.#.#.#######.#########.#.#.#
...#.....#.....#.#.#...#.#.....#.#.#...#.#...#.......#.....#.#.#
.#.#.#####.###.#.#.###.#.#.###.###.#.###.#.#.#.#####.#####.###.#
.#...#.....#.#.#.#.#...#.#.#.#.....#.#...#.#...#...#.#...#...#.#
######.#####.#.#.#.#.#####.#.#####.###.#####.#####.#.#.#.###.#.#
.....#.#...#.#...#.#.#...#.#.......#...#...#.#...#.#...#...#.#.#
.###.#.#.#.#.###.#.#.#.#.#.#######.#.###.#.#.#.#.#.#######.#.#.#
.#.....#.#...#...#.#...#.#...#...#.#.#...#.#.#.#...#.......#.#.#
.#.#####.#####.###.###.#.###.#.#.#.#.###.#.#.#.#####.#######.#.#
.#.#...#.#.......#...#.#...#...#.#.#.....#.#.#.....#.#...#.....#
.###.#.#.#.#########.#####.#####.#########.#.#####.#.#.#.#####.#
.#...#.#.....#.......#...#.....#.........#.#.#.....#.#.#...#...#
.#.###.#####.#.#######.#.###.###########.#.#.#.#.###.#.###.#####
.#...#.....#.#.........#...#.......#.....#.#...#.#...#.#...#...#
.###.#####.###############.###.#####.#.###.#.#####.#.#.#.###.#.#
.#...#...#.........#...#...#...#.....#.#...#.#.....#.#.#.#...#.#
.#.#####.#####.###.#.###.###.###.#.#####.#####.#####.#.#.#.###.#
.#.#.......#...#...#.#.......#...#.#...#.....#.#.....#.#.#.#.#.#
.#.#.###.###.###.###.#.#######.###.#.#.#####.#.#######.#.#.#.#.#
.#...#.#.#...#.#.#...#...#.....#...#.#.....#.#.#.....#.#.#...#.#
.#####.#.#.###.#.###.###.#.###.#####.#####.#.#.#.###.#.#.###.#.#
.......#.#.#.........#...#...#.#...#.#.....#.#...#.#...#.....#.#
.#.#####.#.#########.#.#####.#.#.#.#.#.#####.#.###.###########.#
.#...#...#.........#.#.#...#.#.#.#...#.....#.#.#.............#.#
####.#.###########.###.#.#.#.###.#########.#.#.###########.###.#
.....#.#.......#.#.....#.#.#.....#.......#...#.......#.....#...#
.#####.###.###.#.#######.###############.###########.#.#####.#.#
.#...#.....#...#...........................#.........#.....#.#.#
.#.#.#######.#####.#############.#########.#######.###.###.#.###
.#.#.......#.#...#...#.....#...#.#...#...#.......#.#.#.#.#.#...#
.#.#####.###.#.#.###.#.###.#.#.#.#.#.###.#######.#.#.#.#.#.###.#
.#.#...#.....#.#...#.#.#...#.#...#.#.......#...#.#.#.....#...#.#
.#.#.#########.###.###.#.###.#####.#######.#.###.#.#####.#.#.#.#
...#.............#...#.#...#.#...#.#.....#.#...#.#...#.#.#.#.#.#
.###############.###.#.###.#.#.#.#.#.###.#.###.#.###.#.#.#.###.#
.........#.......#.....#...#...#.#...#.#.#.....#...#.#...#...#.#
########.#.#############.#######.#.###.#.#####.###.#.#######.#.#
.#.......#.#.......#...#.#.....#.#...#.#.....#...#.#...#.....#.#
.#.#######.#.#####.#.###.###.#.#.###.#.#####.###.#.###.#.###.#.#
.#.#.........#.....#...#.....#.#...#.#.....#...#.#G#.#.#...#.#.#
.#.#######.###.#######.#######.###.#.###.#####.###.#.#.###.#.#.#
.#.......#...#.#.....#.#.......#...#...#.....#.#...#.......#.#.#
.#######.###.#.#.###.#.#.#######.#####.#.#.###.#.#############.#
.......#...#.#.....#.#.#.#.......#...#.#.#.#...#.......#.....#.#
.#####.###.#########.#.#.#####.###.###.###.#.#########.#.###.#.#
.....#...............#.........#...........#.............#.....#
################################################################
