32
...............#...........#...#
##############.#.###.#####.###.#
...#...#...#...#.#.#...#.......#
.#.#.#.#.#.#.###.#.###.#########
G#...#.#.#...#...#...#.........#
.#####.#.#####.#####.#########.#
.#...#.#.....#.#...........#...#
.###.#.#####.#.###.#########.###
...#.#.....#.....#.#.......#...#
##.#.#####.#####.#.#.#####.###.#
...#.....#.....#...#...#...#...#
.###.###.#####.###.###.###.#.###
...#...#.....#.#.....#...#.#...#
.#.#####.###.#.#########.#.###.#
.#.....#.#...#.#...#...#.#.#...#
.#####.#.#####.#.#.#.#.#.#.#.#.#
.#.....#.........#.#.#...#...#.#
##.###.###########.#.#########.#
...#...#.........#.#.#...#...#.#
.###.###.#######.#.#.#.#.#.#.#.#
.#...#...#...#...#...#.#.#.#.#.#
.#.###.#####.#.#######.#.#.#.#.#
.#.#...#.....#.......#.#...#...#
.###.###.###########.#.#######.#
...#...#.......#...#.#.....#S#.#
.#.###.#.#####.#.#.#.#######.#.#
.#...#.#...#...#.#.#.........#.#
.###.#.#####.###.#.###########.#
.#.#.#...#...#...#.........#...#
.#.#.###.#.###.#######.#####.###
...#.....#...........#.........#
################################
