32
.....#.......#.........#...#...#
.###.#.#####.###.#####.#.#.#.#.#
...#...#...#...#.#...#.#.#S#.#.#
.#.#####.#.###.###.#.#.#.###.#.#
.#...#...#...#.....#.#.#.....#.#
.###.###.#.#.#######.#.#######.#
...#...#.#.#...#...#.#...#...#.#
######.#.#.#####.#.#.#.#.#.###.#
.......#.#...#...#...#.#...#...#
.###########.#.#######.#####.###
.....#.......#.#.......#.....#.#
.###.###.###.#.#.#####.#.#####.#
.#.#.#...#...#.#...#...#.#.#...#
.#.#.#.###.###.#####.###.#.#.#.#
...#.#...#...#.....#.#...#...#.#
.###.#.#.#########.#.#.#####.#.#
.#...#.#.........#...#.....#.#.#
##.###.#######.#####.#####.###.#
...#...#.......#.......#...#...#
.#######.#.#####.#######.###.#.#
.#.......#.#.....#...#...#...#.#
.#.#########.#######.#.###.#.#.#
.#.....#...#.........#.#...#.#.#
.#.###.#.#.#########.#.#.###.#.#
.#...#...#...........#.#.#...#.#
.###.###############.#.###.###.#
...#.#.............#.#.....#.#.#
.#.###.###########.#.#######.#.#
.#...#...#...#..G..#...#.......#
.###.###.#.#.#.#########.#######
...#.......#.#.................#
################################
