16
.#....S#...#...#
.#.#####.#.#.#.#
.#.#.#...#...#.#
.#.#.#.#######.#
...#.#.......#.#
.###.###.#####.#
...#.....#.....#
##.#####.#.###.#
.#.....#.#.#...#
.#####.###.###.#
.....#...#...#.#
.###.###.#.#.#.#
.#.#...#.#.#.#.#
.#.###.#.###.#.#
.....#.......#G#
################
