64
...#.........#.....#...................#.....#.#...........#...#
.#.#.#######.#####.#.#################.###.#.#.#.#####.###.###.#
.#...#.#...#.......#.#.........#.....#...#.#...#...#.#.#.#.....#
.#####.#.#.#######.#.###.#######.###.###.#.#######.#.#.#.#####.#
...#.....#.#.......#...#.#.....#...#.....#...........#.#...#.#.#
.#.#.#####.#.#########.#.#.###.###.#.#######.#########.#.#.#.#.#
.#.#...#...#.#.........#.#...#.....#.#.....#.....#.....#.#...#.#
##.###.#.###.#.#########.###.###.#####.###.#######.#####.###.#.#
...#...#.....#.#.......#.#...#...#.......#.......#.#.....#.#.#.#
.#########.###.###.#.#.#.#.#######.#############.#.#.#####.#.#.#
.........#...#...#.#.#...#.........#...#.........#.#.#.#.....#.#
.#######.#.#####.###.###.###########.###.#########.#.#.#.#####.#
.#...#...#.#...#.....#.#.............#...#.#.......#.#.#...#...#
.#.#.#.#####.#.#######.#############.#.###.#.#####.#.#.###.#.###
...#.#.......#.......#.....#.....#...#.#.....#.....#.#.....#.#.#
####.###########.###.#.###.###.#.#.###.#.#####.#####.#######.#.#
...#.#...#.#.....#.#...#.#...#.#.#.#S#.#...#...#...#.......#.#.#
.###.#.#.#.#.#####.#####.###.###.#.#.#.#####.###.#.#.#####.#.#.#
.#...#.#.#.#.#...#.........#.....#.#...#.....#...#.#.#...#.#.#.#
.#.###.#.#.#.#.#.#.#.#########.###.#####.#####.###.#.###.#.#.#.#
...#...#.#.#.#.#.#.#.........#.#...#.......#...#...#.#...#...#.#
.#####.#.#.#.#.#.#.#########.#.#.#########.#.###.###.#.#.#####.#
...#...#...#.#.#.#.#.......#...#...........#...#.#.#...#.#.....#
##.#.#######.#.###.#.#########################.#.#.#####.#.###.#
.#.#.......#.#.......#...#...#...........#.....#.#.#.....#.#...#
.#.#.#####.#.#######.#.#.#.#.#.#########.#.#.###.#.#.#####.#.###
...#...#...#.......#.#.#...#...#.#.....#...#.#.#.#.#.....#.#.#.#
.###.###.#####.###.#.#.#########.#.###.#####.#.#.#.#####.#.#.#.#
.#...#...#...#...#.#.#.......#...#...#.......#...#...#.#...#...#
.#####.#.#.#.###.#.#.#######.###.###.#########.###.#.#.#######.#
.....#.#.#.#...#.#.#.....#.#.......#.#.....#...#...#.......#.#.#
####.#.#.#.###.###.#####.#.#######.#.#.###.#.###.#.#######.#.#.#
...#...#.#...#.....#...#.#...#.....#.....#.#.....#.#...#.....#.#
.#.#####.###.#######.###.#.#.#.###########.#.#####.#.#.#######.#
.#.....#...#.#.............#.#.....#.....#.#.#...#.#.#.........#
.#####.###.#.#################.#####.###.#.###.#.###.###########
.#.....#.#.#.#.................#.....#.....#...#...#.......#...#
.#.###.#.#.#.#.#################.#########.#.#####.#######.#.#.#
.#...#.#.#.#...#...........#...#...#.....#.#.#...#...#.....#.#.#
####.#.#.#.#####.#########.#.#.###.#.###.###.#.#.#.###.#####.#.#
.....#...#...#...#.........#.#.....#...#.....#.#.#.....#.....#.#
.#######.###.#.###.#########.#.#######.#######.#.#######.#######
.#.....#...#...#...#...#.....#.#.....#.#.....#.#.....#...#.....#
.#.#######.#####.###.#.#.#.#####.###.#.#.###.#.###.#.#.###.###.#
.#.........#...#...#.#.#.#.#...#...#.#.#.#...#.#...#...#...#...#
.#.#########.#####.#.###.#.#.#.###.#.#.#.#.###.#.#######.###.###
.#.#.....#.....#...#...#.#.#.#.#...#...#.#.#...#.....#.....#...#
.#.###.#.#####.#.#####.#.###.#.#.#######.#.#.#######.#.#######.#
.#.....#.....#.#.....#.#.....#...#...#...#.#.#...#...#...#...#.#
.###########.#.#####.#.#############.#.#.#.#.#.###.###.###.#.#.#
...#.............#.#.#.........#...#.#.#.#.#.#...#.....#...#...#
.#.#####.#######.#.#.###.###.#.#.#.#.#.#.###.###.#######.#######
.#.#...#.#...#.....#...#.#...#...#.#.#.#.........#.....#...#...#
.#.#.#.###.#.#########.#.#.#######.#.#.#########.###.#.###.#.#.#
.#.#.#...#.#...#.....#.#.#...#...#.#.....#.....#.....#.#...#.#.#
.#.#.###.#.###.#.#.#.#.#####.#.#.#.#####.#.###.#######.#.###.#.#
.#.#.#...#.#.#...#.#.#.....#.#.#...#...#.#...#.#...#...#.....#.#
.#.#.#.###.#.#####.#######.#.#.#####.#.#####.#.###.#.#########.#
.#...#.....#.....#.#...#...#.#...#...#.#...#.#.#...#.......#...#
.###########.###.#.#.#.#.###.###.#.###.#.#.#.#.#.#########.#.###
...#.....#...#...#.#.#...#...#.#...#.#...#...#.#...........#...#
##.#.###.###.#.###.#.#####.###.#####.#########.###############.#
.....#....G..#...#.........#...................................#
################################################################
