64
.#.......#.....#...#.......#.............#.#..............G....#
.#.###.#.###.###.#.#.#####.#.#####.#####.#.#.#######.#########.#
.#.#...#.....#...#.#.....#.#.#.#...#...#.#.......#...#.......#.#
.#.#.#########.###.#####.#.#.#.#.#.#.#.#.#####.###.###.###.###.#
.#.#...#.......#.....#...#.#...#.#.#.#.#.#...#.#...#...#.#.#...#
.#.###.#.#######.###.#.###.###.#.#.#.#.#.#.#.#.#.#####.#.#.#.###
.#...#...#.....#.#...#...#.....#.#.#.#.#...#.#.#.....#.#...#...#
.###.#########.#.#####.#########.#.#.#.#####.#######.#.#.#####.#
.#...#.....#...#.......#...#.....#.#.#...#...........#.#.....#.#
.#.###.###.#.#.#########.#.#.#####.#.###.#############.###.###.#
.....#.#.#.#.#.#.......#.#.#.#...#.#.#.#.........#...#...#.#...#
####.#.#.#.#.#.#.###.###.#.#.#.###.#.#.#########.#.###.#.###.###
...#...#.....#.#.#...#...#...#.....#...#.....#...#.....#.#...#.#
.#.#####.#####.###.#.#.#######.#######.#.#####.###.#####.#.###.#
.#.....#.#...#.....#.#.....#...#.....#...#...#...#.#...#.......#
.#####.###.#.#############.#.#####.#.#.###.#.###.#.###.#########
.#...#...#.#...#.....#.....#.#.....#.#.#...#.....#.......#.....#
.#.#.###.#.###.#.###.#.#####.#.#####.#.#.#################.###.#
.#.#...#...#.#...#.....#.....#...#...#.#.........#...#.....#.#.#
.#.###.#####.#.#########.#######.#####.#########.#.#.#.#####.#.#
.#.#.#...#...#.#.....#.#.#.....#...#...#...#.....#.#...#.....#.#
.#.#.###.#.#.#.#.###.#.#.#.###.###.#.#####.#.#####.#####.#.###.#
.......#.#.#...#.#.#.#...#.#.#...#.#.#.....#.....#.#.....#.#...#
.#####.#.###.###.#.#.###.#.#.###.#.#.#.###.#####.#.#.#####.#.#.#
.#...#.#...#.#...#.#...#.#.#...#...#.#.#.#...#...#.#.#.....#.#.#
.#.#.#####.#.#.###.###.#.#.#.#.#.###.#.#.###.#.#.#.#.#.#####.###
.#.#.......#.#.....#.#.#...#.#...#...#.#...#.#.#.#...#.#...#...#
.#.#########.#####.#.#.###.#####.#.###.###.#.#.#######.#.#.###.#
.#.......#.....#...#.#.#...#...#.#.#.....#...#.........#.#.....#
.#######.#.#####.###.#.#####.#.#.#.###.#.#.#############.#####.#
...#.#...#...#...#...#.......#.#.#...#.#.#...#...#.......#...#.#
##.#.#.###.###.###.#######.###.#.###.#.#.###.#.#.#.#########.#.#
.#.#.#.#...#...#...#.....#...#.#...#.#.#...#.#.#.#.#.........#.#
.#.#.#.###.#.#####.#.###.###.#.#####.#####.#.#.#.#.#.###.###.#.#
.....#...#.#...#...#...#...#.#.......#.....#...#.#.#...#.#.#.#.#
####.###.#.###.#.#####.###.###.#######.#####.#####.#####.#.#.#.#
...#.#...#.#...#.....#...#...#...#.....#.....#.....#.....#...#.#
.#.###.#.###.#####.#####.###.###.#.###########.#####.#####.###.#
.#.....#.#...#...#...#...#...#.#.#.#.........#.#...#.#.......#.#
.#####.###.###.#.###.#.###.###.#.#.#.#######.#.#.#.#.#.#######.#
.#.....#...#...#.....#.#...#.....#.#.#...#...#.#.#...#...#...#.#
.#######.###.###.#####.#.#####.###.#.###.#.###.#.#.#######.#.#.#
.............#...#.....#.....#.....#.#...#.#...#.#.#.......#...#
.#################.#########.#######.#.###.#.###.#.#.###########
.#...#.........#...#.#.....#.......#.#...#.#...#.#.#.#...#.....#
.#.#.#.#######.#.###.#.###.#######.#.#.#.#.###.#.###.#.#.###.#.#
.#.#.#...#...#...#...#...#.......#...#.#...#...#...#...#.....#.#
.#.#.###.#.#.#####.#.###.#.#####.#####.#####.###.#.###########.#
.#.#...#.#.#.....#.#...#.#.#...#...#...#.....#...#.......#.#...#
.#.###.#.###.#.###.###.#.#.#.#.#.###.#######.#.###.#####.#.#.###
.#...#.#...#.#.....#.#...#...#.#.#...#.......#.#...#.......#.#.#
.###.#.###.###.#####.#########.###.#####.#######.#.#########.#.#
...#.#...#...#...........#...#...#.#.....#.......#.#.......#...#
##.#.#######.###.#########.#.###.#.#.#.#######.#####.#####.###.#
...#.......#...#.#...#.....#.#...#.#.#...#.....#...#...#.#.....#
.#####.#.#####.###.#.#.#####.#.###.#.###.#.#####.#.###.#.#######
.....#.#.....#.....#...#.#S..#.#...#.#...#.......#.....#.......#
####.#######.###########.#####.#.#####.###.#############.#####.#
...#.........#.....#.....#...#...#.....#.#.....#.......#.#...#.#
.###########.###.#.#.###.###.#.#####.###.#####.#.#####.#.#.#.#.#
...#.......#.#...#...#.#...#.#.#...#.#.......#.#.....#.#...#.#.#
.#.#.#.#####.#.#######.###.#.#.#.#.#.#.#######.#####.#.#####.#.#
.#...#.........#.............#...#...#...............#.......#.#
################################################################
