64
....S#...........#...........#.....#...............#...........#
.###############.#.#####.###.#.###.#########.#.###.#########.#.#
...#.......#...#...#...#.#.....#...........#.#.#.#.......#...#.#
##.#.#####.#.#.###.###.#.#################.###.#.#######.#.###.#
...#.#.....#.#...#.....#.........#.............#.....#.#...#.#.#
.###.#.#####.###.#####.#########.#.###############.#.#.#####.#.#
.#...#.#.#.....#...#.....#.....#.#...#...#.........#.#.#.......#
.###.#.#.#.###.###.#####.#.###.#.#####.#.###.#######.#.#.#######
.....#.#.....#.#.#...#...#...#.#...#...#.#...#...#...#.#...#...#
######.#.#####.#.###.###.###.#.###.#.###.#.###.###.###.###.#.#.#
.#...#.#...#...#...#...#...#.#...#...#...#.#...........#...#.#.#
.#.#.#.#####.###.#####.###.#.#.#######.###.#####.#######.###.#.#
...#.#.......#.#.......#...#.#.#.......#.#.....#...#.....#...#.#
.###.#########.#.#######.#####.#.#######.#.###.###.#.#######.#.#
.#...#.....#...#.#.....#.#...#.#.....#...#.#.#...#.#...#.....#.#
.#.###.#.#.#.#.#.#.#.#.#.#.#.#.#####.#.#.#.#.###.#####.#.#.###.#
.#.....#.#.#.#...#.#.#.#.#.#.....#...#.#.#.#...#.#.....#.#...#.#
.#######.#.#.#######.###.#.#####.#.###.#.#.#.###.#.#####.###.#.#
.#...#...#.#...#.....#.....#.....#.#.#.#...#.#...#.#...#.#...#.#
##.#.#.###.###.#.#.###.#######.###.#.#.#####.#.###.#.###.#.###.#
...#...#.#...#.#.#.......#...#...#.#.........#.....#.....#.#.#.#
.#######.###.#.#########.#.#.###.#.#########.#########.###.#.#.#
.......#.....#.......#...#.#...#.#.....#.....#.......#...#.#.#.#
.#####.#.###########.#####.###.#.#####.###.###.#####.#####.#.#.#
...#...#.#.........#.#.....#...#.#...#...#.#...#.....#.....#...#
##.#.#####.#####.#.#.#.#####.###.#.#####.#.###.#.#####.#####.###
.#.#.......#...#.#.#...#...#...#.#.#.....#.....#...#...#.#...#.#
.#.#######.#.#.#.#.#####.#####.#.#.#.#############.###.#.#.###.#
.#.#.....#.#.#...#.#.....#.....#...#.....#.......#.....#...#...#
.#.#.###.###.#.#####.###.#.#######.#####.#.###.#########.###.###
.#.#.#.#.....#.#...#...#.#.#.....#...#.#.#...#.........#...#...#
.#.#.#.#######.#.#.###.#.#.#.#.#####.#.#.#####.#######.###.###.#
...#.#.....#...#.#...#.#...#.#.#...#...#.....#.....#.....#...#.#
.###.###.#.#.###.###.#.#####.###.#.###.#####.#######.#######.#.#
.#.#...#.#.#...#.#.#...#.....#...#...#...#.#.....#...#...#...#.#
.#.###.#.#####.#.#.#####.#.###.#####.###.#.#####.#.###.#.#.###.#
.....#.#.......#.#.......#.#...#...#.#.....#.....#.....#...#...#
.#####.#.#######.#####.#.###.#####.#.#.#####.#####.#########.#.#
.#.....#.......#.....#.#...#.....#.#...#.#...#.....#.........#.#
##.###.#############.#.###.#####.#.#####.#.###.#####.#########.#
...#.#.#...........#.#...#.....#.#.......#.#...#.....#...#.....#
.###.#.#.#######.###.###.#.#####.#.###.#.#.#.#####.#####.#.#####
.#.....#.....#.#.....#.#.#.......#...#.#.#.#.......#.....#.#...#
.#####.#####.#.#######.#.#############.#.#.#########.#.###.#.#.#
.....#...#.#.....#.......#.........#...#.#.....#.#...#.....#.#.#
.###.###.#.#####.###.#########.###.#.###.#####.#.#.###########.#
.#.#...#.......#...#.#.........#...#...#...#...#...#...........#
.#.###.#######.###.#.###.#######.#####.###.#.#####.#####.#####.#
.#...#.......#...#.#...#.#.....#.....#.#...#.....#.......#...#.#
.###.#######.#####.###.#.###.#######.#.#.#######.#########.#.#.#
.#...#.......#...#.#.#...#...#.........#.......#...#...#...#.#.#
.#.#.#.#.#####.#.#.#.#####.###.###############.###.#.#.#.#####.#
...#.#.#.#.....#...#...#....G#...#.......#...#...#...#.#.#...#.#
####.#.###.#########.###.###.###.#.#####.#.#.###.#####.#.#.#.#.#
.#...#...#.#.....#.....#...#...#.#...#.#...#.#...#.....#...#...#
.#.#####.#.###.#.#.###.###.#.###.###.#.#####.#####.#####.#####.#
...#...#.#...#.#.#.#.#.....#.#...#.#.#.....#.....#.....#.#...#.#
.###.#.#.###.#.#.#.#.#######.#.###.#.#####.#####.#####.###.#.###
.....#.#.....#.#.......#...#.......#.....#.....#.....#.....#...#
######.#################.#.#.#####.#####.#.#.#######.#.#######.#
.....#...#.......#.....#.#.#.#...#.#.....#.#.#.......#.......#.#
.#.#####.#####.#.#.###.#.#.###.#.###.#####.###.###############.#
.#.............#...#.....#.....#.....#.........................#
################################################################
