32
.......#...........#...........#
.#####.###.#.#####.#.#####.###.#
.#...#...#.#.#.....#.#...#.#.#.#
.#.#.###.###.#.#######.#.#.#.#.#
.#.#.#.......#.........#...#.#.#
.#.#.#.#######.#############.#.#
.#.#...#.....#.#...#.....#.....#
.#######.###.###.#.#.###.#######
...........#.....#.....#..G....#
##############################.#
...........#...................#
.#########.#.#################.#
...#.#.....#.#.......#.........#
.#.#.#.#####.#.#####.#####.#####
.#.#.........#.#.#...#...#.....#
.#.#####.#####.#.#.#.#.#.#####.#
.#.#...#.#.....#.#.#.#.#...#...#
.#.#.#.###.#####.#.###.###.###.#
.#...#.#.........#.......#...#.#
.#####.#.#########.#########.#.#
.....#...#...#...#...#.......#.#
##.#######.#.#.#.#####.#######.#
...#.......#.#.#.....#...#...#.#
####.#######.#.#####.###.#.###.#
.....#.....#.#.#.#...#...#.#...#
.#####.###.#.#.#.#.###.###.#.###
.#...#...#S#.#.#.#...#...#.#...#
.###.###.###.#.#.###.###.#.###.#
.#.....#.....#.#.....#...#...#.#
.#.###.#######.#.#####.###.#.#.#
...#...........#.......#...#...#
################################
