8
.....#.#
.###.#.#
G..#.#.#
.#.#.#.#
.#.#...#
.#.#####
.#....S#
########
