8
.......#
.#######
.#....S#
.#.#####
...#...#
.###.#.#
..G..#.#
########
