16
...#...#...#...#
.###.#.#.#.#.#.#
.#S..#...#...#.#
.#############.#
...........#...#
.###.#######.###
...#...#.....#.#
##.###.#.#####.#
.#.#.#...#.....#
.#.#.#####.#.###
...#.....#.#...#
.###.###.#####.#
.#...#.#.#....G#
.#.###.#.#.###.#
...#.......#...#
################
