8
...#..G#
.#.#.#.#
.#.#.#.#
.#.#.###
.#S#...#
.#####.#
.......#
########
