8
.......#
######.#
...#S#.#
.#.#.#.#
.#...#.#
.#####.#
G......#
########
