32
.#.........#.........#.........#
.#.###.###.#.#.#####.#.#####.#.#
.....#.#...#.#.#.....#.#.....#.#
.#####.#####.#.###.#####.#####.#
.#.....#.....#...#.....#.....#.#
.#.#####.#######.#####.#.###.###
.#.#...#.#.....#.....#.#...#...#
.#.#.#.#.#####.#####.#.#######.#
.#...#.........#...#.#.........#
.#############.#.#.#.#####.#####
.......#...#.....#.#.....#.#...#
##.#####.#.###########.#.###.#.#
...#.....#.....#.....#.#.....#.#
####.#########.#.###.#.#######.#
.....#.......#...#S..#.#.....#.#
.#####.###############.###.###.#
.....#.#...........#...#...#...#
####.#.#.#####.#####.###.#.#.#.#
...#.#...#...#.#...#.....#.#.#.#
.#.#.###.#.#.#.#.#.###.#####.###
.#.#...#.#.#.#...#...#.#...#...#
.#####.#.###.#####.#.#.#.#.#.#.#
.....#.#.....#...#.#.#.#.#.#.#.#
.###.#.#######.#.#.#.#.#.#.#.#.#
.#...#.......#.#.#.#...#.#.#.#.#
.#.#########.#.#.#######.#.###.#
.#.........#.#.#.........#.#...#
.#####.#####.#.###########.#.#.#
.#...#.#...#...#.#.........#.#.#
.###.#.#.#.#####.#.#########.#.#
..G..#...#...................#.#
################################
