32
...........#...#...............#
.###########.#.#.#############.#
.....#.......#...#.....#.....#.#
.###.#.###.#######.#.#.#.###.#.#
.#...#...#.#.....#.#.#.#.#.#...#
##.#####.#.#.###.###.###.#.#####
...#...#.#.#.#.#...#...#.#.#...#
.###.#.#.###.#.###.###.#.#.#.#.#
.#...#.#.......#...#...#.#...#.#
.#.###.#########.###.#.#.#####.#
...#...#.........#...#.#.......#
.###.#.#.#########.#.#########.#
.#...#.#.#...#...#.#.......#...#
.#.###.#.#.#.###.#.#######.#.###
.#.#.#.#.#S#...#.#.....#...#.#.#
##.#.#.#.#####.#.###.###.###.#.#
...#...#.......#.....#...#...#.#
.#################.###.#.#.###.#
.................#.#...#.#...#.#
.###########.###.###.###.###.#.#
...#...#...#.#.#...#.#...#.#.#.#
##.#.#.#.#.#.#.###.#.###.#.#.#.#
...#.#...#.#.#.#...#...#...#.#.#
.###.#####.#.#.#.#####.###.#.#.#
.#...#...#.#.#.........#...#...#
.#.###.#.#.#.###.#############.#
.#.#.#.#...#...#.#...........#.#
##.#.#.#######.###.#########.#.#
...#...........#...#.....#.#.#G#
.###############.###.###.#.#.#.#
.....................#.....#...#
################################
