64
...........#...............#.....#.....#.....#.........#.......#
.#######.#.#.###.#########.#.###.#.#.#.#.###.#.###.###.#####.#.#
.......#.#.#.#...#.....#...#.#.#...#.#.#...#.#.#.#...#.....#.#.#
######.#.#.###.###.###.#.###.#.#####.#####.#.#.#.###.#####.#.#.#
...#...#.#.....#.....#...#...#.#...#.....#.#.#.....#.#.....#.#.#
.#.#.###.#####.#########.#.###.#.#.###.#.#.#.#.#####.#.#####.#.#
.#.#.#.#.#.....#...#...#.#.....#.#.....#.#.#...#.....#...#...#.#
.###.#.#.#####.#.#.#.#.#####.###.###.#####.#####.#######.#####.#
...#...#.#...#.#.#...#.....#.#...#...#.......#...#.....#.#.....#
.#.###.#.#.#.###.#######.###.#.###.###.#####.#.#######.#.#.###.#
.#...#.#...#...#.......#.....#...#.#...#...#.#.#.....#...#...#.#
.###.#.#######.#######.#########.###.###.#.#.#.#.###.#.###.#.#.#
...#...#.....#.........#.......#.....#...#.#.#.....#.#.#...#.#.#
##.#########.#########.#####.#.#######.###.#########.#.#.###.###
...#.........#.......#...#...#...#...#...#.......#...#.#...#...#
.###.#######.#.#####.###.#.###.###.#.###.#######.#.###.#.#####.#
.#.......#...#.#.#...#.....#...#...#...#...#...#...#...#.#.....#
.###.###.#####.#.#.###.#########.#####.#.#.#.#.#####.###.#.###.#
...#...#...#...#.#.#.....#.....#...#.#.#.#.#.#.#...#.#...#.#...#
##.#######.#.###.#.#######.###.#.#.#.#.#.#.###.#.#.#.#.###.#####
.#.#.......#.#...#.........#.#.#.#.#...#.#...#...#...#...#.....#
.#.#.###.###.#.#############.#.###.#.#######.#.#############.#.#
...#...#.#...#.........#.....#.#...#.........#.............#.#.#
.###.#.###.###########.#.#.###.#.#########.###############.#.#.#
.#...#...#.....#....S#.#.#.....#...#.......#.....#.........#.#.#
.#.#####.#####.#.#####.#.#########.#########.###.#########.###.#
.#...#.......#...#.....#.#.......#.........#.#.#.....#...#.....#
.###.#.###########.#####.###.###.#########.#.#.#####.#.#.#####.#
...#.#.............#.....#...#.#.........#.#.......#...#.#.....#
##.#.###########.#.#.#####.###.#########.#.#.#####.#####.#####.#
.#.#...#...#.....#.#.#.....#.....#.....#.#...#...#...#.#.....#.#
.#.#.###.#.#.#####.#.#.#####.###.###.#.#.#####.#.###.#.#####.###
...#.#...#.#.#...#.#...#.......#...#.#.#.......#.#.....#...#...#
.#####.###.#.#.#.#.#####.#####.###.###.#########.#####.#.#####.#
...#...#.#.#.#.#...#.....#...#...#...#...#.......#...#...#...#.#
##.#.###.#.#.#.#######.###.#.###.###.###.#.#######.#.###.#.#.#.#
.#.#.#.......#.#.....#.....#.#.#...#.....#.#.#.....#...#.#.#.#.#
.#.#.#########.###.#.#######.#.###.#######.#.#.###.###.###.#.#.#
...#.........#.....#.......#...#...#.......#.....#.#...#...#.#.#
.#########.#.#############.#####.#.#.#######.#####.#.###.###.#.#
.#.......#.#...#.....#...#.......#.#.....#.#...#...#.#...#...#.#
.#.#####.#####.#.###.#.#.#########.#####.#.###.#.###.#.###.###.#
...#.#...#...#.#...#.#.#.#.......#.....#.#.....#.#.#.#.#.#.....#
####.#.###.#.#.#.#.###.#.#.#####.###.###.#######.#.#.#.#.#######
.....#.#...#...#.#...#.#...#...#.....#...#.......#.#...#.......#
.###.#.#.###########.#.#####.#.#######.###.#######.#########.###
...#.#.#...#.......#.#.#.....#.....#.#.....#.....#.........#...#
.#.###.###.#.#####.#.#.###.#######.#.#######.###.###.#####.###.#
.#...#.....#.#...#.#.#.....#.#.....#.......#...#.....#...#.#...#
.###.#######.#.###.#.#######.#.#####.###.###.#.#######.###.#.#.#
.#...#.......#.........#.....#.#.......#.....#.....#.#...#...#.#
##.#.#.###.#############.#.###.#########.#########.#.#.#.#####.#
...#.#.#.#.....#...#.....#.....#...#...#.....#.....#.#.#.....#.#
.###.#.#.#####.#.#.#.###########.#.#.#.#######.#####.#.#.#####.#
...#.#...#...#.#.#.#.#...#.......#...#.........#.....#.#.......#
.#.#####.#.#.#.#.#.#.#.#.#.#####.###############.###.#.#########
.#.....#...#.#.#.#...#.#.#.#...#.........#.......#.#.#.........#
####.#.#####.#.#.#######.#.###.#######.#.#.#######.#.#########.#
.....#...#...#.#.......#.......#.....#.#.#.#...#...#...#.....#.#
.#######.#.###.#######.#.#######.###.#.#.#.#.#.#.#.###.#.#.#.#.#
.......#.#...#...#...#.#.#...#...#.#.#.#.#.#.#...#G..#...#.#.#.#
.#####.#####.#.###.#.#.###.#.#.###.#.###.#.#########.#####.###.#
.....#.......#.....#.......#...#.........#...............#.....#
################################################################
