8
.......#
.#####.#
.#...#G#
.#.###.#
S#.....#
##.#####
.......#
########
