32
.......#.......#.......#.......#
.#.###.#####.#.#.#####.#.#######
.#...#...#...#...#...#.#.......#
.###.###.#.#.#######.#.#######.#
.#.#.#.#...#.#.....#.#.#.......#
.#.#.#.#####.#.###.#.#.#.#####.#
...#.#...#...#...#.#...#...#...#
##.#.###.#.#####.#.#.#####.#.###
...#...#.......#.#.#.#.....#.#.#
######.#######.#.#.#.#.#.###.#.#
.....#.....#...#.#.#.#.#...#...#
.###.#.###.#####.#.#.#####.#####
...#.#.#...#.....#S#.....#.....#
.#.#.###.#.#.###########.#.###.#
.#.#.....#.#.#.........#.#...#.#
##.#########.#.#######.#.#####.#
...#.........#.....#...#.......#
.###.#############.#.#########.#
...#.#...#.......#.#.....#.....#
##.#.#.#.#.###.#.#.#####.#.#####
...#...#.#.#...#.#.#...#.#.....#
.#######.#.#.###.#.#.###.#####.#
...#.....#.#.#.#...#...#.#.....#
##.#.#######.#.#######.#.#.#####
...#.........#.........#.#.#...#
.#.#############.#.#####.#.###.#
.#...............#.#.....#.....#
.###################.#########.#
.....#.........#...#.#.#.....#.#
.###.#.#######.#.#.#.#.#.###.#.#
...#G........#...#...#.....#...#
################################
