64
.......#...........#...#.....#.......#.....#.............#.#...#
.###.#.###.###.###.#.#.#.#.###.###.#.#####.#.###.#######.#.#.#.#
...#.#...#...#...#...#.#.#.......#.#.#...#.....#.#.....#.#...#.#
####.###.###.###.#####.#######.###.#.#.#.#.#####.#####.#.#####.#
.....#.....#.#.#...#...#.....#.#...#...#.#.#...#...#...#.......#
.#########.#.#.###.#.###.###.###.#######.###.#.###.#.#########.#
.#....S#...#.....#.#.#...#...#...#...#...#...#.....#.....#.....#
.#.#####.#########.#.#.###.###.#####.#.###.#########.###.#.#####
...#.#...#...#.....#...#.#...#.#.....#.....#.........#.#...#...#
####.#.###.#.#.#########.###.#.###.#.#######.#########.#####.###
.....#.#...#...#.....#.....#.#...#.#.......#.#...#.........#...#
.#####.###.###.#.###.###.#.#.###.#.#####.###.#.###.###.###.#.#.#
.....#...#...#.#.#.#...#.#.#.....#.#.....#...#.....#.#.#.#.#.#.#
.###.###.#.#.###.#.###.#.#.#######.#######.###.#####.#.#.#.###.#
...#.....#.#.#...#.#...#.#.....#.#.......#...#.......#.#.#...#.#
##.#########.#.###.#.###.###.#.#.#.#####.###.#######.#.#.###.#.#
.#.#.....#...#.....#.#.#...#.#.#.#.#...#...#.......#.#.#...#...#
.#.#.###.#.#####.###.#.#.###.#.#.#.###.#.#########.###.#.#####.#
.#.#.#.#.#.......#...#...#...#.#.#...#.#...#...#...#...#.#.....#
.#.#.#.#.#########.###.###.###.#.###.#.###.#.#.#.###.###.#.#####
...#.#.........#...#.....#.#...#...#.#...#...#...#...#.#...#...#
.###.#########.#.###.#####.###.###.#.###.###########.#.#.###.###
.#.......#...#.#.#...#...#...#.....#.....#...........#...#.....#
.#######.#.#.#.#.#####.#.###.#####.#####.#########.###.###.###.#
.....#...#.#.#.#.......#...#.#...#.#.....#...#.....#...#.....#.#
####.#.#####.#.#########.#.#.#.#.#.#.#####.#.#.#####.###.#####.#
.....#.#.....#.#.......#.#.#...#.#.#...#...#.#...#.#...#...#...#
.#####.###.###.#.#####.#.#.###.#.#####.#.###.###.#.###.###.#.#.#
.#...#...#.#...#...#.#.#.#...#.#.....#.#...#...#.#.......#.#.#.#
.###.#.#.#.#.#####.#.#.#.###.###.###.#.#.#.###.#.#######.###.#.#
.#...#.#.#.#...#...#.#.#...#...#.#.#.#.#.#.#...#.....#.#.#...#.#
.#.###.#.#.###.#.###.#.#######.#.#.#.#.###.#.#######.#.#.#.###.#
.#.....#.#...#...#...#.........#...#.#.....#.....#...#.#.#.#...#
.#.#####.#.#########.###############.###########.#.###.#.#.#.###
.#.#.....#.............#...........#.....#.....#...#...#.#.#...#
.###.###########.#.###.#.#########.#.#####.###.#####.#.#.#.###.#
.#...#.....#...#.#.#.....#.#.....#.#.#.....#.#...#...#.#.#...#.#
.#.###.###.#.#.###.#######.#.###.#.#.#.#####.#.#.###.#.#.#.#.###
.#...#.#.#...#...#...#...#...#...#...#.#.....#.#.....#.#.#.#...#
.###.#.#.#######.#.#.#.#.#.###.#####.#.###.#.#.#######.#.#####.#
...#...#.#.......#.#.#.#.....#.#.....#.....#.#.......#.#.#...#.#
##.#.###.#.#######.#.#####.###.#.###########.#######.###.#.#.#.#
...#.....#.#.......#.....#.#...#.#.........#...#.#...#...#.#...#
.#########.###.#########.#.#.###.#.###.#######.#.#.#.#.###.###.#
.........#...#...#...#...#.#.#...#...#.#...#.....#.#.#.#...#.#.#
########.#.#.###.#.#.#.#####.#.#####.#.#.#.#.#####.#.#.#.###.#.#
.#.......#.#.#.#.#.#...#.....#.#...#.#.#.#.#...#...#.#...#...#.#
.#.#########.#.#.#.#######.###.#.#.#.#.#.#.#.###.#########.#.#.#
...#.........#...#.......#.#...#.#.#.#...#...#...#......G..#...#
.###.#########.#########.#.#.###.#.#.#########.###.#############
.#.#.....#...#.#.......#.#...#...#...#.....#.#.....#...........#
.#.#.###.###.#.#.#####.#.#####.#######.#.#.#.#######.#.#########
.#...#.#.#...#...#...#.#.......#...#...#.#.........#.#.........#
.###.#.#.#.#######.#.#.#########.#.#####.#########.#.#########.#
...#...#.#.........#.#...#.......#.......#...#...#.#.......#...#
##.###.#.#.#####.###.###.#.#.#############.#.#.#.#.#####.###.#.#
...#.#.#.#.....#.#.#...#.#.#...#.......#...#.#.#...#...#.#...#.#
.###.#.#.###.###.#.###.#.#####.#######.#.#.###.#####.#.###.###.#
.#.....#.#.#.#...#.....#.#...#.#.....#.#.#.....#.....#.....#.#.#
.#.#####.#.#.#.#####.###.#.#.#.#.###.#.#.#########.#########.#.#
.#.#.....#.#.#.....#.#...#.#...#.#.....#.#...#.....#.#.....#...#
.###.#####.#.#####.###.###.#####.#######.#.#.###.###.#.###.#.###
.....#...........#.........#...............#.....#.......#.....#
################################################################
