64
.....#...............#.....#.....#.................#.......#...#
.###.#.###.#########.#.#.###.#.#.###.#######.#####.#.#####.#.#.#
...#.#.#.#...#.......#.#...#.#.#...#.....#...#.#...#.....#.#.#G#
.#.###.#.###.#.#######.###.#.#.###.#####.#.###.#.#######.#.###.#
.#...#...#...#...#...#...#...#...#.....#.#.#...#.#...#...#.....#
.###.###.#.#####.#.#.###.#######.#####.#.#.#.#.#.#.#.#.#######.#
...#.....#.....#...#.#.........#.#...#.#.#.#.#.#...#...#.....#.#
##.###########.#####.#.#########.#.#.#.###.#.###########.###.#.#
.#.#.........#.#...#.#.#.#.......#.#.#.....#.......#.....#.#.#.#
.#.#.#######.#.#.#.###.#.#.###.#####.#######.#.#####.#.###.#.#.#
...#...#...#.#...#.#...#.#...#.#...#.......#.#.......#.#.....#.#
.#####.#.###.#####.#.###.###.###.#.###.#####.#########.#.#####.#
.#...#...#.......#...#...#...#...#.#...#...#.#.....#...#.....#.#
.#.#.#####.#####.#####.#.#.###.###.#.#.#.#.#.#.###.#.#####.###.#
...#.......#.....#.....#.#.#...#...#.#.#.#.....#...#.#...#.#...#
############.###########.#.#.###.###.###.###########.#.#.#.#.###
.#.....#.....#...........#.....#...#.#...#...#.......#.#.#.#.#.#
.#.###.#.#######.#######.#########.#.#.###.###.#.#####.#.###.#.#
...#...#.#.......#.#.....#.#.......#...#...#...#.#.....#.#...#.#
####.#.#.###.#.###.#.#####.#.#######.#####.#.###.#.#####.#.###.#
...#.#.#...#.#.#...#.#.....#...#...#...#...#...#.#.#...#.#.#...#
.#.#.#.###.#.#.###.#.###.#.###.#.#####.#.#.###.#.#.###.#.#.###.#
.#...#.#...#.#...#.#...#.#...#.#...#.....#...#.#.#.#...#...#...#
.#######.#####.#.#.###.###.#.#.###.#.#######.#.#.#.#.#######.#.#
.......#.....#.#.#...#...#.#.#...#...#...#...#.#.#.#.....#...#.#
.#####.#####.#.#.#.#.###.#.#.###.###.#.#.###.#.###.###.#.#.#.#.#
...#.#.#.....#.#.#.#.......#...#...#.#.#...#.#.....#...#.#.#.#.#
##.#.#.#.#####.#.###########.#####.#.#.###.#.#######.#####.#.#.#
.#.#.#.#...#.#.#.#.....#.....#.....#.#...#.#.....#...#.....#.#.#
.#.#.#.###.#.#.#.#.###.#.#####.#.#####.###.#####.#.###.#####.#.#
.#...#...#.#...#.#...#.#.#.....#.#.....#...#...#.#.......#.#.#.#
.###.#.###.#.###.###.#.###.#####.#.#####.###.#.#.#######.#.#.#.#
...#.#.....#.#...#.#.#...#.#...#.#...#...#...#.#.#...#.....#.#.#
##.#.#########.#.#.#.###.#.#.#.#####.#.###.###.#.#.#.#######.#.#
...#.#.#.......#...#.#.#.#...#.#...#.#.#...#...#...#...#.....#.#
.###.#.#.###.#.#####.#.#.#####.#.#.#.#.#.#############.#.#######
.#...#.....#.#.#...#.#.#.....#...#...#.#.............#.#...#...#
.#.###.#####.###.#.#.#.#####.#########.#######.###.###.###.#.#.#
...#.....#...#...#...#.......#.....#...#.....#...#.......#...#.#
.#########.###.#######.#####.#.###.#.###.###.#.#########.#.###.#
.#.......#...#.....#...#...#...#.....#...#.#.#.#...#...#.#.#.#.#
.#.#.###.###.#####.#####.#.#########.#.###.#.###.#.#.#.#.#.#.#.#
.#.#.#.......#...#.......#...#.....#.#.#...#.....#...#.#.#.#.#.#
.#.#.#######.#.#########.###.#.###.###.###.#########.#.#.#.#.#.#
.#.#...#.......#.......#.#...#...#...#.....#...#...#.#.#.#...#.#
.#####.#######.#.#####.###.#####.###.#####.###.#.#.###.#.#####.#
.....#.....#...#.#.........#.......#.....#...#.#.#.....#.....#.#
####.#####.#.###.#########.#.#######.#.#####.#.#.###########.#.#
.#...#...#.#...#.#.......#.#.#.....#.#.....#.#.#.........#.#...#
.#.###.#.#.###.#.#.#####.###.#.###.#.#####.#.#.#########.#.###.#
...#...#...#.#.#...#S..#.#...#.#...#.#...#.#.#.#.......#.#...#.#
.###.#######.#.#######.#.#.###.#.###.###.#.#.#.#.#####.#.###.#.#
.....#.#...#.....#.....#...#...#...#.....#.#.#.#.#.#...#...#...#
######.#.#.#.#####.#######.#.#####.#######.#.#.#.#.#.###.#.###.#
.....#...#...#...#.......#.#.....#.......#.#.#.#.#.#.#.#.#...#.#
##.#.#.#######.#.#######.#.#####.#######.#.#.#.#.#.#.#.#.###.#.#
...#.#.....#.#.#.......#.#.#...#.#.....#.#.....#.#.#.#.#.#.#.#.#
.#########.#.#.###.#####.#.###.#.#####.#.#######.#.#.#.#.#.#.###
.#.......#...#.#.#.#.....#.....#.#...#.#.#...#...#...#.....#...#
.#.#####.###.#.#.#.#.###########.#.#.#.#.#.#.#.###.#######.###.#
.#.#.#...#...#.#.#...#...........#.#...#.#.#.#.#...#.....#.#...#
.#.#.#.###.###.#.#########.#######.#####.#.#.#.#.#####.#.###.#.#
.....#.......#.............#...............#...#.......#.....#.#
################################################################
