64
.....#...#.......................#.......#...#.........#.......#
.###.#.#.#.#######.#######.#####.#.#####.#.#.#.#####.###.#####.#
.#.....#G#.#.#...#.#.....#.#.....#...#.#.#.#.#.#...#.......#...#
.#######.#.#.#.#.#.#####.#.###.###.#.#.#.#.#.#.#.#.#########.#.#
.#...#...#.#.#.#.#.......#...#...#.#.#...#.#.#...#.....#.....#.#
.#.#.###.#.#.#.#.###########.###.#.#.#.#####.#########.#.#####.#
...#...#.#.#.#.#.............#...#.#.#.....#...........#...#.#.#
######.###.#.#.#.#########.#####.###.#####.###.###########.#.#.#
.....#.#...#.#.#.#...#.....#...#.#...#...#...#.#...........#.#.#
.###.#.#.###.#.###.#.###.###.#.#.#.#####.###.###.###########.#.#
...#.#.#.#...#...#.#...#.#...#.#...#.......#...#.#.........#.#.#
##.#.#.#.#.#.###.#.###.###.###.#####.#.#######.#.#.#####.#.#.#.#
...#...#...#...#.....#.#.....#...#.#.#.......#...#.#...#.#...#.#
.#############.#######.#.#######.#.#.#######.#####.#.###.#####.#
.....#.......#...#...#.#.#.#.....#.....#...#.........#...#...#.#
.###.#.###.#####.#.#.#.#.#.#.#########.###.###########.###.#.#.#
.#.#...#.#.......#.#...#...#.#.....#...........#.....#.....#...#
.#.#####.#########.#####.###.#.###.#########.###.###.###.#######
...........#.......#...#.#...#.#...#.......#.#...#.....#.......#
##########.#.#######.#.#.#.###.#.###.#####.#.#.#######.#######.#
.....#...#.#.......#.#...#.#...#.....#...#.#.#.....#.#.#.#.....#
.###.#.#.#.#######.#.#####.#.#########.#.#.#######.#.#.#.#.#####
.#...#.#...#.....#.#.#...#...#...#.....#.#.#.......#.#.#.#.#...#
.#.###.#####.###.#.#.#.#.#####.#.#.#####.#.#.#######.#.#.#.#.#.#
.#.#...#...#.#...#.....#.....#.#...#.......#.#.......#.#.#.#.#.#
.#.#.###.#.###.#.#############.#####.#######.#.#.#####.#.#.#.###
.#.#.#...#.....#.....#.........#...#...#.....#.#.#.....#.#.#...#
.#.#.#.#########.#####.#########.#.#.###.#####.###.#####.#.#.#.#
.#.#...#.......#.#...#.....#.....#.#.#...#.......#.#...#...#.#.#
.###.###.#####.###.#.#####.#.#####.#.#.#######.#.#.###.#.###.#.#
...#.#...#...#.....#.......#.#.....#.#...#...#.#...#...#.#.#.#.#
##.#.#.###.#.###############.#.#####.###.#.#.#####.#.###.#.#.#.#
...#.#.#...#.#.......#.......#.........#...#.....#.#.....#...#.#
.###.#.#.#####.#.###.#.###########.###########.#.#.#####.#####.#
.....#.#.#...#.#...#.#.#.........#.#....S#...#.#.#.#...#.....#.#
.#####.#.#.#.#.###.###.#.#######.###.#####.#.#.#.#.#.#.#####.#.#
.....#.#...#.#...#...#.#.......#.#...#.....#.#.#.#...#.#...#.#.#
######.#.###.#.#####.#.#######.#.#.#####.###.###.#####.###.#.#.#
.......#...#...#...#...#.....#.#...#.....#.......#...#.#...#.#.#
.#############.#.#.#####.#.###.#####.#.###########.###.#.#.#.#.#
.#.......#...#.#.#.......#...#...#...#.......#.....#...#.#.#...#
.#.#####.#.#.###.###########.###.###########.#.#####.###.#####.#
.#.#...#...#...#.#...#.....#...#.......#.....#...#...#.........#
.#.###.#######.#.#.###.###.#.#.#######.#.#####.#.#.#########.###
.#.......#...#...#.....#...#.#.....#...#.#.#...#...#.......#...#
.#######.#.#.###########.#.#.#####.#.###.#.#.#######.#####.###.#
.#.....#.#.#...#...#.....#.#...#...#.#...#.........#.#...#...#.#
.#.###.#.#.#.#.#.#.#.#########.#.###.###.#########.#.#.#####.###
...#...#.#.#.#...#...#.......#.#.#.#...#...#.....#...#.....#...#
####.###.#.#.###.#####.#####.#.#.#.###.###.#.###.#########.###.#
.....#...#.#...#.#.....#...#.#.#...#...#...#...#.#...#.......#.#
.#####.###.###.#.#.#####.#.#.#.###.#.###.#####.#.#.#.#.#######.#
.....#...#.#...#.#...#...#...#.#.#.#...#.....#.#...#.#.#...#...#
.###.###.###.#####.###.#####.#.#.#.###.#.###.#.#####.#.#.#.#.###
.#.....#.#...#.....#...#.....#.#.....#.#...#...#.....#...#.#...#
.#.#.###.#.###.#####.###.#####.#####.#.#.#######.#####.###.###.#
.#.#.#...#...#.....#...#.....#.#...#.#.#.#...#...#.....#.....#.#
.#.###.###.#.###.#####.###.###.#.#.#.#.###.#.#.###.#####.#####.#
.#.#...#...#.....#.....#.#.#...#.#.#.#.....#.#.#...#...#.....#.#
.#.#.#############.#####.#.#.#.#.#.#########.#.#.#####.#####.#.#
.#.#.#.....#.....#.#.....#.#.#.#.#.#.......#...#.#.......#.#...#
.#.#.#.###.#.###.#.#.#####.#.###.#.#.###.#######.#.#####.#.#####
.#.....#.....#.....#.......#.....#.....#...........#...........#
################################################################
