16
...........#G..#
.#.#######.#.#.#
.#...#.......#.#
.###.#.#######.#
...#.#.#...#...#
####.#.#.#.###.#
..S#.#.#.#...#.#
.###.###.###.###
.#.....#.#.#...#
.#####.#.#.###.#
...#...#.#...#.#
##.#.###.#.#.#.#
...#.......#.#.#
.#############.#
...............#
################
