64
...................#...............................#...#.....#.#
.#################.#.###.#########################.#.#.#.###.#.#
.#.....#.........#.#.#.#...#...........#...#.....#...#.#...#.#.#
.#.###.#.###.#.###.#.#.###.#######.###.#.#.#.#.#######.###.#.#.#
.#...#.#...#.#.#...#.#...#.#...#...#...#.#...#.......#.....#.#.#
.#.#.#####.#.###.###.###.#.#.#.#.#####.#########.###########.#.#
.#.#.....#.#.....#.......#...#.#.....#...........#.........#.#.#
.#.###.#.#.#############.#####.#####.#############.#######.#.#.#
.#.#...#.#.#.........#.#.#...#.#.....#.............#.....#...#.#
.###.#####.#.#######.#.#.#.#.#.#.#####.#################.#####.#
...#.#.....#.....#...#.....#.#.#.#...#...#.........#.......#...#
##.#.#.#########.#.#########.#.#.#.#.###.#.###.###.#.#####.#.#.#
...#.............#.#.....#...#.#...#.#...#...#.#.#...#...#.#.#.#
.###.#############.#.###.#.###.#.###.#.#######.#.#######.#.###.#
...#...#.....#...#...#...#.#...#...#.#.......#.#.....#...#.#...#
##.#####.###.#.#######.#####.#######.#######.#.#.#.#.#.###.#.###
...#.....#.#.#.....#...#.....#.....#.........#.#.#.#...#...#...#
.###.#####.#.###.###.#####.#.#.###.#####.#####.###.#.###.#####.#
...#.#.....#...#.........#.#.#...#.....#.#.....#...#.#...#.....#
##.#.#.###.###.#########.#.#####.#####.#.###.###.#####.#####.#.#
...#.#.#.#...#...#...#.#.#.....#.#...#.#...#...#.......#...#.#.#
.#.#.#.#.###.###.#.#.#.#.#####.#.###.#.###.###.#####.###.#.#.#.#
.#.#.#...#.....#.#.#.#.#.......#.....#...#.....#...#...#.#.#.#.#
.###.#####.###.#.#.#.#.#######.#.#####.#.#####.#.#.###.#.#.#.###
.....#.....#...#...#.#.........#.#...#.#...#.#.#.#...#...#.#...#
.#####.#####.#######.#.#########.#.#.#####.#.#.#.###.#####.#.#.#
.#...#...#.#.#...#...#.#...#.....#.#.......#.#.#.#.#.....#.#.#.#
.#.#.###.#.#.#.#.#.#.###.#.#.#####.#.#######.#.#.#.#####.#.#.#.#
...#.....#.....#.#.#.#...#...#.....#.#S....#.#.#.#.....#.#.#.#.#
##########.#######.###.#######.#####.#####.#.#.#.#####.#.#.###.#
...#.......#.......#...#...#...#.....#...#.#...#.#.....#.#.....#
##.#.#######.#######.###.#.#.#####.###.#.#.#.###.#.#####.#####.#
...#.......#.......#.#...#.#.....#.#...#.#.#.#...#.....#...#.#.#
.#.#######.#######.#.#####.#####.#.#.###.#.###.###.###.###.#.#.#
.#.#.....#.....#.#...#.......#...#.#...#.#.....#.#...#...#.#.#.#
.###.###.#####.#.#####.#######.###.#.###.#######.###.#.###.#.#.#
.#.....#.....#.....#...#.......#...#.#...#.......#...#.#...#.#.#
.#.#########.#####.#.#.#.###########.#.#.#.###.#.#.###.#.###.#.#
...#...#.....#...#.#.#.#.........#...#.#.#...#.#.#.#...#.#...#.#
.###.#.#.#####.#.#.#.#####.#####.#.###.#.###.#.###.#.#.#.#.###.#
.#...#...#.....#...#.#...#...#...#.#.#.#.#.#.#.....#.#.#.#.....#
##.#####.#.#########.#.#.#####.###.#.#.#.#.#.#######.###.#######
...#...#.#...#.......#.#.#...#.#.....#.#...#.....#.#...#.......#
.###.#.#.###.#.#####.#.#.#.#.#.#.#####.###.#####.#.###.#######.#
.#...#...#...#.#...#.#.#...#...#...#...#...#...#.#...#.#.......#
.#####.###.###.#.#.#.#.#########.###.#######.#.#.#.#.#.#.#######
.....#.#.#.#.#.#.#...#.....#.....#...#.......#.....#.#.#...#...#
.###.#.#.#.#.#.#.###.#####.#.#####.###.###############.###.#.###
.#...#...#.#...#...#...#...#.....#...#.#.......#.....#...#.#...#
.#.#.#####.#######.#####.#######.###.#.#.#.###.#.###.###.#.###.#
.#.#.#.....#.....#.....#.........#.#.#.#.#...#.#...#.....#...#.#
.#.#.#.#####.###.#.###.###########.#.#.#####.#.###.#####.###.#.#
.#.#.#...#...#.#.#.#...#.........#.#.#.....#.#...#.....#...#.#.#
##.#####.#.###.#.#.#.###.###.###.#.#.#####.#.###.#####.###.#.#.#
...#...#...#.....#.#.#...#...#.#...#.....#.#...#.....#...#.#...#
.#.#.#.#####.#######.#.###.###.###.###.###.###.#########.#####.#
.#G#.#.#.....#.....#...#...#...#...#...#.......#...#.....#.....#
.###.#.#.#####.###.#####.###.#.#.###.#.#.#######.#.#.#.###.#####
.....#.#...#...#...#...#.#...#.#...#.#.#.#.#.....#...#.#...#...#
.#####.###.#.#.#.###.#.#.#.#######.#.#.#.#.#.###########.#####.#
.#...#.....#.#.#.#...#.#.#.......#.#.#.#.#.#.#...#.....#.#.....#
.###.#########.#.#.###.#.#.#####.#.#.###.#.#.#.#.#.###.#.###.#.#
...............#...#.....#.....#...#.......#...#.....#.......#.#
################################################################
