64
.........................#...#.......#.......#.....#.....#.....#
##.#####################.###.#.#####.#.#####.#.#.###.###.#.#.###
...#...#.......#.......#...#...#...#...#...#...#.......#...#...#
.###.###.###.#.###.###.###.#.###.#.###.#.#.#################.#.#
.#.#.....#.#.#.....#...#.#.#...#.#...#.#.#.#.......#.......#.#.#
.#.#.#####.#.#######.###.#.#####.###.#.###.#.#####.#.#####.#.#.#
.#.....#...#.#...#...#...#..G....#.#.#.....#.#.#...#...#.#.#.#.#
.#####.###.#.#.###.#####.#########.#.#######.#.#.#####.#.#.###.#
.#...#.....#.#...........#.....#...#.........#.#.......#.#...#.#
.#.#.#######.###########.#.###.###.###########.#########.###.#.#
...#.......#.......#.#...#.#.#.#.......#.....#.#...#.......#...#
.#########.###.###.#.#.###.#.#.#.#####.###.#.#.#.#.#.#####.###.#
...#.....#...#.#...#.#.#...#...#.#.....#...#...#.#...#...#...#.#
##.#.###.###.###.###.#.###.###.#.#####.#.#####.#.#####.#.#.#.#.#
.....#...#.#...#.#...#...#...#...#...#.#.#...#.#.#.#...#.#.#.#.#
.#######.#.###.#.#.#####.###.#####.#.#.#.#.#.###.#.#.###.#.###.#
...#...#...#...#.#...........#.....#.#...#.#.....#.....#.#.....#
####.#.#####.###.#.#######.###.#####.###.#.#############.#######
.....#.......#...#.#.....#.#...#...#...#.#...#...............#.#
.###############.###.###.###.###.#####.#####.###.###########.#.#
...#...........#.......#...#...#.....#.......#...#.......#.#...#
.#.#.#########.#.#########.###.#####.#########.###.#.###.#.###.#
.#...#.......#.#.#.....#.....#.#...........#...#...#.#.....#...#
.#######.#####.###.###.#.#.###.#.###########.#.#.###.#####.#.###
.......#.....#.....#...#.#.#...#...#.........#.#...#...#...#.#.#
######.#####.#######.###.###.#####.#.#########.#######.#####.#.#
.....#.....#.....#...#.....#.....#.......#...#.......#.#.....#.#
.#########.#.###.#.###.###.#####.#######.#.#.#######.#.#.#####.#
...#.....#...#...#...#...#.....#.....#.....#.#.......#.#...#...#
.#.#.###.#####.#####.###.#.#########.#.#######.#######.###.#.#.#
.#.#...#.....#.#...#.#...#.....#...#.#...#...#.#.....#.....#.#.#
.#.###.###.###.###.#.#.#######.#.#.#.###.#.#.#.#.#####.#####.#.#
.#...#...#.........#.#.#.#...#...#.#.#...#.#...#.......#.....#.#
####.###.###########.#.#.#.#.#####.#.#.###.#####.#############.#
...#.#...#.....#.....#.#...#...#.#...#...#.#...#.............#.#
.#.#.#.###.###.#.#####.###.#.#.#.#########.#.###############.#.#
.#...#.#...#...#...#.#...#.#.#.#...........#.............#...#.#
.#####.#.###.#####.#.###.###.#.#######.#####.#####.#######.###.#
.......#...#.#.....#.......#.#.....#...#.#...#...#.........#...#
.#########.#.###.#.#######.#.#####.#.###.#.###.###############.#
...#...#...#.....#.#.....#.#...#.....#...#...#.........#.......#
##.#.#.#.#.#########.###.#.###.#######.#.###.#####.###.###.#####
...#.#...#.#.....#...#...#.....#...#.#.#...#...#...#.#...#.....#
.###.#######.###.#.###.#.#######.#.#.#.#.#.###.#.###.###.#####.#
.#.#.......#.#.#...#...#.#.....#.#.#...#.#...#...#.#...#...#...#
.#.#######.#.#.#####.#####.###.#.#.#####.#########.#.#.###.#.###
.#.......#.#.#.....#.......#...#.#.....#.#...#.......#.....#...#
.#.#######.#.###.#.#########.#.#.#####.#.#.#.#.###############.#
...#.......#.#...#.......#.#.#.#.#.....#.#.#...#...#...........#
####.#####.#.#.#########.#.#.###.#.#####.#.#######.#.#######.#.#
.....#...#.#...#.........#.#.....#...#...#.......#.....#...#.#.#
.#####.###.#####.#########.#########.#.#########.#######.#.#.#.#
.#...#...#...#...#.....#.....#...#...#.........#.........#...#.#
.###.#.#.###.#.###.#####.#.#.#.#.#.#######.###.###############.#
...#...#.....#.#.....#...#.#...#.#.#.....#.#.......#.......#...#
.#.#.#####.###.###.#.#.###.#######.#.###.#.#.#######.#.#####.###
.#.#.#...#...#...#.#...#.#.......#.....#.#.#.......#.#.....#...#
##.#.#.#.#######.#.#####.#######.#######.#.#######.#.#####.###.#
...#.#.#.....#...#.#.........#.#.....#...#.....#...#...#.....#.#
.#####.#####.#.###.#####.###.#.###.###.#######.#.#.###.#.#####.#
...#...#...#.#.#...#.....#.#.....#...#..S#.....#.#...#.#.#...#.#
.#.#.###.#.#.#.#.###.#####.#####.###.#####.#####.#####.#.#.#.#.#
.#.......#.#...#.....#.............#...........#.......#...#...#
################################################################
