64
.......#.....#.......#...........#.........#.......#.......#...#
.###.#.#.#.###.#####.#.#.#######.#.###.#####.#####.#.#.###.#.#.#
.#...#.#.#...#...#...#.#...#...#.#.#.#.......#...#.#.#.#.....#.#
.#.###.#####.###.#.#.#.###.#.#.###.#.#########.#.#.#.#.#######.#
.#.#.#.........#.#.#.#.#.#.#.#.....#.....#...#.#...#.#.....#.#.#
.#.#.#.#########.#.###.#.#.#.#######.###.###.#.#########.#.#.#.#
.#.#...#.........#.....#.#...#.......#.#.....#.........#.#.#...#
.#.#.###.###############.#####.#######.#.#####.#######.###.###.#
.#.#.#...#.....#...#.............#.......#...#.#.....#...#...#.#
.#.#.#.###.###.#.#.#########.###.#########.#.###.###.###.#.#.###
.#.#.#...#.#.....#.....#...#.#...#.........#.....#.#.#...#.#...#
##.#.###.#.###########.#.#.#.#.#.#.###############.#.#.#####.#.#
...#...#.#...#...#.#...#.#.#.#.#.#.#.......#.#.......#.....#.#.#
.#####.#.#.#.#.#.#.#.###.#.###.#.#.###.#.#.#.#.###########.#.#.#
...#...#.#.#.#.#...#.....#.#...#.#...#.#.#...#.....#.....#.#.#.#
.#.#####.#.#.#.###########.#.###.###.###.###.#####.#.###.#.#.#.#
.#.......#.#.#.#.........#.#...#.#...#...#...#...#.#...#...#.#.#
.###########.#.#.#####.#.#.###.###.###.#######.#.#.###.#####.#.#
.#...........#...#...#.#.#...#.#...#...........#.#...#.#.#...#.#
.#######.#####.###.###.#####.#.#.###.###########.###.#.#.#.###.#
.......#.....#.....#...#.....#.#.#.#.....#.#.....#.#...#...#...#
######.#####.#####.#.###.#####.#.#.#####.#.#.###.#.#########.###
.....#.#.....#.#...#...#.#.....#S#...#...#.#.#...#...#.....#...#
.#####.#.#####.#.#####.#.#.###.#####.#.###.#.###.#.#.#.###.###.#
.....#.#.#.....#.....#.#...#.#.#.....#.#...#...#...#...#.....#.#
.###.#.#.#.###.#####.#.#####.#.#.#.#.#.#.#####.#############.#.#
.#.#.#...#...#.....#.#.......#.#.#.#.#.#.....#...#.......#.#...#
.#.#.###########.###.###.#####.###.###.###.#.###.#.#####.#.###.#
...#...#.........#...#.#.......#...#.......#...#.#.#...#.#...#.#
####.#.#.#######.#.###.#########.###.###########.#.#.#.#.#.###.#
.....#.#.#.......#.#.........#...#.....#.......#.....#.#.#...#.#
.#####.#.#########.#.#####.#.#.#.#.#####.#####.#########.#.#.#.#
.....#.#...#.......#.....#.#.#.#...#...#.#.............#.#.#...#
####.#.###.#.###########.#.#.#.#####.#.#.#############.#.#######
.....#.....#...#.........#.#.#.#.#...#...#...#.....#...#.......#
.#####.#######.###.#######.###.#.#.#####.#.#.#.###.#.#########.#
.#.....#.....#...#.#.....#.#...#.#.#.....#.#.#...#.#...#.......#
.#######.###.###.#.###.#.#.#.###.#.#######.#.###.#.###.#.#####.#
.....#.....#...#.#...#.#.#...#...#.........#.....#.#...#...#...#
.###.#.#######.#.###.###.#####.#.#################.###.###.#.###
...#...#...#...#...#.#.......#.#.#...............#...#.....#...#
##.#####.#.#.#####.#.#.#####.###.#.#.###########.#.#.#########.#
.......#.#...#...#.#.#.#...#.....#.#.#...#...#...#.#.....#...#.#
.#######.#####.#.#.#.#.#.#.#####.#.###.#.###.#.#####.###.#.#.#.#
.#.....#.#.....#...#...#.#.......#.....#...#.#.....#...#...#.#.#
.#.###.#.#.#########.#########.###########.#.#####.###.#####.###
.#.#.....#...#.......#.......#.....#.......#.....#...#.#...#...#
.#.###.#####.#########.#####.#####.#.#########.#.###.#.#.#####.#
.#...#.#...#.......#...#...#...#.#.#.#.........#.#...#...#.....#
.###.###.#.#######.#.#####.###.#.#.#.#######.#####.#####.#.#####
...#.#...#.......#...#.....#...#...#.#...#...#.....#...#.#.....#
##.#.#.#######.#.#####.#####.#######.#.#.#.###.#####.###.#####.#
.#.#.#.#...#...#...#...#...#.......#.#.#...#...#.......#...#.#.#
.#.#.#.###.#.#####.###.#.#.#######.#.#.#####.#######.#.###.#.#.#
.#.#...#...#.....#.....#.#.......#...#.#...#.#.....#.#...#...#.#
.#.#####.#.#####.#####.#.#####.#######.#.#.#.#.#.#.#.#.#####.#.#
...#.....#...#.#...#.#.#.....#.....#...#.#.#.#.#.#.#.#.#.....#.#
.###.#######.#.###.#.#.#####.###.###.#.#.#.#.#.#.#.#.#.#.#####.#
.#.....#.....#...#.#.......#...#.....#...#...#.#.#.#.#.#.#..G..#
.#####.#.#####.#.#.#######.###.#################.#.###.#.#.###.#
...#...#...#...#.#.#.....#...#.#...#.............#...#...#.#.#.#
##.#.#####.#.###.#.#.###.#####.#.#.###########.#####.#####.#.#.#
.....#.......#...#.....#.........#.............#...........#...#
################################################################
