8
....G..#
.#####.#
.#.....#
##.###.#
...#.#.#
.###.#.#
S#.....#
########
