8
S..#...#
##.#.#.#
...#.#.#
.###.###
...#...#
##.###.#
......G#
########
