8
.......#
######.#
G....#.#
.###.#.#
...#...#
.#.###.#
.#..S#.#
########
