32
.........#...#.............#...#
.#########.#.#.#######.###.###.#
.#.....#...#.#.#.....#.#...#...#
.#.###.#.###.#.#.#####.#.###.#.#
.#.#.#...#.#...#...#...#.....#.#
.#.#.#####.#######.#.###########
.#.................#...........#
.#################.###########.#
.#.............#.#...#.......#S#
.#.###.#######.#.###.#.###.#####
.....#.#...#.....#...#.#.#.....#
.#####.#.###.#####.###.#.#####.#
...#...#.....#.#...#.....#...#.#
####.###.#####.#.#####.###.#.#.#
...#...#.....#.#.#...#.#...#.#.#
.#.###.#####.#.#.#.#.###.###.#.#
.#.....#...#...#...#...#...#...#
.#######.#####.#######.#.#.#####
...#.........#.#...#.#.#.#.....#
.#.#.#####.###.#.#.#.#.###.###.#
.#.#...#...#.....#...#...#.#...#
.#.###.#.#.#.#######.###.###.#.#
.#.#...#.#.#.#.#...#...#.#...#.#
##.#####.###.#.#.#.#####.#.###.#
...#...#...#.#.#.#.....#.#.#...#
.###.#.###.#.#.#.#####.#.#.#.###
.#...#...#.....#.....#.#.#.#...#
.#.#####.#########.###.#.#.#####
...#G..#.........#.#...#.#.....#
.#####.#########.#.#.###.#####.#
...............#...#...........#
################################
