16
...#...........#
.#.#.#####.#####
.#...#.....#...#
.#####.#####.#.#
.#.....#.....#.#
.#.#####.#####.#
.#...........#.#
.#############.#
...#...#......G#
##.#.#.#.#####.#
S#.#.#.#.#.....#
.###.#.#.#.#####
.#...#.#.#...#.#
.#.###.#.###.#.#
...#.....#.....#
################
