64
.....#.....#.............#.........#.....#...#...#.............#
##.#.#.#####.#.#########.#.#####.###.#.#.###.#.#.#######.#######
...#...#...#.#.......#...#...#.#...#.#.#.....#.#S#.....#.#.....#
.#######.#.#.#######.#.#####.#.###.#.#.#######.###.###.#.#.###.#
.......#.#...#...#.#.#.....#.....#.#.#.......#.#...#.#.#...#...#
######.#.#####.#.#.#.###.#####.###.#.#######.#.###.#.#.#####.#.#
.....#.#.......#.#.#...#.#.....#...#...#...#...#...#.#.......#.#
.###.#.#########.#.###.###.#####.#.###.#.#.#####.###.#########.#
.#.......#.....#.....#.....#.....#.#...#.#.......#.......#...#.#
.#########.###.#####.#######.#######.#######.#####.#.#####.#.#.#
...#.....#.#.#.......#.....#...#...#.#...#...#.....#.....#.#...#
.#.#.###.#.#.#########.#######.#.#.#.#.#.#.#####.#######.#.#####
.#...#...#...........#.......#...#.#.#.#...#...#.#.....#.#.#...#
.#####.#############.#####.#.#####.#.#.#####.#.#.#.#####.#.#.#.#
...#.#.........#...#.....#.#.....#...#.#.....#.#.#.#.....#...#.#
##.#.#####.###.###.#####.#####.#######.#.#####.#.#.#.#########.#
...#.....#...#.#...#...#.....#.........#...#.#.#...#...#.....#.#
.###.#######.#.#.#.#.#######.###.#########.#.#.#####.#.#.#.###.#
.#.#.....#...#...#.#.......#.....#.......#.#.#.....#.#.#.#...#.#
.#.#.###.#.#######.#######.#######.#####.#.#.#####.###.#.###.#.#
.#...#...#.....#.........#.....#...#...#...#...........#...#.#.#
.#####.#######.#########.#.###.#.#####.#####.#############.#.#.#
.....#.......#.......#.#.#.#.#...#.....#.........#.......#.#...#
####.###.###.#######.#.#.#.#.#######.#.#.#########.#####.#.#####
...#...#...#.#.....#.#.....#.......#.#.#.#.#.......#...#...#...#
.#####.###.###.###.#.#######.###.#.#.###.#.#.#########.#######.#
.#...#.#...#...#.#.#...#...#.#...#...#...#.#.#...........#.....#
.#.#.#.#.###.###.#.###.#.#.#.#.#######.###.#.#.###.#####.#.###.#
...#...#...#.....#.#...#.#.#.#...#...#...#.#.#...#.#...#.#.#...#
.#########.###.###.#.#####.#.###.#.#.###.#.#.#####.#.#.#.#.#.###
...#.....#.....#...#.#...#...#.#...#...#...#.......#.#.#...#.#.#
##.#.#.#.###.###.#.#.#.#.###.#.#######.###.#########.#######.#.#
...#.#.#...#.#...#.#...#...#...#.....#...#.....#...........#.#.#
.###.#.###.###.###.#######.###.#.###.###.#####.#.#####.#####.#.#
.#...#...#.....#.....#...#.#.#.#...#...#.......#...#.#.......#.#
.###.###.#######.#####.#.#.#.#.###.###.###########.#.#########.#
...#...#.#.#.....#.....#...#...#...#...#.........#.#.......#...#
##.#####.#.#.#####.#####.#######.###.###.#######.#.###.###.#.#.#
.#.......#.......#.....#.#...#...#.#.....#...#.#.#.#...#.#.#.#.#
.#########.#######.###.#.#.#.#.###.#######.#.#.#.#.#.###.#.#.#.#
.......#...#.....#.#.#.#.#.#...#...#...#...#...#...#...#.#...#.#
.###.###.###.###.#.#.#.###.#######.#.#.#.#.###.#######.#.#####.#
.#.#.....#...#...#...#...#.#.....#...#.#.#.#.#.........#...#...#
.#.#######.###.#########.#.#.###.###.#.#.#.#.###########.###.###
.#.......#...#.......#...#...#.#...#.#...#.#.........#...#...#.#
.###.###.###.#######.#.#.#####.###.#######.#.#######.#.#.#.###.#
.#...#...#...#.....#...#.#.#.....#.........#.....#...#.#.#.#...#
.#.#.#####.#######.#####.#.#.###.###########.###.###.###.#.###.#
...#.#.....#...........#G..#.#.#.....#.........#...#.#...#...#.#
####.#.#####.#.#######.###.#.#.#####.#.###########.#.#.#####.#.#
.....#.#.#...#...#.......#.#...#...#.....#.....#...#...#.....#.#
######.#.#.#####.#########.###.#.#########.###.#.#####.#.#####.#
.......#...#...#...........#...#.#.......#.#.#.#.#...#.#.#.....#
.#######.###.#.#.###########.###.#.#####.#.#.#.#.#.###.#.#####.#
...#.#.....#.#.#.#.....#...#.#...#.#...#...#.#...#.....#.....#.#
.#.#.#.#####.#.#.###.#.#.#.#.###.#.#.#.#####.#.#####.#######.#.#
.#.#.....#...#.#.....#...#.#.#...#...#.....#...#...#.......#...#
.#.#######.###.###########.#.#.#.#########.#####.#.#######.###.#
.#.#.......#...#.........#.#.#.#...#.....#.#.....#.......#...#.#
.#.#.#######.#.#.#######.###.#.###.###.#.#.#.###########.#####.#
.#...#...#.#.#.#.....#...#...#.#...#...#.#...#...#...#.#.#...#.#
.#####.#.#.#.#######.#.###.###.#.###.###.#####.#.#.#.#.#.#.#.#.#
.......#...#.........#.........#.....#.........#...#...#...#...#
################################################################
