32
...................#...........#
################.#.###.#.#####.#
...............#.#...#.#...#...#
.#############.#.###.###.#.#.###
...#.......#...#...#...#.#.#..G#
##.#####.###.#####.###.###.###.#
...#...#...........#.#...#.#...#
.###.#.#############.###.#.#####
.#...#.....#.......#...#.#.#...#
.#.#######.#.#####.#.#.#.#.#.#.#
.#.#...#...#.#...#...#.#.#...#.#
.#.###.#.###.#.#.#######.#.###.#
.......#...#...#.#.......#...#.#
##########.#####.#.###########.#
...........#...#.....#.......#.#
.#########.#.#.#####.#####.#.#.#
...#.....#.#.#...#...#.....#...#
.#.###.#.#.#.###.#.###.#######.#
.#...#.#.#.#.#.#.#.#...#.....#.#
.###.#.#.#.#.#.#.#.###.#.#.###.#
.#.#.#.#.#.#.#.#.#.....#.#.....#
.#.#.#.#.#.#.#.#.#######.#######
...#.#.#...#.#.#.#...#.........#
####.#.#####.#.#.#.#.#########.#
.....#.#...#S#.#...#.....#...#.#
.#####.###.###.#########.#.#.#.#
...#...........#.....#...#.#.#.#
.#.#####.#####.#.#.###.#####.#.#
.#.....#.#...#.#.#...#...#...#.#
.#####.###.#.###.###.###.#.###.#
.....#.....#.......#.....#.....#
################################
