32
...............#.....#.......#.#
.###.#########.#.###.#.#####.#.#
.#...#.#.....#.#...#...#...#.#.#
##.###.#.###.#.###.#######.#.#.#
...#...#...#...#...#.....#.#...#
.#####.###.#####.#.#.###.#.###.#
.#...#.#...#.....#.#...#.#.....#
.#.#.#.#.###.#.#######.#.#####.#
...#.#...#...#...#.....#.....#.#
.###.#.#########.#.#########.#.#
.#.#.#...........#...#...#...#.#
.#.#.###########.###.#.#.#.###.#
...#.#...........#...#.#.#...#.#
##.#.#####.#####.#.###.#.###.###
.#.#.....#.#...#.#.#...#...#...#
.#.#####.###.#.#.#.#######.###.#
.#.....#.....#.#.#.........#...#
.#####.#######.#########.###.###
.....#.......#.........#.#...#.#
.###.#######.#####.###.#.#.###.#
...#.....#...#...#...#.#.#..S#.#
.#.#####.#.###.#.#####.#.#####.#
.#.#.....#...#.#.......#...#...#
.#.#########.#.#.#########.#.#.#
.#...........#.#.#.......#...#.#
.#############.#.#.#####.#####.#
.....#.....#...#.#.#...#.#...#.#
####.#.#.#.#.###.#.###.#.#.#.#.#
.#...#.#.#.#...#.#...#.#...#...#
.#.#####.#.###.#####.#.#########
..G......#...#.................#
################################
