16
.....#.....#...#
.#####.#.#.###.#
G..#...#.#.....#
.#.#.###.#####.#
.#.#.#...#...#.#
.#.#.#.###.#.#.#
.#...#.#.#.#...#
.#####.#.#.#####
.#.#...#.......#
.#.#.#########.#
...#...#....S#.#
##.###.#.#####.#
.#...#.#...#...#
.###.#.###.#.###
.....#.....#...#
################
