16
.........#.....#
.#######.#####.#
.#...#....G..#.#
.#.#.#.#####.#.#
...#.#.#...#...#
.###.###.#.###.#
...#.....#...#.#
##.#########.###
.#.#.......#...#
.#.#######.###.#
...#.....#.#...#
.###.###.#.#.###
...#.#.#.#.#...#
##.#.#.#.#.###.#
.....#.......#S#
################
