16
.....#.........#
.#.#.#.#######.#
.#.#...#.....#.#
.#.#####.###.#.#
.#...#.....#.#.#
.###.#####.#.#.#
...#.#...#.#...#
####.#.#.#.#####
.....#.#.#.#..S#
.#####.#.###.###
.#.....#.....#.#
.#.###########.#
...#...#.....#.#
.###.#.#.###.#.#
..G..#...#.....#
################
