8
S..#...#
##.#.###
...#..G#
.###.#.#
.#...#.#
.#####.#
.......#
########
