64
.......#.#.......#...........#.......#...............#.........#
##.###.#.#.#####.#.###.#####.#.#####.#.#######.#####.#.#####.###
...#.#.#.#...#.#...#...#...#.#.....#...#.#...#.#.....#.#...#...#
.###.#.#.###.#.#####.###.#.#.#####.#####.#.#.###.###.#.#.#.###.#
.#.....#...........#.#...#.#.#...#.......#.#...#.#.#.#.#.#...#.#
.#.###############.#.#.###.#.#.#######.###.###.#.#.#.#.#.#####.#
.#...............#.#.#...#.#...#.......#...#.#.#.#...#...#.....#
.###############.###.#####.#.###.#######.###.#.#.#######.#.#####
...#.........#.#...#...#...#.#...#.#...#...#.#.#.........#.....#
.#.#.#######.#.###.###.#.###.#.###.#.#.###.#.#.###.#####.#####.#
.#.#.....#...#.......#.#.....#.#...#.#.#...#.#...#.#...#.....#.#
##.#####.#.###.#####.#.#.#####.#.###.#.#.###.###.###.#.#.#####.#
.....#...#...#.#...#...#.#.....#...#.#...#.......#...#.#.#.....#
.#####.#####.###.#.#####.#.#######.#.#####.#######.###.#.#.###.#
.....#.....#...#.#.#.....#.....#...#...#.#.#.......#...#.#...#.#
.###.#####.###.#.#.###.#######.#.#####.#.#.#.#######.###.###.###
.#.#.......#.#...#...#.#.....#.#.#.....#.....#...#...#.....#...#
.#.#########.#######.###.#.###.#.#.#####.#######.#.#######.###.#
...#.....#...#.....#.....#.......#.#...#.#.....#.#.#.....#.#...#
##.#.###.#.#.#.#.#.###############.#.#.###.###.#.#.###.#.###.###
...#...#...#...#.#.......#.......#...#.....#.#.#...#...#...#...#
.#####.#########.#.#####.#.#####.###.#####.#.#.###.#.#####.###.#
...#.#.#.......#.#.#...#.#...#.#...#.#...#...#...#.#.#...#...#.#
##.#.#.#.#####.#.###.#.#####.#.###.###.#.###.###.#.#.#.#.###.#.#
...#.#.#...#...#.....#.#.....#...#.#...#.#.....#.#...#G#...#...#
.###.#.###.#.#####.###.#.#######.#.#.###.#####.#.#####.#.#.###.#
...#.....#.#.#...#.#...#.#.......#.#.#.......#.#.#.....#.#...#.#
##.#######.#.#.#.###.#.#.###.#.#.#.#.#######.#.#.#.#####.###.#.#
.#.........#.#.#.....#.#...#.#.#.#.#.....#...#.#.#...#.#...#.#.#
.###########.#.#######.###.###.#.#.#####.#.#####.###.#.###.###.#
.......#.....#...#.......#.#...#.#...#...#.......#...#...#...#.#
####.#.#.#######.#########.#.#######.#.###########.###.#.###.#.#
.....#.#.#...#...#...#.....#.......#...#.........#.#...#...#...#
.#######.#.#.#.###.#.#.#####.#####.#####.#####.#.#.#####.#.#####
.#.....#...#...#...#...#...#.#...#.......#.....#.#.......#...#.#
.#.###.#####.###.#######.###.###.#########.#####.###########.#.#
...#.#.......#...#.....#.....#...#.#.....#.#...#...#.#.....#.#.#
.###.#########.###.###.#.#####.#.#.#.###.#.#.#.###.#.#.#.###.#.#
.........#...#.#.#...#...#.....#.#.#...#.#...#.#.#.#.#.#.#...#.#
####.#####.#.#.#.###.#####.#####.#.###.#.#####.#.#.#.#.#.#.###.#
.#...#.....#...#...#.......#...#...#...#.......#...#...#.#.#...#
.#.###.#########.#.#########.#####.#.###########.#######.#.#.#.#
.....#.#.....#...#...#.....#.#.....#.......#...#.#.......#.#.#.#
.#####.#.###.#.#####.#.#.#.#.#.###########.#.#.#.#.###.###.###.#
...#...#...#.#.....#...#.#...#...#.......#.#.#.#...#...#...#...#
####.#####.#.#.#########.###.###.#.#######.###.#####.###.###.#.#
.....#.....#.#.#.......#...#.#...#.#.....#.#.......#...#.....#.#
.###########.#.#.#####.#.#.###.###.#.###.#.#.#########.#######.#
.....#.....#...#...#.#.#.#...#.#...#.#...#.#.........#.#.....#.#
.###.#.###.#######.#.#.#.###.#.#.###.#.###.#.#######.#.#.#.###.#
.#...#.#.#.#.......#...#.#...#.#.#...#...#.#.......#...#.#.....#
.#.#.#.#.#.#.#######.#####.#.#.#.#.#####.#.#############.#######
.#.#.#...#.#.......#.......#.#.#.#.#.#.....#.......#.....#.#...#
.#.#####.#.#######.#######.###.#.#.#.#.#####.#####.#.#####.#.#.#
.#.......#.#.....#.#.......#.....#.#.#...#...#...#...#.#...#.#.#
.#########.#.###.#.#####.###.#####.#.###.#.#####.#####.#.#.#.#.#
.#.....#.#.....#.#.....#...#...#...#.#...#...........#...#...#.#
.#.###.#.#####.#.###.#.###.#.###.###.#.#############.#.#######.#
.#.#.....#...#.#...#.#.#...#.#...#...#.....#.......#.#.......#.#
.#.#######.#.#.###.###.#####.#.###.#.#.#####.#####.#.#######.#.#
.#.#.....#.#.#.#...#...#.....#...#.#...#.....#.#...#.#.....#.#.#
.#.#.###.#.#.###.###.###.#######.#######.#####.#.###.#.###.###.#
...#..S#...#.....#.............#...............#.......#.......#
################################################################
