64
...#.....#.....#...#.......#.....#.......#.......#.....#.......#
.#.#.#.###.#.###.#.#.#####.#.#.#.###.#.###.#####.#.#.#.#.#####.#
.#...#.#...#.....#.#.#...#.#.#.#...#.#.#...#.....#.#.#.#...#.#.#
.#.#####.#########.#.#.#.#.#.#.###.#.###.###.#####.#.#.###.#.#.#
.#.#...#...#.....#...#.#.#...#...#...#...#.#.#.....#.#...#...#.#
.###.#.###.#####.#######.#######.#####.###.#.###.###.#######.#.#
.....#...#.....#...............#...........#...#.#.#.#.......#.#
.#######.#####.#.#############.###############.#.#.#.#.#######.#
...#...#.....#.#.....#.......#.....#.#.......#.#...#.........#.#
##.###.#.#####.#####.#.#####.#####.#.#.#####.#.###.#########.#.#
...#...#.............#...#.....#...#.#.....#.#...#.#.#...#...#.#
.###.###################.#####.#.###.#####.#.###.#.#.#.#.#.###.#
...#.#...#...#.........#.....#.#.........#.#...#.#...#.#.#...#.#
##.#.#.#.#.#.#.#######.#.###.#.#####.#####.###.#.#.###.#.#####.#
...#...#.#.#...#.....#.#.#...#...#.#.#.....#.#...#.#...#...#...#
.#######.#.#####.#####.#.#.#####.#.#.#.#####.#######.#####.#.###
.#.......#.#.....#.....#.#.#.....#...#.#.....#.....#.#...#.#..G#
.###.###.#.#.#.###.#######.###.#######.###.#.#.###.#.#.###.###.#
.....#.#.#.#.#.#...#.....#...#...#.....#...#...#.#...#.#...#...#
######.#.#.###.#.#####.#.###.###.#.#####.#######.#####.#.###.###
.....#...#...#.........#.#...#...#.#...#.......#.......#...#...#
.###.#.#####.###########.#.###.###.#.#.#.#####.#.#####.###.#.#.#
.#...#...#.#.......#...#...#.#.....#.#.#...#...#.....#.....#.#.#
##.#####.#.#######.#.#.#####.#######.#.###.#.#######.#########.#
...#.....#.......#...#.#.......#...#.#.#...#...#...#...#.......#
.#.#.#######.#.#####.#.#.#.#####.#.#.#.#.#####.###.###.#.###.#.#
.#.#...#.....#.#...#.#.#.#.......#.#.#...#.....#...#...#...#.#.#
.#####.#.#####.#.#.###.#.#######.#.#.#####.#####.#.#.#######.###
.....#...#S#...#.#.#...#.#.....#.#.#.....#.#.....#.#.#.....#...#
##.#.###.#.###.#.#.#.###.#.###.###.###.###.#.###.#.#.#.###.###.#
...#...#.#...#.#.#.#.#...#...#.....#...#...#.#.#.#.#...#.#.....#
.#######.###.#.#.#.#.#.#####.#####.#.###.###.#.#.#######.#####.#
...#.....#.#.#.#.#...#...#.#.#.....#...#.#.#.#.#.#...........#.#
.#.#.#####.#.###.#######.#.#.#####.#.###.#.#.#.#.#.#######.###.#
.#.#.....#.#.....#...#.....#.....#.#.#...#...#.#...#...#...#...#
##.#####.#.#######.###.#####.###.###.#.###.###.#####.###.###.###
.......#...#...........#...#...#.....#.#...#...........#.....#.#
.#.#######.#####.#######.#.#########.#.#.#####.#######.#######.#
.#.#.....#.....#.#...#.#.#.........#.#.#.....#.#...............#
.###.###.#####.#.#.#.#.#.#########.#.#.#####.#.#.#############.#
.....#.#.#.....#.#.#...#...#.......#.#.#.#...#.#...#...........#
.#####.#.#.#####.#.#######.#.#######.#.#.#.#####.#.#.###########
.......#.#.#.....#.....#...#...#...#.#.#.......#.#.#.........#.#
####.###.#.#####.#####.#.#####.#.#.#.#.#######.###.#########.#.#
...#.#...#.....#.......#.#...#.#.#.#.#.......#.....#...#...#...#
.#.#.#.#######.#######.#.###.#.###.#.#######.#######.#.###.###.#
.#...#.......#.#...#...#.#...#...#.....#...#...#.....#...#.#...#
.#########.#.#.#.###.###.#.#####.#######.#.#.#.#.#######.#.#.###
.#...#.....#.#.#.....#...#.....#.......#.#.#.#.#.....#.....#...#
.#.#.#.#.#####.#.#####.#######.#######.#.#.###.#####.#.#######.#
.#.#...#.#.....#.#...#.......#.......#...#.....#.....#.#.....#.#
.#.###.###.#####.#.#########.#.#.###.###########.#####.#.#.###.#
.#...#.#...#.#...#...#...#...#.#...#...........#.....#.#.#.....#
.###.###.###.#.#####.#.#.#.###.###.###########.#.###.#.#.#######
.#...#...#...#.......#.#.#...#...#.#.......#...#.#.#.#.#.#.....#
.#.#.#.###.#.#######.#.#.###.###.#.#.#####.#.###.#.#.###.#.###.#
.#.#.#.#.#.#.....#...#.#.....#.#.#...#.....#...#.#.#...#.#.#...#
##.#.#.#.#.###.#.#.###.#######.#.#####.#.#######.#.###.#.###.#.#
...#.#.#.....#.#.#.#...#.......#.#.....#.#.....#.#.#...#...#.#.#
.#####.#######.###.#.#####.#####.#.###.###.###.#.#.#.#####.#.#.#
.#...#.#.....#.....#.....#.#...#.#...#.#...#.#.#...#.....#.#.#.#
.#.#.#.#.###.###########.#.#.#.#.###.###.###.#.###.#####.#.#.#.#
...#.....#...............#...#.....#.........#.........#.....#.#
################################################################
