32
.............#.........#.......#
####.###.#####.###.#####.#.#####
...#...#.#.....#.#.#.....#.....#
.#.###.#.#.#####.#.#.#########.#
.#...#.#.#.....#.#...#...#...#.#
.###.#.#.#####.#.#####.#.###.#.#
...#.#.#.....#.#.......#.#...#.#
##.#.#######.#.#.#.#####.#.###.#
...#.#.....#...#.#.#...#...#...#
.###.#.###.#.#####.#.#.#####.#.#
.#.#...#...#.....#.#.#.......#.#
.#.#####.#######.#.#.###########
.#.....#.#.....#...#.#...#.....#
.#.###.#.###.#.#####.#.#.#.###.#
.#...#.#.#...#.....#...#.#..G#.#
.#####.#.#.#######.#.###.#.###.#
...#...#...#.......#...#...#...#
##.#.#######.#########.#####.#.#
...#.....#...#.#.....#...#...#.#
.###.###.#.###.#.###.###.#.###.#
...#.#...#...#...#.#.#...#...#.#
##.#.#.#.###.#.###.#.#.#####.#.#
...#.#.#.#.#.#...#.#.#.....#.#.#
.###.#.#.#.#.###.#.#.###.###.#.#
...#.#.#...#...#...#.....#...#.#
.#.###.###.###.###.#######.###.#
.#...#...#.#...#.......#...#...#
####.###.#.#.#########.#.###.###
...#.#...#.#.........#.#.#...#.#
.#.#.#.#############.###.#.###.#
S#...#...................#.....#
################################
