64
.........#.....#.....................#.....#.....#.......#.....#
.#.#####.#.###.#####.###############.#.###.#####.#.#####.#.###.#
.#...#.....#...#.....#.........#.....#...#.....#.#.#...#.....#.#
####.#######.###.#####.#.#####.#.#######.#####.#.#.###.#######.#
.....#.....#.....#.....#...#...#.#.......#...#.#.#...#.....#...#
.#####.###.#######.#######.#.###.#.#.#####.#.#.#.###.###.#.#.#.#
.#...#...#.#.#...#.......#.#...#.#.#.#.#...#.#.#...#.....#.#.#.#
.#.#.###.#.#.#.#.###.#####.#####.###.#.#.#.#.#.#.#######.###.#.#
...#.#...#.#...#.....#...#.....#.....#...#.#.#.#.#.......#...#.#
####.#.###.#.#########.#.#####.#######.###.###.#.#.#######.###.#
...#...#.#.#.....#.....#.....#.....#.....#...#.#...#.....#...#.#
.#.#####.#.#######.#########.#.#.#.#########.#.#.#######.###.#.#
.#.......#.......#.......#...#.#.#.....#...#.#.#.......#.#...#.#
.#.#####.#######.#.#####.#.#####.#####.#.#.#.#.#######.#.#.###.#
.#...#.....#...#.#.#.....#.#...#...#.#...#.#.#.....#...#.#...#.#
.###.#######.#.#.#.#.#####.#.#.###.#.#####.#.#####.#.###.###.#.#
.#.#...#.....#.#.#.#.#...#...#.....#...#...#.#.....#.#.....#.#.#
.#.###.#.#####.#.#.#.###.#############.#.###.#.#####.###.#.#.###
.#...#.#.....#...#.#...#...............#.....#...#.....#.#.#...#
.###.#.#####.#####.###.#####.#.#############.###.#####.#.#.###.#
.....#.....#.#...#...#.....#.#...........#.....#...#.#...#...#.#
.#######.###.#.#####.#####.#######.#####.#.#######.#.#####.###.#
.#.......#...#.#...#.#...#...#...#.....#.#.#.......#.......#...#
.#.#######.###.#.#.#.#.#.###.#.#.#######.#.#.###############.#.#
.#.....#...#.....#...#.#...#...#...#...#...#.#...#.....#.....#.#
.#####.#.###########.###.#.#######.#.#.#.###.#.#.#.###.#.#####.#
...#...#...#......S#...#.#.#.....#...#.#.#...#.#.#...#...#...#.#
##.#.#####.#.#########.#.#.###.#.#####.#.#.###.#.#.#.#######.#.#
...#.....#.#.......#.#...#.#...#.#.....#.#.#...#.#.#.....#...#.#
.#####.###.#######.#.#####.#.#####.#######.#.#.#.#######.#.###.#
.#...#.#.......#.#.#.......#...#...#.....#.#.#.#.....#...#...#.#
.#.#.#.#.#####.#.#.###.#######.#.#.#.###.#.###.#####.#.#####.#.#
...#.#.#...#.....#...#.#.......#.#.#.#.#.#...#...#.#.#.#.....#.#
.#####.###.#.#######.#.#.#######.###.#.#.###.###.#.#.#.#.#####.#
.#...#.#...#...#.....#...#.....#...#...#.....#...#.#...#.......#
.#.#.#.#.#####.#.#######.#.###.#.#.###.#######.###.#####.#######
.#.#...#...#...#.#.......#...#.#.#...#.#.....#.#.......#.#.....#
.#.#.#####.#.###.###.#######.#.#.#.###.#.###.#.#.#####.#.###.#.#
.#.#.#.....#...#...#.#.#.....#.#.#.#...#.#.#...#.#...#.#...#.#.#
.#.#.#.###########.#.#.#.#####.###.#.###.#.#####.#.#.#.###.#.#.#
.#.#.#.............#...#...#...#...#.....#...#.....#.#...#...#.#
.#.###################.###.#.###.#.#######.###.#####.#########.#
.#.......#...........#.#...#.#...#...#...#.#...#...#.........#.#
####.###.#########.###.#.###.#.#.###.#.#.#.#.###.###########.#.#
.....#.#...#.......#...#.#...#.#.#...#.#.#.......#...........#.#
.#####.###.#.#####.#.###.###.###.#.###.#.#########.###########.#
...#...#...#.....#.#.#.#...#.....#...#.#.....#.....#...........#
.#.###.#.#####.#.###.#.###.#########.#.#####.#.###.#.###########
.#...#.......#.#...#...#.#.#.....#...#.#.....#.#...#.........#.#
.###.#######.#.###.###.#.#.#.###.#.###.#####.#.#############.#.#
...#.#...#...#...#...#.#.#.#...#.#...#.....#.#.#.........#.#...#
.###.#.#.#.#####.###.#.#.#.#####.###.#####.#.#.#.#.#####.#.###.#
.#...#.#.#.#.......#.#.#.#.....#.....#.....#...#.#.....#...#.#.#
##.#.#.#.#.###.#####.#.#.#####.#.#####.#####.###.#####.###.#.#.#
...#.#.#.#...#.#.....#.#.....#.#...#.......#.#...#.#...#.....#.#
.#.###.#.###.###.#####.#.#####.###.#######.#.#.###.#.###.#####.#
.#.#...#.#.#.....#.....#...#...#...#.......#.#...#.#...#.#.....#
.###.###.#.#####.#.#####.#.#.#####.#.#######.###.#.###.###.#####
.#...#...#.......#.....#.#.#.....#...#.......#...#...#...#.#...#
.#.###.###############.###.#####.#####.#####.#.#####.###.#.#.###
.#.#.#.#.........#.....#...#.#...#...#.#...#.#.......#.#...#...#
.#.#.#.#.#######.#.#####.#.#.#.###.#.###.#.#########.#.#######.#
.....#.........#.........#...#.....#.....#....................G#
################################################################
