64
.#.........#.............#...#.......#.......#.....#.......#...#
.#.#####.###.###.#########.#.#.#.###.#.#.###.#.#####.#.#####.#.#
.#.#.....#.....#.....#.....#.#.#...#.#.#...#.#.......#.#...#.#.#
.#.#.###.#.#########.#.#####.#.###.#.#####.#.#########.#.#.#.#.#
...#...#.#.#.#.......#.#.#...#.#.#.#.......#.........#...#...#.#
.#####.#.#.#.#.#######.#.#.###.#.#.#################.#####.###.#
.#...#.#.#...#.....#...#.#.....#.#...#.........#...#.....#.#...#
.#.###.#.###.#####.#.###.#######.###.#.###.#.###.#.#####.###.#.#
.#.#...#..G#...#...#...#.....#...#...#.#...#.#...#.....#...#.#.#
.#.#.###.#####.#.#.###.###.#.#.#.#.###.#.###.#.###.#######.#.#.#
.#.#...#.#.....#.#...#.#...#.#.#.#...#.#...#.#.#.#.#.....#...#.#
.#.###.###.#####.###.#.#.#####.#.###.#.###.###.#.#.#.###.#####.#
.#...#.......#...#.#.#.#.#.....#...#.#...#.....#.#.#.#.#.....#.#
.#.###########.###.#.#.#.#.#######.#.###.#######.#.#.#.#.###.#.#
.#.........#...#.....#.#.........#.#.#...#.#.....#.#.#.#...#.#.#
.#.#####.#.#.###.#####.#########.#.#.#.###.#.###.#.#.#.###.###.#
.#...#...#.#...#.#...#...#.......#.#.#.#.....#...#.......#.#...#
.#####.###.###.#.###.###.#########.#.#.#####.#.#.#######.#.#.###
.......#...#.#.#.......#...#.......#.#.....#.#.#...#...#.#.....#
.#########.#.#.#######.###.#.#####.#.#####.###.#.###.#.#########
.#...#...#...#.#.....#.#...#.#.#...#.#.........#.#...#.........#
##.#.#.#.#####.#####.#.#.###.#.#.###.#############.#######.###.#
...#.#.#.....#...#...#.#.#...#...#.#...........#...#.....#.#...#
.###.#.#####.###.#.#.#.#.###.###.#.###########.#.###.###.###.#.#
.#.#...#.#.......#.#.#.#...#...#.....#.....#...#...#...#.....#.#
.#.#####.#.#######.###.###.###.#####.#.###.#.#####.###.#######.#
.#.......#.#.....#.......#...#.#...#.#.#...#.....#...#.#.....#.#
.#.#####.#.#.###.#.#########.#.#.#.###.#.#.###.#####.#.###.#.#.#
.#.#...#...#.#...#.#.........#...#.#...#.#...#...#...#...#.#...#
.###.#.#.###.#.#####.#############.#.###.#.#####.#.#####.###.###
.....#.#...#.#.....#...#.....#.....#...#.#.#.....#.....#...#...#
.#####.###.#.#####.###.###.#.#.#######.#.#.#.###.#####.###.#####
.....#...#.#.#...#...#...#.#...#.......#.#.#...#.#.....#...#...#
####.###.#.#.###.###.###.#.###.#.#######.#.###.###.#####.###.#.#
...#...#.#.#.#...#...#.#.#.#...#.....#...#...#.....#...#.....#.#
.#####.#.###.#.###.#.#.#.#.#######.###.#############.#.###.###.#
.....#.#...#.#...#.#.#.#.#.........#...#.....#.....#.#...#.#...#
##.###.###.#.#.#.#.#.#.#.#.#########.#.#.###.#.###.#.###.###.#.#
...#...#.#...#.#.#.#...#.#.......#...#.#...#...#.#.#.#.#.....#.#
.###.###.#######.#.###.#.#.#######.###.###.#####.#.#.#.#######.#
.....#.......#...#...#.#.#.#.......#.#.#.#.....#...#.#.....#...#
.#####.#####.#.#####.#.#.###.#######.#.#.#####.#.###.###.###.###
...#.....#.....#...#.#.#.#...#.....#...#...#.#.#.#.....#.#...#.#
##.#####.#######.#.#.###.#.###.#####.###.#.#.#.#.#####.#.#.###.#
.#.#...#.......#.#...#...#.#.#.......#...#...#.#.......#...#...#
.#.#.#.#####.#.#.###.#.###.#.#.#######.#######.#########.###.#.#
.#...#.....#.#.#.#...#.#...#...#.......#...#...#.......#...#.#.#
.#########.#.#.#.#####.#.###.###.#####.#.#.#.###.###.#####.#.#.#
.....#.....#.#.#.....#.#.#...#...#.....#.#.#.#.#...#.......#.#.#
.###.#.#####.#.#####.#.#.#.###.###.###.#.#.#.#.###.#########.#.#
.#.#.#.....#.#.....#...#.#.#.....#.#...#.#...#.......#.......#.#
.#.#.#####.#######.#####.#.#######.#.###.#.#########.#######.#.#
...#.....#...#...#.......#.........#...#.#.#.......#.........#.#
##.#.#######.#.#.#.#####.###.#########.#.###.#####.###########.#
.#.#...#.....#.#.#.....#.#...#...#.....#.#.......#.#...#...#...#
.#.###.#.#####.#.#####.#.#####.#.###.###.#.#####.#.#.###.#.#.###
...#...#.#.....#.#...#.#...#...#...#...#...#...#.#.#.#...#...#.#
.###.#.#.###.###.#.#.#####.#.#####.#####.###.#.###.#.#.#######.#
.#...#.#.#...#.#...#.....#.#.#...#.#...#.#...#.#...#...#.....#.#
##.###.#.#.###.#########.#.#.#.#.#.#.#.###.###.#.###.#####.#.#.#
...#...#...#.....#...#...#.#.#.#.#...#...#...#...#.#.#.....#...#
.###########.###.#.#.#.###.#.#.#.#######.###.#####.#.###.#####.#
...............#...#.......#S#.#.............#...........#.....#
################################################################
