64
.....#.............#.....#.......#.....#.......#.........#.....#
.#####.#####.#####.###.#.#.#####.#.#.#.#####.#.###.#####.#.###.#
.......#...#...#.#.#...#.#.#...#.#.#.#.#...#.#...#.#.....#.#.#.#
.#########.###.#.#.#.###.#.#.#.#.###.#.#.#.#.###.#.#.#####.#.#.#
.#.......#.#...#...#.#.#...#.#...#...#.#.#...#...#.#.....#...#.#
.#.#.###.#.#.###.###.#.#####.#####.###.#.#####.#####.###.###.#.#
.#.#.#.#...#.#.#.#...#.#.....#.....#.....#...#.#...#...#...#.#.#
.###.#.#.###.#.#.#.#.#.#.#######.#########.#.#.#.#.###.#.###.#.#
.#...#...#...#.#.#.#.#.........#.......#...#.#...#...#.#...#.#.#
.#.#.#####.###.#.#.#.#########.#.#####.#.#.#########.#####.#.#.#
...#.#...#.#.....#.#.....#.....#...#.#.#.#.........#.....#...#.#
.#####.#.#.#.#######.###.#.#######.#.#.#.#########.#####.#####.#
.#.....#.#.#.#.....#.#...#.......#...#.#.....#.......#...#.....#
##.#####.#.#.###.#.#.#.###.#####.#####.#####.#.#####.#.###.#####
...#...#...#.....#.#.#.#...#...#.....#.#...#.#...#...#.#...#...#
.###.#.###########.#.#.#.###.#.#####.#.###.#.###.#####.#.#.#.#.#
.#...#.....#.....#.#.#.#.#...#.#...#.#.#...#.#.#.....#.#.#..G#.#
.#.#######.#.###.#.###.###.###.###.#.#.#.#.#.#.#####.#.#.#####.#
...#...#...#.#...#...#.....#...#...#...#.#.#.#...#...#.#.#...#.#
####.#.#.###.#.#####.#######.###.#######.###.#.###.###.###.#.#.#
.....#.#.#...#.......#.......#.........#.#...#...#.....#...#...#
######.#.###.#######.#.###########.###.#.#.#####.#######.#####.#
.......#...#.#.#...#.#.....#.....#...#...#.#.......#.........#.#
.###.#####.#.#.#.#.#.#####.###.#.###.###.#.#.#.###.#####.###.#.#
.#...#.....#.#.#.#.#.......#...#.....#...#.#.#.#.#.....#...#.#.#
.###.#.#####.#.#.#.#########.#############.###.#.#####.###.#.#.#
...#.#.....#...#.#.#.........#...#.....#...#...#.....#.#.#.#.#.#
##.#.#####.#####.#.###.#.#####.#.#.###.#.###.#####.###.#.#.#.###
...#.#.....#...#.#...#.#.......#...#...#.#...#.....#...#...#...#
.#####.#####.#.#.###.###.###########.#.#.###.#.###.#.###.#####.#
.....#.......#.....#...#.#.........#.#.#.#...#...#.#.#.......#.#
####.#################.#.#######.###.#.#.#.###.#.###.#####.###.#
...#...........#.......#...#.....#...#.#...#...#...#...#...#...#
.#.###.###.###.#.#########.#.#.###.###.#####.#####.###.#####.#.#
.#...#.#...#...#...#...#...#.#.#...#...#...#.....#...#...#...#.#
.###.###.###.#####.#.#.#.###.###.###.###.###.#####.#####.#.###.#
.#.....#.#.#...#...#.#.#.#...#...#.#...#.#...#.....#...#.#...#.#
.#####.#.#.###.#.#####.#.#.#.#.###.###.#.#.###.###.#.#.#.#.#.#.#
.#...#...#...#.#.#.....#.#.#.#...#...#.#.....#...#.#.#...#.#.#.#
.#.#.#######.#.#.#.#.###.#.#.###.###.#.#####.###.###.#######.#.#
...#.....#...#.#.#.#.#...#.#...#...#...#...#...#.#...#.......#.#
.#######.#.###.#.###.#.#######.###.###.#.#.#####.#.#####.#.#####
...#.....#...#.#...#...#.....#...#...#...#.......#.....#.#.#...#
##.#.#####.#.#.###.#.#####.#.#.#####.#######.#########.#.#.#.#.#
...#...#.#.#...#.#.#.......#.#.#.....#...#...#.......#.#.#...#.#
.#####.#.#.#####.#.#########.#.#.#####.###.###.#.#.###.#.#####.#
.#...#.#.....#...#...#.#.....#.#.#.....#...#.#.#.#.#...#...#...#
.#.#.#.#####.#.#.###.#.#.#####.#.###.#.#.###.#.#.###.#######.#.#
.#.#.#.....#...#...#.#.#.....#.#...#.#.#.#...#.#.....#.......#.#
##.#.#####.#####.###.#.#####.#.###.#.###.#.#.#.#######.#######.#
...#.....#...#...#...#.....#...#.#.#...#.#.#.#.#.....#...#.....#
.#######.###.#.###.###.#######.#.#.###.#.#.###.#.#####.#.#.#####
.#...#.......#.#...#.#.......#...#...#.....#...#.......#.#.#...#
.#.#.#########.#.###.#.#####.###.###.#######.###.#######.###.#.#
.#.#...#.......#.#...#.#.#.....#.#...#...#...#.........#.....#.#
.#.###.#########.###.#.#.#.###.#.#.###.#.#.###########.#######.#
...#.#...#.....#...#.....#...#.#.#.....#...#...#.....#.......#.#
.###.###.#.###.###.#####.###.#.#.###########.#.#.###.#.#######.#
...#...#...#...#.#...#.#.#.#.#.#...#.....#...#...#...#.#...#...#
##.#.#.#####.#.#.###.#.#.#.#.#.###.#####.#.#.#####.###.#.#.#.###
.#...#.#...#.#.....#S#.#.#.#.#...#.....#...#.....#.#...#.#.#...#
.#####.#.#.#.#########.#.#.#.#########.#########.#.#####.#.###.#
.........#.#...............#.....................#.......#.....#
################################################################
