64
.....................#.......#.........#.......#.....#.......#.#
.###.###############.###.###.#.#####.###.#.#####.###.#####.#.#.#
...#.#.........#...#...#...#...#.#...#...#.....#...#.....#.#.#.#
.#.###.#######.#.#.###.###.#####.#.###.#######.###.#####.#.#.#.#
.#...#.#...#...#.#...#.....#...#...#...#...#...#...#...#...#...#
####.#.#.###.###.###.#######.#.#####.###.#.#.#.#.#####.#######.#
.....#.#...#.#...#.#.........#.....#.....#.#.#.#.....#.........#
.###.#.###.#.#.###.###############.#######.#.#######.#######.###
.#...#...#.#.#.#.............#.....#.......#.#.....#......S#...#
.###.###.#.#.#.###########.###.###.#.#######.#.#.#############.#
...#.#...#.#.#.#...........#...#.#.#...#...#.#.#...........#...#
##.###.###.#.#.#.#########.#.###.#.###.###.#.#.#########.###.###
...#...#...#.#...#.....#...#.#...#...#...#.#...#.......#.....#.#
.###.###.###.#####.###.#.###.#.#####.###.#.#####.#####.#######.#
.....#...#...#.....#...#.#.#.#.....#.#.#...#.........#.........#
.#######.#.###.#.#.#####.#.#.###.#.#.#.###.#.#######.#########.#
.#.#.....#.....#.#.#...#.#.#...#.#...#...#.#.......#...#.....#.#
.#.#.#.#########.###.#.#.#.###.#####.###.#.###########.#.###.#.#
.#...#.....#...#.....#.#.#...#.....#...#.#.#.........#.#...#.#.#
.#######.#.#.#.#######.#.#.#.#####.###.#.#.#.#######.#.###.#.#.#
...#.....#.#.#.......#.#.#.#...#...#.#...#.#...#...#...#...#.#.#
##.#.#####.###.#####.#.#.#.###.#.###.#.###.#.#.#.#.#########.#.#
...#...#.#...#...#...#...#...#.#.#.....#...#.#...#...#.......#.#
.#####.#.###.###.#.###########.#.###.###.###.#######.#.#.#.###.#
.#.....#...#...#.#.............#...#...#.#.#.#.......#.#.#.#...#
.#.#######.###.###.#####.#####.###.#####.#.#.#.#######.#.###.###
...#.#.......#...#.#...#...#...#...#.....#.#.#.....#...#...#.#.#
####.#.#.#######.#.###.###.#.###.###.#####.#.#####.#.#####.#.#.#
.......#.#.......#...#.#...#.#.#...#...#...#.....#.#.....#.#.#.#
.#######.#.#########.#.#.###.#.###.###.#.#.#####.#.#####.#.#.#.#
.....#...#.#...........#...#.....#...#.#.#.......#.....#.#.#...#
####.#.###.#.###########.#.#.#######.#.#########.#####.###.###.#
.#...#G....#...#.#.....#.#.#.#.....#...#.......#.....#...#...#.#
.#.###########.#.#.###.#.#.###.#.#######.#####.#####.###.#.#.#.#
.#.#...#.........#.#...#.#.....#.......#.....#.#...#...#.#.#.#.#
.#.#.###.#####.###.#.#####.#########.#.#.###.#.#.#.#.###.#.###.#
.#.#.#...#...#.#...#.....#.#.....#...#.#...#.#.#.#...#...#.#...#
.#.#.#.###.#.###.#######.###.###.#.###.#.###.#.#######.###.#.###
...#...#...#.....#.....#...#.#.#.#...#.#.#...#.#...#...#...#.#.#
.#######.#########.#.#####.#.#.#.###.#.###.###.#.#.#.#####.#.#.#
.#...#...#.........#.#...#...#.#.#...#.....#.#...#...#.....#.#.#
.#.#.#.###.###########.#.#####.#.#.#########.###########.###.#.#
...#.#...#.........#...#.....#...#.......#...............#...#.#
####.#.#.#####.###.#.###.#####.#########.#######.#####.###.###.#
...#.#.#.#...#...#.....#...#...#.........#.....#.....#.....#...#
##.#.#.#.#.#.#########.###.#.###.#######.#.###.#####.#########.#
...#.#.#...#.......#.#...#...#...#.......#...#.#...#...#.......#
.###.#.#######.###.#.###.#####.###########.###.###.###.#.#######
...#.#.#.....#.#...#...#.#...........#.....#...#.....#.#.#.....#
##.#.#.#.###.###.###.###.#.#########.#.#####.###.#.###.#.#.###.#
...#.#.#...#.....#.....#.#...#.....#.......#.#...#.#...#.....#.#
.###.#####.###########.#.###.#.###.#########.#.#.###.#########.#
...#.....#.#.#.........#.#...#...#...#.......#.#.....#.......#.#
.#.#####.#.#.#.###.#####.#.#####.###.#.#########.#####.#####.#.#
.#.....#...#.#...#.....#.#.....#...#.#.........#.......#...#...#
.#####.#####.###.#####.#.#####.###.#.#########.#########.#####.#
.#.......#.......#.#...#.#...#...#.#.#...#.#...#.....#.......#.#
##.###.###.#######.#.#.#.#.#.###.#.#.#.#.#.#.#####.#.#.###.#.#.#
...#...#...#.......#.#.#...#.#.....#...#...#.#.....#.#.#.#.#.#.#
.#.#####.#####.#.###.#######.#######.#######.###.###.#.#.#.###.#
.#.#...#.#...#.#...#.......#.#.....#.#.....#.#...#...#.#.#...#.#
.###.#.#.#.#.#####.#####.###.#.###.###.###.#.#.#######.#.###.#.#
.....#.....#...........#.......#.......#.....#.............#...#
################################################################
