64
.#.........#.......#.......#...............#...................#
.#.#####.#.###.#.###.###.###.###.#########.###########.#######.#
.#.#.....#...#.#...#...#.....#.#.....#...#.....#.....#.....#...#
.#.#.#######.#####.###.#######.#####.#.#.#####.#.###.#######.#.#
.#.#.......#.......#...#...........#.#.#.......#.#.#.#.......#.#
.#.#######.###.#####.###.#######.###.#.#########.#.#.#.#######.#
.#.....#...#...#.........#...#...#...#.#.........#.#.#.#...#...#
.#####.#.#######.#########.#.#.###.###.###.#######.#.#.#.#.#####
.#.....#.#.......#...#.....#.#...#.#.#...#.....#.......#.#.....#
.#.#####.#.#######.#.#####.#.###.#.#.###.#.###.#######.#.#####.#
.#.#.....#...#...#.#.#...#.#...#.#.#.#...#...#.......#.#.....#.#
.#.#.#######.#.#.#.#.#.#.#.###.#.#.#.#.#####.#######.###.#####.#
...#...........#.#.#.#.#.#...#...#.#...#.....#.....#.#...#....G#
.###########.#####.#.#.#.###.#####.#.#########.###.#.#.###.###.#
.......#...#.#...#.#...#...#.#...#.#.....#.....#...#...#...#.#.#
.#####.#.#.###.#.#.#######.###.#.#.#####.#.#####.#######.###.#.#
.#...#.#.#...#.#.#...#...#.....#...#...#...#.#...#.......#.....#
.#.#.###.###.#.#.#.#.###.###########.#######.#.###.#######.#####
.#.#...#...#.#.#.#.#.#.......#.....#.........#.#.......#...#...#
.#.###.###.#.#.#.###.#.#####.#.#.###.#.###.###.#.#####.#.#####.#
.#.#.......#.#.#.....#...#.....#.#...#...#.#...#.....#.#.......#
.#.#########.#.#######.#.#########.#####.###.#######.#.#######.#
.#...#.#...#...#.....#.#.#.........#...#.....#.......#.#...#...#
####.#.#.#.#########.#.#.#.#########.###########.#####.#.#.#####
.....#...#.......#...#.#.#.....#...........#...#.#.....#.#.#...#
.#.#########.###.#.#.#.#.#####.###.#####.#.#.#.#.#.#####.#.#.#.#
.#.#.......#.#.....#.#.#.....#...#...#...#...#.#.#...#...#.#.#.#
.###.#####.#.#########.###.#####.###.#.#######.#.###.#.###.#.#.#
.#...#...#.#.....#.......#.....#.#...#.#.......#...#.#...#...#.#
.#.###.#.#.###.#.#.#########.#.#.###.#.###.#######.#.###.#####.#
...#...#.#...#.#.......#...#.#.#...#.#...#...#.....#.....#.....#
.###.###.###.###########.#.#.#####.###.#.###.#.###########.###.#
...#...#...#.#.....#.....#.#.....#...#.#.#.#.#.#.....#.....#.#.#
##.###.#.#.#.#.###.#.#####.#.#.#.###.#.#.#.#.###.###.#.#####.#.#
.#...#.#.#.#.....#.....#...#.#.#.#...#.#.#.#.#...#...#.....#...#
.###.###.#.###########.#.#####.###.#####.#.#.#.###.#######.#.###
...#...#.#.#.........#.#.#.....#...#.....#.#.#...#.#...#...#...#
.#.###.#.###.#######.###.#.#####.###.#####.#.#.#.#.#.#.#.#####.#
.#.#...#...#.......#.....#.......#...#.......#.#.#...#...#.#...#
.#.#.###.#.#######.#########.#####.#.#######.###.#########.#.###
.#.#.#...#.....#...#.......#.....#.#.......#.....#...#...#...#.#
.#.#.###.#.#####.###.#####.#####.#.#######.#######.#.#.#.###.#.#
.#.#...#.#.....#...#.#...#.#.....#.......#.#...#...#.#.#...#...#
.#.###.#######.###.#.###.#.###.#########.#.#.#.#.###.#.###.#####
.#.....#.....#...#.......#...#.....#...#.#...#...#...#.#.#.....#
.#######.###.###.#######.###.#####.#.#.###.#######.###.#.#####.#
.....#...#.#...#.#.....#...#...#.#.#.#...#.#.....#.....#.....#.#
####.#.###.###.#.#.###.#######.#.#.#.###.#.#.###.#####.###.###.#
...#.#...#.#...#.#.#...#...#...#.#...#.#.#.#...#.#...#.....#...#
.#.#.###.#.#.###.#.#.###.#.#.###.#####.#.#####.#.#.#.#######.#.#
.#.#...#.#.#.#...#.#.....#.#.#.........#.......#...#.........#.#
.#.###.#.#.#.###.#.#######.#.#.#####.#########################.#
.#...#.#.#.#.....#...#.......#.#...#...........#...#.........#.#
.#.###.#.#.#####.###.#.#########.#.#.#.#######.###.#.#######.#.#
.#...#...#.....#.#.#.#.#.....#...#.#.#.#.....#.#...#.#...#...#.#
.###.#####.###.#.#.#.###.###.#.###.#.#.#.###.#.#.#.#.#.#.#.###.#
...#.......#...#...#.......#.#.#...#.#.#...#.....#.#...#.#.....#
##.#####.###.#####.#########.#.#.#####.#################.#######
.#.#...#.#.......#.#.........#.#.....#.................#.....#.#
.#.###.#.#######.#.#.#######.#.#####.#####.###########.#####.#.#
...#...#.#.....#.#.#.#.......#.#...#.#...#...#.....#.#.....#.#.#
.###.#.#.#.###.###.#.#########.#.#.#.#.#.###.###.#.#.#####.#.#.#
.....#.#.....#.....#.............#.#...#..S#.....#.......#.....#
################################################################
