32
...........#.....#.......#.#...#
.#########.#.#.#.#.#####.#.#.#.#
...#.#.....#.#.#.#...#.#.#...#.#
##.#.#.#######.#.###.#.#.###.#.#
...#.......#...#...#.#.....#.#.#
.#########.#.#####.#.#####.###.#
...#S....#.#.#.....#.#...#.....#
##.#####.#.#.###.###.#.#.#####.#
...#.....#.#...#...#...#.#...#.#
.###.#####.###.###.#####.#.#.#.#
.....#...#...#.#.#.#...#.#.#...#
######.#.###.#.#.#.#.#.#.#.#####
.....#.#.....#.#.#.#.#.#.#.#...#
.#.###.#######.#.#.#.#.#.#.#.###
.#...#.#.......#.#.#.#...#.#...#
####.#.#.#######.#.#.#####.###.#
.....#...#.......#...#...#.#...#
.#########.#####.#####.#.#.#.###
.....#...#.#...#.......#.#.#...#
.###.#.#.#.###.###.#######.#.#.#
.#.#...#.........#.#.......#.#.#
.#.#############.#.#.#########.#
.#...#.......#...#.#...#.......#
.#.#.#.#####.#####.###.#.#####.#
...#.#.#.............#...#...#.#
####.#.#######.###########.#.#.#
.....#.#...#...#...........#.#G#
.#####.#.#.#####.#####.#####.#.#
.#.....#.#.#.....#...#.#...#.#.#
.#.#####.#.#.#####.#.#.#.#.###.#
.#.......#.........#.#...#.....#
################################
