8
..S#...#
.###.#.#
.#...#.#
.###.#.#
.....#.#
######.#
......G#
########
