16
...........#...#
.#########.#.#.#
G#...#.....#.#.#
.###.#.#######.#
...#...........#
.#.###.#######.#
.#...#.#.....#.#
.###.###.###.#.#
.#.#.#...#S#.#.#
.#.#.#.###.#.#.#
...#.#.....#.#.#
##.#.#######.#.#
...#.......#.#.#
.#######.###.#.#
.......#.....#.#
################
