32
.......#...........#...........#
.#####.#.#########.#.#########.#
.#.....#.#.......#.#.#.......#.#
.#.#####.#######.#.#.#.#####.#.#
.#.......#.....#.#...#.....#.#.#
.#####.###.###.#.###.#####.#.###
.#...#.#...#...#.......#...#...#
.#.#.#.#.###.###########.#####.#
.#.#...#.#.#...#...#.....#S..#.#
.#####.#.#.###.#.#.#.#######.#.#
.....#.#...#...#.#...#.....#...#
.###.#####.#.###.#####.###.#####
.#.#.......#.#...#.....#.#.....#
.#.#########.#.###.#####.#####.#
...#.......#...#...........#...#
##.#####.#.#####.#######.###.#.#
.#...#...#.#...#...#...#.#...#.#
.###.#.###.#.#.#.###.#.###.#####
...#.#...#...#.#.#...#.#...#...#
.#.#.###.#####.###.###.#.###.#.#
.#.#...#...#.#.....#...#.....#.#
.#.###.###.#.#######.#####.###.#
.#...#.....#.#.....#.....#...#.#
####.#######.#.#.#.#####.###.#.#
....G#...#.....#.#.....#...#.#.#
.#.###.#.#.#####.#########.###.#
.#.#...#...#...#...........#...#
.###.#######.#.#############.###
...#.#.......#.#.....#.........#
.#.#.#######.#.#.###.#########.#
.#...........#...#.............#
################################
