32
.........................#.....#
.#####################.#.###.#.#
.....#.....#.#.........#.....#.#
####.#.###.#.#.###############.#
...#.#.#.#...#.....#...#.......#
.#.#.#.#.###.#####.#.#.#######.#
.#.#...#.....#...#...#.#.....#.#
.#.#####.#####.#.#####.#.###.#.#
.#...........#.#.....#.#...#.#.#
.###########.###.###.#.###.#.###
.#...#.....#...#.#...#.....#...#
.#.#.#.###.###.#.#.###########.#
...#.#.#...#.....#.#.....#.....#
.#####.#.#########.#.###.#.#####
.#.....#.....#...#.#.#...#.....#
.#.#########.###.#.#.#.#######.#
.#.....#...#...#...#.#.......#.#
.#####.#.#####.###.#######.###.#
.#.#S#.#.....#...#.....#...#...#
.#.#.#.#.###.###.#####.#.#.#.###
...#...#...#...#.#.....#.#.#...#
##.#####.###.###.#.#####.#####.#
.#.#.....#...#...#.......#.....#
.#.#######.###.#########.#.#####
.#.......#...#.#.#.......#.#...#
.#######.#.#.#.#.#.#######.#.###
...#...#.#.#.#.#...#.....#.#...#
.#.#.#.#.###.#.#####.###.#.###.#
.#.#.#.#.#...#.......#.#...#...#
.#.#.#.#.#.#.#########.#####.#.#
.#...#.....#................G#.#
################################
