8
...#...#
.#.###.#
G#.#...#
.#.#.###
.#...#S#
.#####.#
.......#
########
