64
.....#...............#.........#.......#...#.........#.........#
.#.#.#.###########.###.#####.#.#.###.#.#.###.###.#####.#######.#
.#.#.#.#.........#.....#.#...#.#.#...#.#.#...#.#.....#.......#.#
.#.#.#.#########.#######.#.#####.#.###.#.#.###.#####.#####.###.#
.#.#.#.#.........#.....#.#.....#.#.#.....#.#.......#.....#.#...#
.#.###.#.#######.#.###.#.#####.#.#.#####.#.#####.#.###.###.#.#.#
.#...#.#...#...#.#.#.#.......#...#.....#.#.......#...#.#...#.#.#
.###.#.###.#.#.#.#.#.#######.#########.###########.###.#.###.#.#
...#...#...#.#.....#.........#.....#.#.#...#.......#...#.#.#.#.#
##.#####.#####.#####.#########.#.#.#.#.#.#.#.#######.###.#.#.###
.#.#...#.....#.#...#.......#...#.#.#.#.#.#...#.#...#.#.....#...#
.#.###.#.###.###.#.#######.#####.#.#.#.#.#####.#.#.#.#.#######.#
.#...#.....#.....#.......#.......#...#...#.#.....#.#...#.......#
.###.#####.#############.###########.#####.#.#####.#####.#####.#
...#.#...#.#...#.......#.#.......#.....#...#.#..G..#.....#...#.#
.###.#.#.#.#.###.#####.#.#.#####.#####.#.###.#.#####.#####.#.#.#
...#...#.#.#.......#...#.......#.....#...#...#.....#.......#.#.#
.#.#####.#.#######.#.#.###########.#.#####.#######.#########.###
.#...#...#.......#.#.#.#...#.....#.#.#...#.#.#...#.........#...#
.###.#.#########.###.###.#.#.###.###.#.#.#.#.#.#.#####.#####.#.#
...#.#.....#...#...#.#...#...#.#...#.#.#...#...#...#...#...#.#.#
####.#####.###.###.#.#.#######.###.#.#.#####.#####.#.###.#.###.#
...#.....#.#...#...#.#.#...#...#.#.#...#.....#.....#.#...#.....#
.#.#####.#.#.#.#.###.#.#.#.#.#.#.#.###.###.###.#####.#.#######.#
.#...#...#.#.#.#.....#...#.#.#...#...#...#.#...#.....#.......#.#
.###.#.###.#.#######.#####.#.#######.###.###.#.#.###.#######.#.#
...#...#...#.......#...#...#.#.....#...#.....#.#.#.#.#.....#.#.#
.#.#####.###.#.#######.#.###.#.#.#.###.#.#######.#.#.#.###.#.###
.#.....#.#...#.#.......#...#...#.#...#.#.#.......#...#...#.#...#
.#####.#.#.###.#.#########.#####.###.#.###.#######.#####.#.###.#
.....#.#.#...#...#.........#.....#...#...#.#.#.......#...#.#...#
####.#.#.#######.#.#########.###.#######.#.#.#.#######.###.#.#.#
.....#.#.......#.#...#.....#...#.#.....#.#.#...#.#.....#.#.#.#.#
.#####.#######.###.#.###.###.#.###.###.#.#.#.###.#.#####.#.#.#.#
.#...#.#.....#...#.#...#.....#.....#.#...#.#.....#.....#...#.#.#
.#.#.#.#.###.###.###.#.#.###########.#####.###########.#.###.###
.#.#.#.....#...#...#.#.#.....#.......#.....#.......#...#.#.....#
##.#.#########.###.###.#####.#.#####.#####.#.#####.#.###.#####.#
...#...#.......#...#...#...#...#.....#.....#.#...#...#.#.......#
.#####.#.#####.#.###.###.#######.#####.#####.###.#####.#########
...#...#.....#.#.#.....#.#.....#.......#...#...#...#...#.......#
##.#.#######.#.#.#####.#.#.#.#####.#####.#.###.#.#.#.#.#.#.###.#
...#...#.....#.#...#...#...#.....#.#...#.#.....#.#.#.#...#...#.#
.#####.#.#########.#.###.#######.#.#.#.#.#######.###.#######.#.#
.....#...#.........#.#.#...#...#...#.#...#...#...#...#.#.....#.#
.###.###.#.#########.#.###.#.#####.#.#####.#.###.#.###.#.#####.#
...#...#.#.....#.....#.#.....#...#.#.#.....#...#...#...#...#.#.#
##.###.#######.#.###.#.#.#####.#.###.#.#######.#.###.#####.#.#.#
...#.#.#.......#.#...#...#.....#.....#...#...#.#.#.....#...#...#
.###.#.#.#########.###.###.#############.#.###.#.#####.#.###.###
.#...#...#.....#...#.....#.#.......#.....#.#...#.......#.#.#.#.#
.#.#######.#.#.#.###.#####.#.#####.#.#####.#.#####.#####.#.#.#.#
.#.#.......#.#...#.#...#...#.#.....#...#.#...#.....#...#.#...#.#
.#.#.#######.#####.###.#.###.###.#####.#.#.#########.#.#.#.###.#
.#.....#.....#.....#...#...#...#.#.....#.#.......#...#.#.#.#...#
.#######.#####.#.###.#####.#.#.#.#.#####.#######.#.###.#.#.#.#.#
...#...#.#.....#.....#S....#.#.#...#.#.........#...#.#...#...#.#
##.#.#.#.#.###################.#####.#.###.#.#######.#########.#
...#.#...#.#...#...............#.#...#...#.#.#.......#.......#.#
.###.#####.#.#.#####.#####.#.###.#.#.###.#.###.#.#####.###.#.#.#
...#.#.#...#.#.....#.#...#.#...#...#.#...#.....#.....#.#.#.#.#.#
##.#.#.#.###.#####.###.#.#####.#.###.#.#############.#.#.#.###.#
.....#.......#.........#.......#...#...............#.....#.....#
################################################################
