32
...#.....#...............#.....#
.#.#.###.#.#####.#######.#.#####
.#G#.#.#.......#.......#...#...#
.#.#.#.#########.#####.#####.#.#
.#.#.......#...#.#...#.#.....#.#
.#.#.#######.#.###.#.#.#.#####.#
.#.#.#.......#...#.#...#.#.#...#
.#.###.#########.#.#.###.#.#.###
.#.....#...#.......#.#...#.#.#.#
.#####.#.#.###########.###.#.#.#
.#...#.#.#.#...........#...#.#.#
.#.#.#.#.#.#.###########.###.#.#
.#.#.#.#.#...#...........#...#.#
.#.#.###.#######.#######.#.###.#
...#.....#.......#.......#...#.#
.###########.#######.#######.#.#
.#.........#.......#.#.#.....#.#
.#####.###.#####.#.#.#.#.#####.#
.#.....#...#...#.#.#...#...#...#
.#.#######.#.#.#.#.#######.#.#.#
.#.......#...#.#.#...#.....#.#.#
.#######.#####.#####.#.#####.#.#
.........#...#.......#...#...#.#
##########.#.#######.###.#####.#
.....#.....#.#...#.....#...#...#
.#.###.###.###.#.#.#######.#.###
.#.....#.#.....#...#.......#...#
.#######.###########.#########.#
.#.......#...#S......#...#.....#
.###.###.#.#.#########.#.###.#.#
.....#.....#...........#.....#.#
################################
