8
.#...#S#
.#.#.#.#
G#.#...#
.#.#####
.#.#...#
.#.###.#
.......#
########
