8
.#..G..#
.#.###.#
.#.#...#
.#.#.#.#
.#.#.#.#
.#.#.###
...#..S#
########
