16
...........#...#
.#########.#.#.#
S#.#...#...#.#.#
##.#.#.#.###.#.#
.#...#...#...#.#
.#.#######.#.#.#
.#.#.....#.#.#.#
.#.#####.#.#.#.#
.#.....#...#.#.#
.#####.#.###.###
.....#.#...#G..#
.#.#.#.#.#####.#
.#.#.#.#.#.....#
.#.###.###.###.#
.#.........#...#
################
