32
.....#.......#.......#S#.......#
##.#.#.###.#.#.#.#####.#.###.###
...#.#...#.#.#.#.#...#.#...#...#
.#.#####.#.###.#.#.#.#.#######.#
.#.#.....#.....#...#.#.......#.#
.#.#.###############.#######.#.#
.#.#...#.......#.......#.....#.#
.#####.#.#.###.#.###.###.#####.#
...#...#.#...#.#.#...#...#.....#
.#.#.#######.###.#####.###.###.#
.#.#.......#...#.....#.....#.#.#
##.#######.###.#####.#######.#.#
...#.....#.........#.....#...#.#
.#.#.#.#####.#####.#.###.###.#.#
.#.#.#.......#...#.#.#...#...#.#
.###.#########.#.#.#.#.###.#.#.#
...#.#...#.....#.#.#.#.#...#.#.#
.#.#.#.#.#.#####.###.#.#.#.###.#
.#...#.#.#...#.#.....#...#.#...#
.#####.#.#.#.#.###.#########.###
.#.....#.#.#.#...#.#.......#.#.#
.#.#####.#.#.#.#.#.#.#####.#.#.#
.#.#...#.#.#.#.#.#.#.#.....#.#.#
.#.#.#.#.###.#.###.#.#.###.#.#.#
.#.#.#.#.....#.....#.#...#.#...#
.#.#.#.#######.#####.###.#.###.#
.#...#.....#.....#.....#.#...#.#
.#########.#.#####.#####.#####.#
.#..G..#.#.#.#...#...#...#.....#
.#.###.#.#.###.#.###.#.###.#####
...#.....#.....#.....#.........#
################################
