64
.....#.........#.......#...................#.........#...#.....#
.###.#.#.#####.#.###.###.###############.###.###.###.#.#.#####.#
.#...#.#.#.....#.#.#.#...#...#...#.....#...#...#...#...#.#...#.#
.#.###.#.#######.#.#.#.#####.#.#.#.###.###.###.###.#####.#.#.#.#
.#.....#.#.....#.#.#.#.#...#...#.#.#.......#...#.#...#.#...#...#
.#######.#.###.#.#.#.#.#.#.#.###.#.#########.###.###.#.#######.#
.#...#.#.....#.....#.#...#.#...#.#.........#.......#.#.......#.#
.#.#.#.#######.#####.#####.###.#.#########.#######.#.#####.#.#.#
...#.#...#...#.#.....#...#.#...#.........#.........#.....#.#.#.#
####.###.#.#.###.###.#.#.#.#.#########.#.###########.###.#.###.#
...#.#...#.#.....#.#.#.#...#...#.....#.#.....#.....#...#.#.....#
.#.#.#.###.#######.#.#.#######.#.###.###.#.###.###.#####.#######
.#.#.#...#...#.....#.#.#.....#.#.#...#...#.#...#.....#...#.....#
.#.#.#.#.###.###.###.#.###.#.###.#.###.#####.#######.#.###.###.#
.#.#.#.#...#...#.#...#.....#.....#...#.....#.#...#...#.....#...#
##.#.#####.###.#.#.#################.#.###.#.#.#.#.###.#####.#.#
...#...#.....#.#.#.........#.#...#...#.#...#...#.#.#...#.....#.#
.#####.#.#.###.#.#########.#.#.#.#.#####.#.#####.#.#####.#####.#
.#.....#.#.#...#.............#.#.#.......#...#...#.......#...#.#
.#.#####.#.#.#####.###########.#.###########.#.###########.###.#
.#.#.....#.#.....#.#.........#.#.......#.....#..G#.........#...#
.#.#.#####.#####.###.#######.#.#####.#.#.#######.#########.#.###
.#.#...#.#.....#.......#...#...#...#.#.#...#...#.....#.....#...#
.#.###.#.#####.#######.###.#####.#.#.#####.#.#.#####.#.###.###.#
.#.....#.#...#...#...#...#.......#.#.......#.#.......#...#.#...#
.#######.#.#.#.###.#.###.###.#####.#########.#########.#.###.###
.....#.#...#.#.#...#.#.#...#.....#...#.......#.......#.#.#...#.#
.###.#.#.###.#.#.###.#.###.#####.###.#.###########.#.###.#.###.#
...#...#.#.#.#.#.#.#.#...........#...#.....#.......#...#.#.#...#
.#.#####.#.#.#.#.#.#.#.###################.#.#########.#.#.###.#
.#.......#.#...#.#.#.#...#...........#...#.#.......#.#...#.#...#
.#########.#####.#.#.###.#.#########.#.#.#.#.#####.#.###.#.#.#.#
.....#.....#...#.#.#...#.#...#.....#.#.#...#.#.....#.#...#.#.#.#
####.###.###.#.#.#.###.#.###.#####.#.#.#####.#.#####.#.###.#.###
.....#...#...#...#.....#...#.....#.#...#...#.#.#.....#.#.#.#...#
.#####.#.#.#######.#############.#.#####.#.###.###.#.#.#.#.###.#
.#.....#.#.......#.......#.....#.#.......#.....#...#.#.#.#.....#
.#####.#########.#######.#.###.#.#.#.###########.#####.#.#####.#
.#...#...#.....#.#.....#.#...#...#.#.#.......#.....#...#.....#.#
.#.#.#.#.#.#.#.#.#####.#.###.#######.#.#####.#####.#.#######.#.#
...#.#.#...#.#.#.....#.#...#.....#...#.#.#...#...#...........#.#
####.#.#####.#.#####.#.###.#.###.#.###.#.#.###.#.#####.#######.#
...#.#...#...#.....#.#...#.#.#.#.#...#.#.#...#.#.....#.#.......#
.###.#####.#####.###.#.#.#.#.#.#.###.#.#.###.#.#####.#.#.#######
.....#.....#.....#...#.#.#.#...#...#...#...#.#.#...#.#.#.#.....#
.#####.###########.#####.#.#####.#.#.###.#.#.#.#.#.#.###.#.#.###
.#.....#S..#.......#.....#.....#.#.#.#...#.#.#...#.#...#.#.#...#
.#####.###.#.#######.#########.#.#.#.#.###.#.#####.###.#.#.###.#
.......#...#.#.....#.........#.#.#.#...#...#.....#...#.#.#.#.#.#
##.#####.###.#.#.###.#####.###.#.#.#########.###.###.#.#.#.#.#.#
.#.#.....#...#.#...#...#.#...#.#.#.........#.#...#...#.#.#...#.#
.#.#.#######.#.###.###.#.###.#.#.#########.###.#.#.###.#.###.#.#
...#.........#.#.#...#.#...#...#.#.......#...#.#.#.#...#.#...#.#
.#############.#.###.#.#.#########.#####.###.#.###.#.###.#.###.#
.#...#.........#...#...#.....#.....#...#.....#.#...#.....#...#.#
.#.#.#.#########.#######.###.#.#.#.#.#.#######.#.#############.#
.#.#...#.....#...#.....#.#.#...#.#.#.#.....#...#.#.............#
.#.#####.#####.#.#.###.#.#.#####.#.#.#####.###.#.#.###.#######.#
.#...#.........#.....#.........#.#.#.....#...#.#.#...#...#.#...#
.###.#.#########################.###.#######.#.#.#######.#.#.###
...#.#.......#.....#.......#...#.....#.......#.#.#...#...#.#.#.#
##.#.#########.###.#.#####.#.#.#######.#######.#.#.#.#.###.#.#.#
...#...........#.....#.......#.........#...........#...#.......#
################################################################
