8
.......#
.#####.#
...#.#S#
##.#.###
.#...#.#
.###.#.#
..G....#
########
