16
.#.........#...#
.#.#######.#.#.#
.#.#.....#.#.#.#
.#.#.###.#.#.#.#
.#.#.#.#...#.#.#
.#.#.#.###.#.#.#
.#.#...#S#.#.#.#
.#.###.#.#.###.#
.#.#...#.#.....#
.#.#####.#####.#
.#...#...#...#.#
.###.#.###.###.#
...#...#.#.....#
.#######.#.#####
G..............#
################
