16
.......#G....#.#
.###.###.#.#.#.#
.#.#.....#.#...#
.#.#######.###.#
.#.....#...#.#.#
.###.#.#.###.#.#
.#...#.#...#...#
.#.###.###.#.###
.#.#.....#.#...#
.#.#.#####.###.#
...#...#...#...#
.#######.###.###
.#S..#...#.#.#.#
.###.#.###.#.#.#
...#...#.......#
################
