64
...#...#.......#.....#.....#.....#...........#.#.....#.........#
.#.###.#.#.###.#.###.#.#.###.###.#.#######.#.#.#.###.#.#####.#.#
.#.....#.#.#.#...#...#.#...#.#...#...#.....#...#...#.#.....#.#.#
.#######.#.#.#####.###.###.#.#.#.###.#.###.#######.#.#####.#.#.#
.....#...#.#.....#...#.#.#...#.#...#.#...#.#.......#...#...#.#.#
####.#.###.#.###.###.#.#.#####.#####.###.###.#######.#.#.###.#.#
...#...#...#.#...#.#.#...#.....#.....#.#.....#.....#.#..G..#.#.#
.#.###.#.###.#.###.#.#.###.#.###.#####.#######.###.#######.#.###
.#...#.#...#.#...#.#.#.#...#.#...#.........#...#.#.#.....#.#...#
.###.#####.#.###.#.#.#.#.###.#.###.#.#######.###.#.#.###.#####.#
.#.....#...#.#...#.#.#.#...#.#.#...#.#.......#.#...#.#.#.......#
.#####.#.###.###.#.#.#.###.###.#####.#.#######.#.###.#.#######.#
...#.#...#.....#...#.#...#...........#.......#...#...#.....#.#.#
##.#.#########.###.#.###############.#####.#.#.###.###.###.#.#.#
...#.........#...#.#.....#.......#...#...#.#.#.#...#.....#.#.#.#
.###.###.###.###.#######.#.#####.#####.#.#.#.#.###.#####.#.#.#.#
...#...#.#.#.....#.....#.#...#.#.#.....#.#.#.#.....#.....#...#.#
##.#####.#.###.###.###.#.###.#.#.#.#####.###.#######.#########.#
...#...#.#.....#...#.#...#...#.#...#.....#...#.........#.......#
.###.#.#.#######.###.#####.###.#####.#####.###.#######.#.#####.#
.#...#...#.......#.#.........#...#...#.....#.....#...#...#...#.#
.#.#######.#######.#.#######.#.#.#.#####.#.#######.#.#####.#.###
.#.......#...#.........#...#.#.#.#...#...#.#.......#.......#...#
.#.#####.###.#########.#.#.#.#.#####.#.###.#.#################.#
.#.#.......#.#.....#...#.#...#.#.....#.#...#.#.......#.......#.#
.###.#######.#.###.#.###.#####.#.#####.#####.#######.#.#####.#.#
...#...#.....#...#.#.#...#.....#...#.....#...#.......#...#.#.#.#
##.###.#.#####.#.#.###.###.###.###.#.###.#.###.#####.###.#.#.#.#
...#...#.#.....#.#.#...#...#...#...#.#...#...#.#.......#.#.#...#
.###.#.#.#######.#.#.###.###.#.#.###.#.#.###.#.#########.#.###.#
.#...#.#.........#...#.#...#.#.#...#.#.#...#.#.......#...#...#.#
.#.#.#################.###.#.#.###.###.#####.#.#####.#.###.###.#
.#.#.............#.......#.#.#.#...#...#.....#...#...#...#.....#
.#.###########.#.#.###.###.#.###.###.#.#.#########.#####.#.#####
.#...#.......#.#...#...#...#.....#...#.#.#.........#.....#.....#
.###.#####.#.#.#####.###.#########.#####.#.#######.#.#########.#
...#.....#.#.#...#.....#...#...#.........#...#.....#.....#.#...#
.#.#####.###.###.#####.###.#.###.###########.###########.#.#.###
.#.#.#...#...#.#...#.....#.#.....#.....#.....#...........#.#...#
.#.#.#.###.#.#.###.#.#####.###.#####.#.#.###.#.###########.###.#
.#.#...#...#.#...#.#.#...#...#.......#...#.#.#...#.....#...#...#
##.#.###.###.###.#.###.#.###.#############.#.###.#.#.#.#.###.###
...#.#.....#.....#.#...#.....#.....#.....#.....#.#.#.#...#...#.#
.###.###.#.###.###.#.#########.###.#.###.#####.#.#.#.#.###.###.#
...#...#.#...#.#...#.......#...#.#...#.#.....#.#.#.#.#.#...#...#
.#.###.#####.###.#########.###.#.#####.#####.###.###.###.###.#.#
.#.#...#...#...#.......#.......#...........#...#.#...#...#...#.#
.#.###.#.#.#.#.#####.###.###########.#####.###.#.#.###.###.#.#.#
.#...#...#.#.#.....#.......#......S#...#.#.#.#...#.....#...#.#.#
####.#####.#.###.###########.#########.#.#.#.#####.#########.#.#
.....#.....#...#.........#...#...#.....#.....#...#.....#.....#.#
.#####.###########.#.#####.###.#.###.#####.###.#.#####.#.#####.#
.#...............#.#.#...#.....#...#.....#.#...#.#...#...#.#...#
.###.###########.#.###.#.#########.#####.#.#.###.#.#.#####.#.###
...#.#.........#.#...#.#.#.........#.....#.#.#.#...#.......#...#
##.#.#.#######.#.###.#.#.#.#########.#####.#.#.#########.#####.#
...#.#.......#.#...#.#.#...#...#...#.....#.#.........#...#.....#
.###.#####.###.###.#.#.#####.#.#.#.#.###.###########.#.#.#.#####
...#.#.....#...#.....#.......#.#.#...#.#.........#...#.#.#.#...#
##.#.#.#####.#################.#.#####.#####.###.#.###.#.#.#.#.#
...#.#...#...#...#...#...#...#.#...#.....#.#...#.#.#.#.#.#...#.#
.#######.#.###.#.#.#.#.#.#.#.#.###.###.#.#.###.###.#.#.#######.#
.........#.....#...#...#...#...#.......#.....#.......#.........#
################################################################
