16
.....#.........#
.###.#######.#.#
..S#.........#.#
##############.#
.#.........#...#
.#.#.#######.###
.#.#.#.......#.#
.#.#.#.#######.#
.#.#...#.......#
.#.#####.#######
.#.#.......#...#
.#.#######.#.#.#
.#.......#...#.#
.#######.#####.#
......G........#
################
