32
G..........#...#.......#.......#
##.#######.#.#.#.#####.#####.###
...#.....#...#.#...#...#...#...#
.###.###.#####.###.#.###.#.###.#
.#.....#.#...#.#...#.#...#.....#
.#.#####.#.#.#.#.###.#.#######.#
...#...#...#.#...#.#.#.#.....#.#
####.#.#####.#####.#.#.#.#####.#
...#.#.......#...#.#...#.#.....#
##.#.#####.###.#.#.#####.#.#####
...#...#...#...#.#.....#...#...#
.#.###.#####.###.#.###.#.#####.#
.#...#...#...#.#.#...#.#.....#.#
.#######.#.###.#.#####.#####.#.#
.......#.#...#.......#...#...#.#
.#####.#.###.#######.#.###.###.#
.#.....#...#....S#.#.#.#...#...#
.#.###.###.#######.#.#.#.###.#.#
.#...#...#.........#.#.#.#...#.#
.###.#######.#####.#.#.#.#.###.#
.#.#.#.....#.....#.#.#.#.#.#...#
.#.#.#.#.#######.#.#.#.#.#.#.###
...#...#.......#.#.#.#.#.#.#...#
##.#########.###.###.#.#.#.###.#
.#.......#.#...#.....#...#...#.#
.#######.#.###.#######.###.#.###
.#...#...#...#.......#...#.#...#
.#.#.#.#####.#######.###.#####.#
...#...#.......#.#.....#...#...#
.#######.#####.#.#.#######.#.#.#
.........#.......#...........#.#
################################
