64
...#.......#.....#.........#.....#...#.....#.......#.....#.....#
.###.#####.#.#.#.#.###.###.###.#.#.#.#.#.#.#.#####.#.#####.###.#
...#.....#...#.#.#.#...#.#...#.#.#.#.#.#.#.#.#...#.#.....#.#...#
.#.###.#######.###.#.###.###.#.#.#.#.###.#.#.###.#.#.###.#.#.###
.#.....#.....#.....#.#...#...#.#...#...#.#.#...#...#...#.#.#...#
.#######.###.#.#####.###.#.###.#######.#.#.###.#.#####.#.#.###.#
.#.....#...#.#.....#...#...#.........#...#.....#.#...#.#...#...#
.#.#######.#.#####.###.#.###########.###########.#.#.#######.#.#
.#...#.....#.#...#.#...#.#.........#.....#.#.....#.#.......#.#.#
.###.#.#####.#.#.###.###.#.#######.#####.#.#.#####.#######.#.###
.....#...#.#.#.#.....#.....#.....#.#.....#.#.....#...#...#.#...#
####.###.#.#.#.#.###########.#####.#.#####.#####.###.#.###.###.#
.#...#.#.#.#.#.#.#.........#.#.....#.#...#.......#...#.#.......#
.#.###.#.#.#.#.###.#######.#.#.#####.#.###.#######.###.#.#####.#
.......#.#...#...#...#.....#...#.....#.#...#.....#...#...#...#.#
.#######.#.#####.###.#.#####.###.###.#.#.###.#####.#.#####.#.###
...#...#.#.....#.....#...#.#.#...#...#.#...#.#.....#.......#...#
##.#.#.#.#####.#.#######.#.#.#####.###.###.#.#.#####.#########.#
...#.#...#...#.#.....#...#...#.....#.#.....#...#...#...#.....#.#
.###.#####.#.#.#######.#####.#.#####.#.#####.###.#.#####.###.#.#
.#.#.....#.#.#.........#...#...#.....#.#...#...#.#.#.....#.....#
.#.#####.#.#######.#####.#.#####.###.#.#.#.###.#.#.#.###########
.#...#...#.....#...#...#.#.#.......#.#.#.#.....#.#...#.........#
.###.#.###.###.#.###.#.#.#.#######.#.#.#########.###.#.#######.#
.....#.#...#.#.#.#...#...#.......#.#.#.......#...#...#.#..S#...#
####.#.###.#.#.#.#.#############.#.#.#######.#.#.#####.#.###.###
.....#...#...#...#.#.......#...#.#.#.......#...#.#.....#.#.#.#.#
########.#####.###.#.#####.#.#.#.#.#############.#.###.#.#.#.#.#
.........#...#...#.#...#...#.#...#.....#...#.....#...#.#.#...#.#
.#########.#.###.#.###.###.#.#####.###.#.#.#.#######.###.#.###.#
.#.........#...#.#...#...#.#...#...#.#.#.#...#...#.#.....#...#.#
.#.###########.#####.###.#####.#.###.#.#.#####.#.#.#########.#.#
.#...#.....#...#...#...#.#...#.#.....#.#...#...#.......#...#...#
.###.#.###.#.###.#.###.#.#.#.#.#.#####.###.#.#.#.#######.#.###.#
...#...#.#.#...#.#.#...#.#.#...#.#.....#.#.#.#.#.#.....#.#...#.#
##.#####.#.###.#.#.#.###.#.#####.#.###.#.#.#.#.###.###.#.###.#.#
.......#...#.#.#.#.......#.#.#...#.#...#.#.#.#...#...#...#.#...#
.#####.#.###.#.#.#########.#.#.###.#.###.#.#.###.###.#####.#####
G....#.#.#...#.#...#.#...#.#.#.#.#.#.....#.#.#...#...#.........#
####.#.#.#.#.#.###.#.#.#.#.#.#.#.#.#######.###.###.###.#####.###
.....#.#.#.#.#.......#.#...#.....#.#.......#...#...#.......#...#
.#####.#.#.#.#########.#.#########.#.#######.#.#.#############.#
.#...#.#...#...#...#...#.#.......#.#.........#.#.#...........#.#
.#.###.#######.#.###.###.#.#####.#.###########.#.#.#########.#.#
.#.....#...#...#.#...#...#.#...#.#.............#...#.....#.#.#.#
.#######.#.#.###.#.###.###.###.#.###################.###.#.#.#.#
.........#...#...#...#...#...#.#...#.......#.....#...#...#.#.#.#
.#############.#####.#######.#.###.#.#####.#.###.#.#.#.###.#.#.#
...#.....#...#.....#.#.......#...#...#...#...#...#.#.#.....#...#
##.#####.#.#.#.#.#.#.#.#######.#.#####.#.#####.###.#.#####.###.#
.#.#...#...#...#.#.#.#.....#.#.#.#.....#.....#...#.#.....#...#.#
.#.#.#.#########.###.#####.#.#.#.#.###.###.#####.#.#####.#####.#
...#.#.......#...#.......#.#...#.....#.#...#.....#.#.....#.....#
.###.#######.#.###.#####.#.#########.#.#.###.#.###.#.###.#.#####
...#.....#.....#...#...#.#.........#.#.#.#...#.#...#.#...#.#...#
##.#.###.###.###.###.###.#########.###.#.#.#####.###.#####.#.###
.#.#...#...#.#...#.......#.#.......#...#.#.......#.#.....#.#...#
.#.#######.###.#####.#####.#.#######.###.#########.#####.#.###.#
...#.....#...#.....#.......#.#...#...#.#.#...........#...#...#.#
.###.###.###.#####.#########.#.#.#.#.#.#.#########.###.#####.#.#
.....#...#...#...#.........#.#.#.#.#.#.#.#.......#.#...#.....#.#
######.###.#.###.#########.#.#.#.###.#.#.#.#####.#.#.###.#####.#
...........#.............#.....#.....#.....#.......#...........#
################################################################
