16
..G#.......#...#
.#.#.#.###.###.#
.#.#.#.#.......#
.###.#.###.#####
.#...#...#.#...#
.#.#####.###.#.#
...#...#.....#.#
.#####.#######.#
.......#.#S..#.#
######.#.###.#.#
...#.#.....#.#.#
.#.#.###.###.#.#
.#...#...#...#.#
.#####.###.###.#
.........#.....#
################
