32
.......#.........#.......#.....#
.#####.#.#######.#.#######.#.#.#
...#.#...#.........#.....#.#.#.#
.#.#.#####.#########.###.#.#.###
.#.#.#...#.#...#...#...#...#..G#
.#.#.#.#.#.#.#.#.#.###.#######.#
.#.#...#...#.#...#.#...#.....#.#
##.#.#####.#.#####.#.###.###.#.#
...#.#...#.#.#...#...#...#...#.#
.###.#.#.#.#.#.#.#####.#.#####.#
...#.#.#.#.#.#.#.#.....#.#.....#
.#.#.#.#.#.#.#.#.#######.#.#####
.#.#.#.#.#.#.#.#.......#.#.....#
.#.###.#.###.#.#######.#.#####.#
.#.#...#...#...#.........#...#.#
##.#.#####.#####.#######.###.#.#
...#...#.......#.#.....#.....#.#
.#####.#.#######.#.###.###.###.#
.......#.#.......#.#.#.#...#...#
######.#.#.#######.#.#.#####.#.#
.....#.#...#.......#.#...#...#.#
.###.#######.#######.###.#.###.#
...#.......#.#...........#...#.#
.#.#######.#.#.#########.#.#.###
.#...#.......#...#.....#.#.#...#
.###.#####.#######.###.#.#.###.#
.#.#.....#.#.......#S..#.#.#...#
.#.#####.###.###########.###.#.#
.#.....#...#.....#.....#...#.#.#
.#####.###.#####.#.###.###.#.#.#
.........#.......#...#.......#.#
################################
