16
.........#.....#
.###.#####.#.###
...#.#.....#...#
##.#.#.#######.#
...#.....#...#.#
.#########.#.#.#
.....#S....#...#
####.###########
...#...#.......#
.#.###.#.#######
.#...#.#.......#
.###.#.#####.#.#
.#.#.#.#...#.#.#
.#.#.#.#.#.###.#
...#.....#....G#
################
