8
.#.....#
.#.#.###
..G#...#
.#####.#
.....#.#
####.#.#
.....#S#
########
