16
........G......#
.#####.#######.#
.#.#...#.......#
.#.#.###.#######
.#.#...#.#.....#
.#.###.#.#.#.#.#
.....#.#.#.#.#.#
######.#.#.#.###
.....#.#.#.#...#
.###.#.#.#####.#
S#.#.#.#.....#.#
##.#.#.#####.#.#
.....#.#...#...#
.#####.#.#####.#
.......#.......#
################
