8
...#...#
.#.#.#.#
.#...#.#
.#######
...#..S#
.#.#.###
G#.....#
########
