32
.......#.....#..G..............#
.#####.###.#.#########.#.#####.#
.#.........#.#.......#.#.#...#.#
.#.#########.#.#####.###.#.#.#.#
.#...#...#.....#...#.....#.#.#.#
.#####.#.#########.#######.###.#
.......#.........#.......#...#.#
################.#.#######.#.#.#
...............#.#.#.....#.#...#
.#############.#.#.#.###.#.#####
.#.....#.....#...#.#.#.#...#...#
.###.###.###.#####.#.#.#######.#
...#.....#.#...#.....#.........#
.#.###.###.###.#.#####.#.#####.#
.#...#.#.....#...#.....#...#...#
####.#.###.#.#####.#######.#.###
.....#.....#.....#.......#.#...#
.###############.#########.###.#
.#...#.........#...........#.#.#
.#.#.###.#####.#############.#.#
.#.#...#.#...#.......#.......#.#
.#.###.###.#.#.#####.#######.#.#
.....#.....#.#.#...#.........#.#
############.#.#.#########.###.#
..S#.....#...#.#.........#.#...#
.###.###.#.###.#.#.#######.#.###
...#.#...#...#.#.#.........#...#
##.#.#.###.#.#.#######.#######.#
.#.#.#.#...#.#.#.....#.......#.#
.#.#.#.#####.#.#.###.#########.#
.....#.......#.....#...........#
################################
