8
.#.....#
.#.#.###
...#..S#
.#######
.....#.#
####.#.#
..G....#
########
