64
.....#.....#...#...........#.....#...............#.......#.....#
.#####.###.#.#.#.#######.#.#.###.#####.#########.#.#.###.#.###.#
...#.....#.#.#.#.#.....#.#.#...#.....#.....#.#...#.#...#.#.#...#
##.#.#####.#.#.#.#.###.#.#.###.#####.###.#.#.#.#####.#.#.###.#.#
...#.#.#...#.#.#...#.#.#.#.#...#...#...#.#.#.#.....#.#.#.....#.#
.###.#.#.#.#.#.#####.#.#.###.###.#.###.#.#.#.#####.###.#######.#
...#.#.#.#.#.#.......#.#...#.....#.#...#.#.#.....#.#...#.......#
##.#.#.#.###.#.#######.###.#.#####.#.###.#.#.#####.#.###########
...#.#.#.#...#.#.....#...#...#...#.#...#.#.#.#....G#.#.........#
.#.#.#.#.#.###.#.###.###.#####.#.#####.#.#.#.#.#####.#.#######.#
.#.#...#...#.#...#.#.....#...#.#.#.....#.#.#...#.....#.#.#.....#
.#####.#####.#####.#########.#.#.#.#####.#.#.###.#####.#.#.###.#
.............#.....#.........#.#.#.#...#.#.#.....#.....#.#...#.#
.###########.#.###.#######.#.#.#.#.###.#.#.#####.#.#####.###.#.#
.....#.....#.#...#.........#.#.#.#...#...#.....#.#.#.....#...#.#
####.#.###.#.#.#.#.#######.###.#.###.#.#####.#.#.#.###.###.###.#
.....#.#.#.#.#.#.#.#.....#.#...#.#...#.#...#.#.#.#...#...#.#...#
.#####.#.#.#.###.###.###.###.###.#.#####.#.###.#####.###.#.#####
...#...#.#.#.....#...#.#...#...#...#.....#...#...#...#...#.....#
##.#.###.#.###.###.###.###.###.#######.#####.###.#.###.#.#####.#
...#.#.....#...#...#.....#...#.#.....#.#...#...#...#...#.#...#.#
.###.#.#########.###.###.###.#.###.#.#.#.#.###.#.###.###.#.###.#
.#.#.#...#.......#.#...#...#...#...#.#...#.#...#.....#...#.#...#
.#.#.###.#.#.#####.#.#.#########.###.###.#.#.#####.#####.#.#.###
...#.#...#.#...#...#.#.........#...#...#.#.#.....#.#...#...#...#
.###.#.#######.#.###.#####.###.#.#.###.#.#.#####.###.#.#######.#
.#...#.........#.#...#...#...#.#.#...#.#.#...#...#...#.#.....#.#
.#.#############.#.###.#.###.#.#####.#.#.###.#.###.###.#.###.#.#
.#S#.............#.#...#.#.#.#.....#.#.#...#.#.#...#.....#.#.#.#
.###.#############.#.#.#.#.#.#####.#.#.#####.#.#.#.#######.#.#.#
.#.................#.#.#.#.#.#...#.#.#.......#.#.#.#.....#...#.#
.#############.#######.#.#.#.#.###.#.#########.#.#.#.###.#.###.#
.......#.....#.........#...#.#...#...#.....#...#.#.#...#.#.....#
######.#.###.#############.#.###.#####.#####.###.###.###.#####.#
.#...#...#.#.#.....#...#...#.#...#.....#...#...#.....#...#.#...#
.#.#.#####.#.#.###.#.#.#####.#.#.#.###.#.#.###.#.#####.###.#.###
.#.#.......#...#.#.#.#.......#.#...#.#.#.#.....#.#.....#...#...#
.#.#.#####.#####.#.#.#########.#####.#.#.#########.#####.#####.#
.#.#...#...#.....#...#.#.......#...#...#...#.....#.#...#.#.....#
.#.###.#.#####.#######.#.#.#.#####.#.#####.###.#.#.#.#.#.#.#####
...#...#.....#.#.....#...#.#.#...#...#...#.....#...#.#...#.#...#
.###.#######.#.#.###.#.###.###.#.#.###.#.###########.###.#.#.#.#
...#.#.........#...#.#...#.....#.#...#.#.........#...#...#.#.#.#
##.#.###########.###.#.#######.#.###.#.#######.###.#.#####.#.#.#
.#.#.............#...#.#.....#.#...#.#.......#.....#.#.....#.#.#
.#.###############.###.#.###.#####.#########.#######.#.#######.#
.#...#.......#...#...#.#...#.....#.........#...#.....#.#.......#
.###.#####.#.#.#.###.#.###.#####.#####.###.###.#.###.#.###.#.#.#
.....#.....#.#.#...#.....#.#...........#.....#.#.#...#...#.#.#.#
.#####.#####.#.###########.#############.#####.#.#######.#.#.#.#
.#.......#.#...#.........#...#...#.....#.#.#...#.......#.#.#.#.#
.#####.#.#.###.#.#######.###.#.#.#.###.#.#.#.#########.#.###.#.#
.....#.#.#.....#...#...#.#...#.#...#.#.#...#...#...#...#...#.#.#
####.###.#####.###.#.#.#.#.#.#.#####.#.###.###.#.###.#.###.#.###
...#.#...#...#...#.#.#.....#.#.#.....#.#.#.#.#...#...#.#...#...#
.###.#.###.#.#####.###########.###.###.#.#.#.###.#.###.#.###.#.#
...#.#.#...#.......#...........#...#...#.......#.#.#...#...#.#.#
.#.#.#.#.#.#######.#.###########.#.#.###########.#.#.#####.#.#.#
.#.#...#.#.#.....#.#.#...........#.#.....#.......#.#...#...#.#.#
.#.#.###.#.#.###.#.#.###.#########.#####.#.#######.#####.#####.#
.#...#...#.#.#.#.#.#.#...#.......#...#.#.#.......#.#...#.......#
.#####.#####.#.#.###.#.###.#########.#.#.#######.#.#.#.#######.#
.....#.........#.......#...............#.........#...#.........#
################################################################
