64
...#.....#...................#...........#.........#.........#.#
.#.#.#.#.#.###.#############.###.#.#####.#.#######.###.#####.#.#
.#...#.#.#.#...#...........#...#.#.#...#...#...#...#...#...#...#
.#####.#.###.###.#########.###.#.#.#.#.#####.###.###.#####.###.#
.#...#.#.....#.......#...#.#...#.#...#...#.....#...#.....#...#.#
.#.#.#.#######.#####.#.#.#.#.###########.#.###.###.###.#.#.###.#
.#.#.#.......#.#...#...#.#.#.........#...#.#.#...#...#.#.#.....#
.#.#.#######.#.#.#.#.###.###########.#.###.#.###.###.###.#.#####
...#.#.....#.#.#.#.#.#.#.#.........#...#.......#...#.....#...#.#
####.#####.#.###.#.#.#.#.#.#######.#####.#######.###########.#.#
...#.#.....#.....#.#...#.....#...#.....#.#.....#.#.........#.#.#
.#.#.#.###.#######.###.#######.#.#####.#.#.###.#.#.###.###.#.#.#
.#.#.#.#.........#...#.#.....#.#.#...#.#.#...#...#...#...#.#...#
.#.#.#.#######.#####.###.###.#.#.#.#.#.#.###.#######.###.#.###.#
.#.#.#...#...#.#.....#...#.#...#.#.#.#...#...#.....#.#.#.#.#...#
.###.#.#.#.#.#.#.###.#.###.#####.#.#.#####.#.#.#.###.#.#.###.###
.#...#.#.#.#...#.#...#.......#...#.#.......#.#.#.#...#.#...#.#.#
.#.###.#.#.#####.#.#####.#####.###.###########.#.#.###.###.#.#.#
.#.#...#.#.....#.#...#...#...#.#.....#.......#.#...#.....#...#.#
.#.#####.###.###.###.#.###.#.#.#####.#.#####.#.#####.#########.#
.#.....#.#...#...#...#...#.#...#...#.....#...#.....#...........#
.#####.#.#.###.#.#######.#.#####.#.#######.#######.#.#####.###.#
...#...#.#.#...#.#.......#.......#.......#.......#.#..G..#...#.#
.###.###.#.#.###.#.#####################.###.#.#.#.#########.#.#
.........#.#.#...#.#...#...............#...#.#.#.#.........#.#.#
.#########.#.#####.###.#.#########.###.###.#.#.###########.#.###
.#...#.....#.....#...#.....#...#...#.#.#.#.#.#.......#...#.#...#
.#.#.#######.###.###.#.#####.#.#.###.#.#.#.#######.###.#.#.###.#
.#.#.......#.#.....#.#...#...#.#...#.#.#.#.......#...#.#.#...#.#
##.#######.###.#####.#.###.###.###.#.#.#.#######.###.#.#.###.#.#
...#.....#.....#.....#.#...#...#...#.#...#.....#...#.#.#...#...#
.###.###.###.###.#######.###.###.###.###.#.#.#####.#.#.###.###.#
.#...#.#...#.#...#.....#...#.#.....#.#...#.#.#...#.#.#.#.....#.#
.#.###.###.#.#.###.#.#.###.#.#####.#.#.###.###.#.#.#.#.#.#.###.#
.#.#.....#.#.#.#...#.#.#...#.......#.......#...#...#...#.#.#...#
.#.###.#.#.#.#.###.#.#.#.###########.#######.###########.###.###
...#...#.#.#.#...#.#.#...#.........#.#.#.....#...........#...#.#
.###.#####.#.###.###.#######.#####.#.#.#.#####.###########.###.#
.#...#...#.#...#...#...#...#...#.#.#.#.#.#...#.............#...#
.###.#.#.#.###.###.#.#.#.#.###.#.#.#.#.#.#.#.#.#############.#.#
.....#.#.#.#.#...#.#.#...#.#...#.#...#.#.#.#.#...#.......#...#.#
######.#.#.#.###.#.###.###.#.###.#####.#.#.#.###.#.#####.#.###.#
.......#...#.....#...#...#.#.#.......#.#.#.#.....#.....#...#.#.#
.###.###############.#####.#.###.###.#.#.#.###########.#####.#.#
.#...#.....#.....#.........#.....#...#.#.#...#.......#.#...#...#
.#####.###.#.###.#.#################.#.#.###.#.#####.#.###.#.###
.#.....#.#...#...#.#.#.........#...#.#.#.#...#.....#.#...#.#...#
.#.#####.#####.###.#.#.#######.#.#.#.#.#.#.#######.#.#.#.#.###.#
.#...#...#...#.......#.#.#...#...#.#...#.#.#.....#.#.#.#.#.....#
.###.#.#.#.#.#####.###.#.#.#.#####.#####.#.#.###.#.#.#.#.#.#####
.......#...#.#...#.#...#.#.#...#...#.....#...#...#.#.#.#.#.#...#
.#############.#.###.###.#.###.#.###.#########.###.#.###.#.###.#
.#.#...........#...#.#...#.#.#...#...#.......#...#.#.....#.....#
.#.#.#############.#.#.###.#.#######.#.###.#.###.#.###########.#
...#.#.....#.......#.#.#...#.........#...#.#...#...#.........#.#
####.#.###.###.#####.#.#.#####.#########.#.#########.###.#.###.#
.....#...#...#...#...#...#.....#.......#.#.#.......#...#.#.#...#
.#######.###.###.#.###.###.#########.###.#.#.###.#.###.#.###.###
.#.....#.#.#...#...#.......#...#.....#...#.#.#.#.#.#...#...#...#
.#.###.#.#.###.#############.#.#.###.#.###.#.#.#.###.#####.###.#
.#.#.#...#.#...#...#.......#.#...#...#...#.#...#.#...#...#...#.#
.#.#.#####.#.###.#.#.#####.#.###########.#.###.#.#.###.#.###.#.#
...........#.....#.......#S#.............#.....#.......#...#...#
################################################################
