8
.#S..#.#
.###.#.#
.#...#.#
.#.###.#
.#...#.#
.###.#.#
G......#
########
