8
....S#.#
.#####.#
.#.....#
.###.#.#
...#.#.#
##.###.#
......G#
########
