8
.#S..#.#
.###.#.#
...#.#.#
.###.#.#
...#.#.#
.#.#.#.#
.#..G..#
########
