16
...#.......#...#
.#.#.###.#.#.#.#
.#.#.#.#.#...#.#
.###.#.#.#######
.....#.#.#.....#
####.#.#.#.###.#
...#...#...#.#.#
.#.#######.#.#.#
.#.#.....#...#.#
.#.#.###.#####.#
S#...#...#.....#
######.###.###.#
.....#.....#.#G#
.#.#########.#.#
.#.............#
################
