16
...#.......#...#
.###.###.###.#.#
..G....#...#.#.#
.#########.#.#.#
...#.#...#...#.#
##.#.#.#.#####.#
.#.#.#.#.......#
.#.#.#.#######.#
.#.#.#.....#...#
.#.#.#####.#.###
...#.#.....#...#
.###.#.#####.###
.#...#.....#.#S#
.###.#####.###.#
.........#.....#
################
