32
.#.........#...#.#.....#.......#
.#.#######.#.#.#.#.#.#.#.#####.#
.#.#.....#...#.#..G#.#.#...#...#
.#.#.###.#####.#####.#.###.#.#.#
.#.....#...#.#...#...#...#.#.#.#
.#########.#.###.#.#####.###.#.#
.....#.....#...#...#...#.#...#.#
####.#.#####.#######.###.#.###.#
.....#.#.....#.......#...#...#.#
.###.#.###.###.#.#####.###.#.###
.#...#...#.....#...#...#...#...#
.#######.###.#####.#.#########.#
.#.....#...#.....#.#...#.....#.#
.#.###.###.#######.###.#.###.#.#
...#.#...#...#.....#.#...#.#...#
.###.#.#.###.#.###.#.#####.###.#
.#...#.#.#...#...#.......#.....#
.###.#.#.#.#####.#####.###.#####
.....#.#.#.#.....#.....#...#...#
####.#.###.#.#####.#####.###.###
.....#.#...#...#.....#...#.....#
.#####.#.#####.#.#####.#######.#
...#...#.#.....#.#.#...#.......#
####.#.#.###.###.#.#.###.#####.#
.....#.#S#...#.....#.....#.....#
.#########.###############.#####
.#.........#.............#.#...#
.#.#####.###.#########.###.#.#.#
.#.....#...#...#.....#.....#.#.#
.#####.###.###.#.###.#########.#
.........#.......#.............#
################################
