16
.....#...#.....#
.###.#.#.#.###.#
...#.#.#...#S#.#
##.#.#.#####.#.#
.#.#.#...#...#.#
.#.#.#####.###.#
.#.#.#.....#...#
.#.#.#.#######.#
.#.#.#...#.....#
.#.#.###.#.###.#
.#.#.....#.#...#
.#.#######.#.###
.#...#.....#.#.#
.###.###.###.#.#
......G..#.....#
################
