32
...#.........#.....#.........#.#
.#.#.#######.#.###.#####.###.#.#
.#...#.....#...#.#.#.....#.#...#
.#####.###.#####.#.#.#####.###.#
.#...#...#.......#...#.#.......#
.#.#.#####.#.#########.#.#######
...#.....#.#.#...#.....#.....#.#
.#######.#.#.#.#.#.###.#####.#.#
.....#.#.#.#.#.#...#.#...#.....#
####.#.#.###.#.#####.#.#.#.###.#
...#.#.#...#.#.#.....#.#.#.#S#.#
.#.#.#.###.#.#.###.#.#.###.#.#.#
.#.....#...#.......#.#.....#.#.#
########.###.###############.#.#
.......#.#.#.#...........#...#.#
.#####.#.#.#.#.#########.#.###.#
...#.#.#.#...#.....#...#.#...#.#
##.#.#.#.#.#######.#.#.#.###.#.#
...#.....#...#...#...#.#...#.#.#
.###########.#.#.#####.###.#.#.#
...........#.#.#...#...#.#...#.#
.#########.#.#.###.#.###.#######
.#.....#...#.#.#.#...#.........#
.#.#####.#.###.#.#####.###.###.#
...#...#.#.#...#.........#.#.#.#
##.#.#.#.#.#.#########.###.#.#.#
.#.#.#...#.#.........#.#...#...#
.#.#.###.###########.###.###.###
.#.#G#...#.........#.....#.#...#
.#.#.#####.#######.#######.###.#
...#.............#.............#
################################
