16
...........#...#
.#####.#####.#.#
.#...#.#...#.#.#
.#.#.###.#.#.#.#
...#.....#...#G#
.#############.#
...#...........#
##.#.#########.#
.#.#.........#.#
.#.#########.#.#
...#.....#...#.#
.###.#####.###.#
.#...#.....#...#
.###.#.#####.###
.....#..S#.....#
################
