16
.............#.#
.###.#######.#.#
...#G#.....#.#.#
####.#.#####.#.#
.....#.#...#...#
.#####.#.#.###.#
.#...#...#.....#
.#.#.###.#####.#
.#.#...#.#...#.#
.#.###.###.#.###
.#.#.#.....#..S#
.#.#.###########
.#.#...........#
.#.###.#######.#
.......#.......#
################
