16
.....#.........#
.###.#########.#
.#.#.........#.#
.#.#####.###.#.#
...#.#S#.#...#.#
##.#.#.###.###.#
.#...#...#.#...#
.###.###.#.###.#
...#.#.#.#.#...#
##.#.#.#.#.#.#.#
...#.#.#...#.#.#
.#.#.#.#####.###
.#.#...#.......#
.#####.#######.#
G..............#
################
