64
...#.#...........#.....#.....#.....#.................#.....#...#
.#.#.#.#########.#.###.#.###.#.#.###.#########.#####.###.#.###.#
.#...#.#.......#...#...#...#...#...#.#...#.....#...#.#...#...#.#
.###.#.#######.#####.#####.#####.#.#.#.#.#.#.#####.#.#.#####.#.#
.#...#.........#.....#...#.#...#.#...#.#...#.#...#.....#...#.#.#
.#.#########.###.#####.#.#.#.#.#######.#####.#.#.#######.#.#.#.#
.#.#...#.....#...#.....#.#.#.#.....#...#...#.#.#...#...#.#...#.#
.###.#.#.#####.#.#.#####.#.#.#####.#.###.#.###.###.#.###.#####.#
...#.#...#...#.#.#...#...#.#.#.....#.#...#.#.....#.#...#.#.....#
##.#.#####.#.#.#####.#.###.#.###.###.#.###.#.#####.#.#.#.#.###.#
...#...#...#.#.#.....#...#.#...#...#.....#.#.#.#...#.#...#.#...#
.#####.#.#.###.#.#######.#.###.###.#######.#.#.#.#####.###.#.###
.....#.#.#.#...#.#.....#.#...#...#.........#.#.#.#...#.....#.#.#
.###.#.#.###.#.#.###.#.#.###.###.#.#######.#.#.#.#.#.#######.#.#
.#.#...#...#.#.#...#.#.#.#.#...#.#.#.....#.#...#...#.......#...#
.#.#######.#.#####.###.#.#.###.#.###.###.#####.#########.#.#####
.#.........#.........#.#.#.....#...#.#.#.#...#.....#...#.#.....#
.#.#####.###########.#.#.#.#######.#.#.#.#.#.#####.#.#.#######.#
.#.....#.....#.....#...#.#.......#.#.#.#.#.#.......#.#.........#
.###.#####.#.#.###.#####.###.#####.#.#.#.#.#########.###########
.#...#.....#.#...#.......#...#.....#.#.#...#.......#...........#
.#####.#.#######.#############.#.###.#.#########.#############.#
......G#.#.......#...........#.#.#...#...........#...........#.#
########.#.#####.#.#########.#.###.###.###.#####.#.#########.#.#
...#.....#.#.....#.........#.#.#...#...#.#.#.....#.#.......#.#.#
.#.#.#####.###########.#####.#.#.###.###.#.###.###.#.#######.#.#
.#.#.#...#.........#...#.....#.#.#.#...#.#...#...#.#.......#...#
.###.#.###########.#.###.#####.#.#.###.#.###.###.#.#######.###.#
.....#...........#...#.#.#.#.....#.........#.#.#.#.#...#.....#.#
.#####.#########.#####.#.#.#.#######.#######.#.#.#.#.#.#.#.###.#
...#...........#.......#.#.........#.#.......#.#.#.#.#...#.#...#
##.###########.#####.###.#########.###.#######.#.#.#.#######.###
.#.....#.....#.#...#...#.........#...#.#...#...#.#.#...#...#...#
.#####.#.###.#.#.#####.#########.###.#.#.###.#.#.#.###.#.#.###.#
.....#.#.#.#.....#.......#.....#...#...#.#...#...#...#...#.....#
.#.###.#.#.#######.#####.###.#.###.#####.#.#######.#.#.#####.###
.#.....#...#.......#...#...#.#...#.....#.#...#...#.#.#.#...#.#.#
.###########.#######.#####.#.#########.#.#.###.#.#.#.###.#.#.#.#
.#...........#.......#.....#.........#.#...#...#.#.#...#.#.#...#
.#.###########.###.###.#####.#####.###.#####.###.#.###.#.#.###.#
...#...#.........#...#...#.......#...#.......#...#...#...#.#...#
####.#.#.###########.###.#######.###.#########.#####.#####.#.###
.....#.#.....#.......#.#.......#.#.#.......#...#.........#.#...#
.###########.#.#####.#.#######.#.#.#.#####.#.###########.#.#####
.........#...#...#...#.....#.#.#.#.#.#.....#.#.......#...#.....#
########.#.#####.###.###.#.#.#.#.#.#.#.#####.#.#####.###.#####.#
.........#.#...#...#.....#.#.#.#...#.#.....#.#...#.#...#.....#.#
.#########.#.#####.#######.#.#.#####.#####.#.###.#.###.#######.#
.....#...#.#.#...#...#.....#.#.......#...#.#.........#.#.......#
.###.#.#.#.#.#.#.###.###.###.#########.#.#.###########.#.#####.#
.#.#...#...#...#...#...#.....#.......#.#.#.#.#S..#.....#...#...#
.#.###############.###.#####.#####.#.#.#.#.#.###.#.#####.#.#.###
.#...................#.#...#.......#.#.#.#.....#.#...#.#.#.#...#
.#.#################.#.#.#.#.#####.###.#.###.###.#.#.#.#.#.###.#
...#.......#.........#.#.#.#.#...#.#...#.....#...#.#.#...#...#.#
####.###.###.#########.#.#.#.#.#.#.#.#########.#####.#######.###
...#...#.....#.......#.#.#.#.#.#.#.#.#.....#.#.......#.....#...#
.#####.###########.#.#.#.#.###.#.###.#.###.#.#########.###.###.#
.....#.#.........#.#.#...#.....#...#.#.#...#...........#.#...#.#
.#.###.###.#####.#.###############.#.#.#.###.###########.###.#.#
.#...#...#...#.#.#.....#...........#...#.#...#.....#.......#.#.#
.###.###.###.#.#.#####.#.###############.###.#.#####.#####.#.#.#
...#.........#.........#.....................#...........#.....#
################################################################
