64
.........#.......#.......#.....#.....#...#.......#...#.........#
##.#####.#######.#.#####.###.#.###.#.#.#.#.#.###.###.#.###.###.#
...#...#.....#...#...#...#...#.....#.#.#...#.#.......#...#.#.#.#
.###.#.#####.#.#.###.#.###.#########.#.#####.#######.###.#.#.#.#
.....#...#.....#.#...#.....#.#.......#...#...#.....#.#...#.#...#
.#######.#######.#.#########.#.#########.#.###.###.###.###.#####
...#...#...#.#...#.#...........#.#.....#.#.#...#...#...#...#...#
##.#.#.###.#.#.###.#####.#######.#.#.###.#.#.###.###.###.###.#.#
.#.#.#...#.#.#...#.....#...#.......#...#.#...#...#.....#.....#.#
.#.#.#.###.#.###.#####.###.#########.#.#.#####.###.#########.#.#
.#.#.#.#...#...#...#.#...#.........#.#.......#.....#.......#.#.#
.#.#.#.#.###.#####.#.###.#########.#################.#####.#.#.#
.#.#.#.#.#.........#...#...#.....#.#...#.............#.....#.#.#
.#.#.###.#####.#####.#####.###.#.#.#.#.#.#############.#######.#
...#...#.....#.#...#.....#...#.#.....#...#.......#...#.#.....#.#
.#####.#####.#.#.#.#.###.###.#.###########.#.###.#.#.#.###.#.#.#
.....#.....#.#...#.#.#.....#.#.#.......#...#.#.....#.#.....#...#
####.#.#####.#####.###.###.#.###.#####.#####.###.#############.#
.....#.#...#.#...#.....#.#.#.#...#...#.....#...#.#...#.......#.#
.#####.#.#.#.#.#.#######.#.#.#.###.#.#####.###.#.#.#.#.#####.#.#
.#...#.#.#.#.#.#...#...#...#.#.#...#S#...#...#.#.#.#...#...#...#
.#.#.#.#.#.#.#.###.###.#.###.#.#.#####.#####.#.###.#####.#.#####
...#...#.#.#.#.#.....#.....#.#.#.#.....#.....#.....#.#...#...#.#
.#######.#.#.#.#####.#######.#.#.###.#.#.#####.#####.#.#.###.#.#
.#.......#...#...#.#.....#...#...#...#.#.....#.....#...#...#...#
.#.#######.#####.#.#####.#.#.#####.#########.#####.#######.#####
.#...#.....#.....#.....#...#...#.....#.......#...#.....#...#...#
####.#.#####.#####.###.#####.###.###.#.#######.#######.#.###.#.#
.....#.#.....#.......#.....#.#...#.#.#.....#.........#.#.....#.#
.#######.#.#########.#.#####.#.###.#.#####.#.###.#####.###.###.#
.....#...#.#.......#.#.......#.....#.....#.#.#.#.....#...#...#.#
.###.#.#####.#####.###.###########.###.###.#.#.#####.###.#####.#
...#.#.#.....#...#...#.......#...#.#.#.....#.#.....#.....#...#.#
.###.#.#.#######.###.#######.###.#.#.#######.#.#.#.#######.#.#.#
.#...#.#...#.....#.#.#.......#...#...#...#.#.#.#.#.#.#.....#...#
.#.#.#.###.#.#.#.#.#.#####.###.#####.#.#.#.#.###.#.#.#.#.#######
.#.#.#.#...#.#.#...#.....#.....#.....#.#...#.....#.#...#.......#
.#.#.#.#.#####.#########.###.###.#####.#.#########.#.#########.#
.#.#.#...#.....#.....#...#...#...#.....#.#.......#.#.......#.#.#
.#.#.#####.#.###.#.#.#.#######.###.#.#####.#####.#.#######.#.#.#
.#.#...#...#.#...#.#.#.........#...#.#.........#.#.#.........#.#
.#.#####.#.###.###.#.###########.###.#.#######.#.#.#.#########.#
.#.#.....#.....#...#.#.......#.....#...#...#...#.#.#...#.....#.#
.#.#.###########.#####.###.#.###########.#.#####.#.#####.###.#.#
.#...#.......#...#.......#.#.#...........#.......#...#...#.#.#.#
.#####.#####.#.###.#######.#.#.#####################.#.###.#.#.#
.......#.#...#.#.....#.....#...#...................#.#...#.#.#.#
########.#.###.#.#####.#######.#.#################.#.###.#.#.#.#
.....#.....#.#...#.....#.....#.#.#...........#.....#.....#.#...#
.#.###.#####.#####.#####.###.#.#.###.#.#.#####.###########.###.#
.#...#.#.....#.....#...#...#.#.#...#.#.#.#...#.............#...#
.###.#.###.#.#.#####.#.###.#.#####.###.#.#.#.#######.#####.#.###
.#...#.....#.#.....#.#...#.#.......#...#.#.#.......#.#...#.#.#.#
.#.#####.#########.#.###.#.#########.###.#.###.###.#.#.#.#.#.#.#
.#.....#.#.........#...#...#.....#...#...#...#.#...#.#.#.#.#...#
.###.###.#.#####.#####.#####.###.#.#.#####.###.#####.#.#.#.###.#
.#.#.....#.#...#.#.....#.....#...#.#.......#...#.....#.#.#.#...#
.#.#######.#.#.#.#.#######.###.#####.#######.###.#####.#.###.###
.........#...#.#.#.#.....#.#...#...#.......#...#.......#...#.#.#
########.#####.#.#.###.#.#.#.###.#.###########.###########.#.#.#
.....#...#.#...#.#...#.#.#.#...#.#.........#...#.......#.#.#...#
.#.###.###.#.#######.#.#.#.###.#.#########.#.#.#####.#.#.#.###.#
.#......G..#...........#...#.....#...........#.......#...#.....#
################################################################
