16
.....#.#.....#.#
##.#.#.#.#.#.#.#
G..#.#...#.#...#
.###.#####.###.#
.#.......#...#.#
.#######.###.###
...#...#...#.#S#
##.#.#####.#.#.#
...#.....#.#.#.#
.###.###.#.#.#.#
...#...#.....#.#
.#.###########.#
.#.....#.......#
.#####.#.#######
.....#.........#
################
