32
G....#.......#...#.........#...#
.###.#.#.#####.#.#.#####.#.#.#.#
.#...#.#.#.....#.....#...#...#.#
.#.#####.#.###########.#######.#
.#.......#.#.......#...#.......#
.#########.###.#.###.#######.###
.......#...#...#.#...#.....#...#
######.#.###.#####.###.###.###.#
.......#.....#...#.......#...#.#
.#####.###.###.#.#########.#.###
.....#...#.#...#.....#..S#.#...#
####.###.#.#.#######.#.###.###.#
.....#...#.#.#...#.#.#.#.#...#.#
.#######.#.#.#.#.#.#.#.#.#.###.#
.#.....#.#.#...#...#...#.#.#...#
.#.###.#.#.#######.#####.#.#.#.#
.....#.#.#.....#...#.....#.#.#.#
.#####.#####.###.#####.#.#.#.###
.#...#.....#.#...#...#.#...#...#
##.#.#####.#.#.###.#.#########.#
...#...#...#.#.....#.#.........#
.#####.#.###.#######.#.#######.#
.#.......#...#...#...#.......#.#
.###.#####.#####.#.#########.#.#
...#.#.....#.....#.#.........#.#
##.#.#.#####.###.#.#.#########.#
...#.#.#.......#.#.#.#...#.....#
.#####.#.#####.#.#.#.#.#.#######
.#.....#.#...#.#.#.#...#.......#
.#.#######.#.#.#.#.###########.#
...........#...#.#.............#
################################
