64
...#...#.....#.....#...#.....................#...#...........#.#
##.#.#.#.###.#.#.#.#.#.#.###############.###.#.#.#.#####.###.#.#
...#.#.#.#...#.#.#...#.#...#.....#.......#.#.#.#...#...#...#...#
.#.#.#.#.#.###.#.#####.###.#####.#.#######.#.#.#######.###.###.#
.#.#.#...#.#...#.....#...#.....#.#...#.#.....#.#.....#...#.#...#
.###.#####.#.#######.#########.#.###.#.#.#####.###.#.#.#.#.###.#
...#.#...#.....#...#.......#...#...#.#.......#.....#.#.#.#...#.#
.#.#.###.#######.#.#####.#.#.###.#.#.#######.#######.#.#####.#.#
.#.#.....#.....#.#.......#.#.....#.#...#...#.#...#...#.....#.#.#
.#.#####.#.###.#.#########.###.#######.###.#.###.#.#######.#.###
.#.#.....#.#...#.#...........#.#.......#...#.....#.........#...#
.#.#.#####.#.###.#.###########.#.#######.###.#############.###.#
.#.#.#.#...#...#.#...#.........#.#...........#...........#.#...#
.#.#.#.#.#####.#.#.###.#########.#.###########.###.###.###.#.###
.#.....#.#...#...#.#.......#...#.#.#...........#.#...#.#...#...#
########.#.#####.###.#######.#.#.###.###########.###.###.#####.#
.......#.#.......#.....#.....#...#...........#.....#.......#.#.#
.#####.#.#########.#####.#########.#########.#####.#######.#.#.#
.#...#...#.........#.#...#.......#.#.#...#.........#.....#...#.#
.#.#.#####.#########.#.###.#####.#.#.#.#.#########.#.###.###.#.#
.#.#.......#.........#.....#...#.#...#.#...#.......#.#...#.#.#.#
.#.#########.###############.###.###.#.###.#########.###.#.#.#.#
.#.......#...#.....#.........#...#...#.#.#.....#..S#...#.#...#.#
.#######.#.#.#.###.#.#######.#.###.###.#.#####.#.#####.#.#.###.#
...#.#...#.#.....#.#.....#.#.#...#...#.#...#.#...#.....#.#.#...#
.#.#.#.###.#######.#####.#.#.###.###.#.#.#.#.#####.#.###.#.#.#.#
.#...#.#...#.#.........#...#...#.....#...#.#.....#.#...#.#.#.#.#
.#.###.#.###.#.#####.#####.#.#############.#.#.###.###.#.###.#.#
.#.#...#...#.#.#.#...#.....#.#.......#...#.#.#.....#...#.....#.#
.###.#####.#.#.#.#.###.#####.#.###.###.#.#.#####.###.#########.#
.....#.......#.#.....#...#.#...#.#.#...#.#.....#.#...#.........#
.###########.#.#########.#.#####.#.#.###.#####.###.#############
.......#...#.#...............#...#.#.#.#...#...#...#.....#.....#
######.#.#.###.#############.#.###.#.#.#.###.###.###.###.#.###.#
.#...#...#...#.......#...#.....#...#.#.#.....#.........#...#...#
.#.#.#######.#####.###.#.#.#####.#.#.#.###############.#####.#.#
...#.......#.....#.#...#.#...#...#.#...#.#.........#.#.#.#...#.#
.###.#####.#####.###.###.#.###.###.###.#.#.#.#####.#.#.#.#.#####
.#.#.#...#.#.....#...#.#.#.#...#.....#.#...#.#.....#.....#.....#
.#.#.#.#.###.#####.###.#.#.#.#########.#####.#.#########.#####.#
.#.#.#.#.....#.....#.....#.#.#...#...#.......#.........#.....#.#
.#.#.#.###########.#.#######.#.#.#.#.#################.#######.#
...#.#.#.....#...#.#.#.....#...#...#...#.........#...#.......#.#
.###.#.#.###.#.#.#.#.#.#.#.#####.###.#.#.#######.#.#########.#.#
.#...#.#...#...#.#.#.#.#.#.#...#.#...#...#.......#.#.......#...#
##.###.#.#.#####.#.#.#.#.#.#.#.###.#######.#######.#.#.#########
...#...#.#.#...#...#.#.#.#...#.#...#.....#.......#...#.........#
.###.#####.#.#######.###.#####.#.###.###########.###.#######.#.#
...#.#.....#.#.......#...#.#...#.#...#...#.....#...#.......#.#.#
##.#.#.#####.#.#######.###.#.###.#.#.#.#.#.###.###.###.#####.#.#
...#...#.....#.........#.....#...#.#...#...#.#.....#...#.....#.#
.#######.###.###########.#######.#.#########.#######.###.#######
.......#...#...#...#.....#.......#.........#.....#.#.#.#.......#
.#.#######.###.#.#.#.#####.###############.#.###.#.#.#.#######.#
.#...#.......#...#.#.#.....#.......#...#.#.#.#.#.#.#...#.#.....#
.###.#.###########.#.###.###.###.#.#.#.#.#.#.#.#.#.###.#.#.#####
.#.#.#.....#.......#...#...#.#...#...#...#...#.#.#...#...#.....#
.#.#.#.#####.#########.###.#.#.###.###########.#.###.#.#######.#
.#.#...#.....#...#...#.....#.#...#.#.....#.....#...#...#.......#
.#.#####.#####.#.#.#.#######.###.#.#.###.#.#.#####.#####.#####.#
.#...#...#...#.#...#...#...#.#.#.#.#...#.#.#.....#.......#.#...#
.###.#.###.#.#.#####.###.#.#.#.#.#####.#.#.###.###########.#.###
G....#.....#.......#.....#.....#.......#.....#.................#
################################################################
