64
.......#.......#.........#...#...#.........#.......#.......#...#
.#####.#.###.###.###.#####.#.#.#.#.#.#####.#.#.###.#.#####.#.#.#
.#.....#...#.#...#.#...#...#...#...#.#...#.#.#...#.#...#.#...#.#
.#.#.#####.#.#.###.###.#.###########.###.#.#.###.#.###.#.#####.#
.#.#.#.....#...#.....#.#.........#...#...#.#...#.#.#...#.#...#.#
##.###.#########.#.#.#.#########.#.###.#.#.#####.#.#.###.#.#.#.#
...#...#.#G....#.#.#.#...#.......#.#...#.#...#...#...#.#...#.#.#
.###.###.#.#.#.#.#.#####.#.#######.#.#######.#.#######.#.###.#.#
.#...#.....#.#.#.#.#.....#.#.#.....#...#...#...#.......#.#...#.#
.#.#########.#.###.#.#.###.#.#.#######.#.#.#####.#######.#.###.#
.#.#.........#...#.#.#.#...#.#...#...#...#.....#.....#...#.#...#
.#.#.###########.#.#.###.###.###.#.#.#####.#####.###.#.###.#.###
.#.#.#.............#...#...#...#...#.....#.#.....#.#.....#.#...#
.#.#.#.###############.###.###.#########.#.#.#####.#######.###.#
...#.#...#...#...#.....#.#...#...#.....#.#.#.....#.....#...#...#
.###.###.#.#.###.#.###.#.###.#.#.#.###.#.#.#####.#.#####.###.###
.#...#.#...#.....#.#.#.#...#.#.#.#.#...#.#.....#.#.....#.....#.#
.#.#.#.#########.#.#.#.#.#.#.#.#.#.#.###.#.###.#.#.###.#######.#
.#.#.#...........#.#.#.#.#.#...#...#...#.#...#.#.#...#.........#
.###.###########.#.#.#.#.#############.#.#.#.#.#.#######.#######
...#.#.........#.#.#.#.#.#.....#.......#.#.#.#.#.#.....#.......#
##.#.#.#######.#.#.#.#.#.#.###.#.#######.#.#.###.#.###.#.#####.#
.#.#...#.....#.#.#.#.#...#...#.......#...#.#.....#.#.#.#.#.....#
.#.#####.###.#.###.#.###.#.#########.#.###.#######.#.#.###.###.#
.#.#.....#.....#...#.#...#.#.......#.#.#.#.#.......#.#...#.#.#.#
.#.#.#####.#####.###.#.###.#.#####.###.#.#.#####.###.###.#.#.#.#
.#...#...#.#...#.#.....#...#.....#.....#...#...#.#.....#...#.#.#
.#####.#.#.#.#.#.#.#####.#######.#######.###.#.#.#.#########.#.#
.....#.#...#.#.#.#.....#...#...#.#...#.#.#...#...#.........#...#
.#####.#####.#.#.#########.###.#.#.#.#.#.###.#####.###.###.#.###
.#.......#...#.#...#...#...#...#.#.#...#.....#.....#...#...#.#.#
.#.#######.###.###.#.#.#.###.###.#.###.#######.#####.###.###.#.#
...#.......#.......#.#...#...#...#.#.......#.......#.#.#...#.#.#
.###.#.#####.#####.#.#####.#.#.###.#######.#.#######.#.###.#.#.#
.#...#.#...#.#...#.#.#.....#.#.#...#...#.#.#.#.......#.....#...#
.#.###.#.#.###.#.###.###.#####.#.###.#.#.#.###.###.###########.#
.#.#...#.#...#.#...#.#...#...#.#.....#.#...#...#.#.#...........#
.#.###.#.###.#.###.#.#.###.#.#.#.#####.#.###.###.#.#.###########
.#...#.#.#.#...#.#...#.#...#...#...#...#.....#...#.#...#.......#
.###.#.#.#.#####.#####.#.#######.###.###########.#.###.#.#####.#
...#.#.#.#.......#.....#.....#...#...#.........#.#...#...#...#.#
##.#.#.#.###.###.###.#.#####.#####.###.#######.#.###.#####.#.#.#
.#.#.#.#.....#.#...#.#.....#.#...#.#.......#.#.#...#.#...#.#.#.#
.#.#.#########.###.#.#####.#.#.#.#.#######.#.#.###.#.#.#.#.###.#
.#.#.....#.....#...#.....#.#...#.#.#.....#.#.#.....#...#.#.#...#
.#.###.#.#.#.###.#######.#.#####.#.#.###.#.#.#####.#####.#.#.###
.#.#...#...#.#...#.......#.#...#.#.....#.#.#...........#.#.#.#.#
.#.#.#######.#.#####.#####.#.#.#.#######.#.#############.#.#.#.#
.#.#.#.....#.#...#...#...#...#.#.#.....#.#...#...#.........#.#.#
.#.#.#.###.#.###.#.#####.#####.#.#.###.#.###.#.#.#.#########.#.#
...#.#.#.#...#...#.....#...#...#...#...#...#...#...#...#.....#.#
.###.#.#.#####.###.###.#.#.#.#######.#####.#####.#####.#.#####.#
...#.#...#...#.#...#.#.#.#.#.....#S#...#...#...#.......#.#.....#
##.#.###.###.#.#.###.#.#.#.#####.#.#.#.#.###.#.#######.#.#.###.#
.#.#.#.#...#.#.#.#...#.#.#.#.....#.#.#.#...#.#...#.#...#...#.#.#
.#.#.#.###.#.#.#.#.#.#.#.###.#####.#.#.#.#.#.###.#.#.#######.#.#
...#.#...#...#.#...#.#.#.....#.#...#.#.#.#.....#.#.....#.......#
.###.###.###.#.#######.#.#####.#.#####.#######.#.#.#####.#######
...#...#.....#...#...#.#.#.....#.#...#...#...#.#.#.#...#.#.....#
##.###.#.#######.#.#.#.#.#.###.#.#.#.###.#.#.###.#.#.#.#.#.#.###
.#.#...#...#.....#.#...#.#.#...#.#.#...#.#.#.....#.#.#...#.#...#
.#.#.#######.#####.#####.###.#.#.#.###.#.#.#########.#########.#
...#...............#.........#.#...#.....#.....................#
################################################################
