64
...#...........#...#.....#.....#.........#...#.......#.....#...#
##.#.#####.###.#.#.###.###.###.#.#######.#.#.###.###.###.#.#.#.#
...#...#.#...#...#...#.#S#.#...#.......#.#.#.....#.#...#.#...#.#
.#####.#.###.#######.#.#.#.#.#####.###.#.#.#######.###.#######.#
.#.....#...#.....#.....#...#.#...#.#...#.#.#.....#...#.#.....#.#
.#.#####.#.#####.###########.#.#.###.###.#.#.#####.#.#.#.###.#.#
...#...#.#...#.#.............#.#.....#.#.#.#...#...#...#.#.#...#
.###.#.#.###.#.###############.#######.#.#.###.#.#######.#.###.#
.#...#...#.#.....#.....#.......#.....#.#...#...#.....#...#...#.#
.###.#####.#####.###.#.###.#####.###.#.#####.#.#####.###.#.###.#
...#...#.#.......#...#...#.#...#...#...#.....#...#.#.....#.#...#
##.#.#.#.#.#######.#####.#.#.###.#.###.#.#######.#.#######.#.###
.#.#.#.#.#.#.#.....#...#...#...#.#.#.....#.....#...#...#.....#.#
.#.###.#.#.#.#.###.#.#.#####.#.#.#.#######.#######.#.#.#.#####.#
.#...#.#...#.....#.#.#.#...#.#.#.#.....#...#...#...#.#.#...#...#
.###.#.###.#####.#.#.#.###.#.#.#.#####.#.#.#.#.#.#####.###.#.###
.#...#...#...#...#.#.#...#...#...#.#...#.#...#.#.....#.#...#...#
.#.###.#.###.#####.#.###.###.#####.#.#######.#.#####.#.#.###.#.#
.#...#.#...#...#...#...#...#...#...#...#...#.#.........#...#.#.#
.###.#.###.###.#.#####.###.###.#.#.###.#.#.#####.#########.#.#.#
.....#...#...#...#...#.#.#.#.....#.#...#.#.#...#.....#.....#.#.#
.#####.#####.#####.#.#.#.#.#######.#.###.#.#.#.###.###.#######.#
.....#.#.....#.....#...#.........#.#.#...#...#.#...#...#.....#.#
####.#.#.#####.#################.###.#.#######.#####.###.###.#.#
...#.#.#...#.......#.....#.....#.....#.....#.#.....#...#...#...#
.#.#.#####.#####.#.#.###.#.#.#######.#####.#.#####.###.###.###.#
.#.#...#...#...#.#...#...#.#.#...#...#.#...#.#.....#...#...#...#
##.###.#.###.#.#######.###.#.#.#.#.###.#.###.#.#####.###.###.###
.....#.#.#...#.........#...#...#.......#.#...#.....#...#...#...#
.#####.#.###.#######.###################.#.#######.###.#.#.###.#
.#...#.#...#.....#...#.....#.....#...#...#.......#...#.#.#...#.#
.#.#.#.#.#.###.#.#####.###.#.###.#.#.#.###.###.#####.#.#.###.#.#
...#...#.#...#.#.#...#.#.#...#.#...#.#.#...#.#.....#.#.#...#.#.#
.###########.#.#.#.#.#.#.#####.#####.#.#.###.#####.#.#.#####.#.#
.#.....#.....#.#...#...#...........#...#.#.....#.#.#...#.....#.#
.#.#.#.#.#####.#############.#####.#####.#.###.#.#.#####.#######
.#.#.#...#...#...#.........#.#...#...#.....#.#.#.#.............#
.###.#######.###.###.###.#.#.###.###.#######.#.#.#############.#
.#...#.....#...#...#...#.#.#...#...#.....#...#.#.........#.....#
.#.###.#.#.###.###.#####.#.###.###.#####.###.#.#######.#.#.###.#
...#.#.#.#...#...#.#.....#...#...#.....#...#.....#...#.#.#.#.#.#
####.#.#.###.#.#.#.#.#######.###.#.#.#####.#####.#.#.#.###.#.#.#
...#...#.#.....#.#.#.#...#...#...#.#.....#.....#.#.#.#...#.#...#
##.#.###.#######.#.#.###.#.###.###.#####.#####.#.#.#.#.#.#.#.###
...#.#.#...#.....#...#...#.#...#.#.#.#...#...#.#...#.#.#.#.#...#
.###.#.###.###########.###.###.#.#.#.#.#.###.#.#####.###.#.###.#
...#.#.#...#.........#.#...#...#.....#.#.....#.#.#...#...#.#...#
##.#.#.#.###.###.###.#.#.###.###.#####.#####.#.#.#.###.#.#.###.#
...#.#.#...#...#...#...#.#.#...#...#...#.....#.#.#.....#.#...#.#
.###.#.###.###.###.#####.#.#.#.###.#.#.#######.#.#####.#####.###
.#...#...#.....#.#.......#...#.#.#.#.#.#.....#.#.....#.#...#...#
.#.#####.#######.#########.###.#.#.#.###.###.#.#.###.#.#.#.###.#
...#...........#.#.......#.#...#...#.#...#.#.#.#...#...#.#.....#
.#####.#######.#.#.#####.#.#.###.###.#.###.#.#.#.#####.#.#####.#
.....#...#...#.#.#.#...#...#...#...#.#.....#...#.#...#.#...#.#.#
####.###.#.###.#.#.#.#.#######.#####.#####.#######.#.#####.#.#.#
...#.....#...#.#.#.#.#.#.....#.....#.....#.....#...#.......#.#.#
.#.#########.#.#.#.#.#.###.#######.#.###.#####.#.###########.#.#
.#.#.........#.#.....#.....#.......#...#.......#...#...#.......#
.#.#.#####.#.#.###.#########.#########.###########.#.#.#.#######
.#.#.#.....#.#...#.#.........#.......#.#...........#.#.#.......#
.#.#.#.#########.###.#########.#####.#.#######.#####.#.#######.#
.#..G#...............#.............#...........#.....#.........#
################################################################
