32
...#.........#.......#.......#.#
##.#.#####.#.#.###.#.#.#####.#.#
...#.....#.#.#...#.#...#...#.#.#
.#######.#.#####.#.#####.###.#.#
.....#...#.......#.#...#.....#.#
.#.###.###########.###.#.#####.#
.#.....#.......#.#...#...#.....#
.#########.###.#.###.#.#####.#.#
...#.......#.......#.#.#...#.#.#
##.###.#####.#######.#.#.#.###.#
...#...#.......#...#.#.#.#.....#
.###.###########.#.#.#.#.#####.#
G....#.........#.#.#.#.#.....#.#
.#####.#######.#.#.#.#.#####.#.#
.#.....#.....#...#...#.......#.#
.#.#######.#####.#############.#
.#...#.....#.....#.......#.....#
.###.###.#.#.#####.#####.#.#####
...#.#...#.#.....#.#...#.#.....#
####.#.###.#####.#.###.#.#####.#
.....#...#.....#.#...#.#.....#.#
.#####.#.#######.###.#.#####.###
.....#.#...........#.#.....#...#
.###.#############.#.#.#######.#
...#...........#...#S#.........#
##.###########.#.#####.#########
.#.#.......#...#.....#.....#...#
.#.#.#.#####.#############.###.#
...#.#.#.....#...#.......#.....#
.#####.#.#####.#.#.###.#######.#
.......#.......#.....#.........#
################################
