32
.........#...............#.....#
.#######.###.#########.###.#.###
.#.....#...#.#.........#...#...#
.#.###.###.#.#.#######.#.#####.#
.#.#.#...#.#.#.#...#...#.#.#...#
.#.#.###.#.###.#.#.#.###.#.#.#.#
.#.....#.#.....#.#.#...#...#.#.#
.#####.#.#.#####.#####.###.#.###
.#.#...#...#...#.........#.#...#
.#.#.#######.#.###########.###.#
.#.......#...#.............#.#.#
.#######.#.###############.#.#.#
.#...#...#.#.....#.....#S#...#.#
.#.#.###.#.#.#####.###.#.###.#.#
...#...#.#...#...#...#...#...#.#
######.#.#.###.#.###.#####.###.#
.......#.#.#...#.#...#...#.#.#.#
.#######.#.#.###.#.###.###.#.#.#
.#.....#.#.#...#...#.#.......#.#
.#.###.#.#.###.#####.#.#######.#
...#.#.#.#...#...#.....#...#...#
.###.#.#####.###.###.###.#.#.###
.#...#.....#.#.#...#.....#.#...#
.###.###.###.#.###.###########.#
.....#...#...#...#.#.....#...#.#
##.###.#.#.#####.#.#.###.#.#.#.#
.#.#...#.#...#...#...#.#.#.#.#.#
.#.#.###.###.#.#.#####.#.#.#.#.#
...#...#...#.#.#.#.....#.#.#.#.#
.#####.#####.#.#.###.#.#.#.#.#.#
..G..#.........#.....#.#...#...#
################################
