64
.......#...............#.................#.........#.....#.....#
.#######.#############.#########.#.#####.#######.###.#.###.###.#
.......#.......#.....#.#.......#.#.#...#.......#.#...#.......#.#
.#####.#######.###.###.#.#####.###.#.#########.#.#.###########.#
.....#.....#.#...#.#...#...#...#...#...........#.#.....#.......#
.#######.#.#.###.#.#.#####.###.#.###.###########.#####.#.#####.#
.#.....#.#.....#.#.#.....#...#.#.#.#.......#...#.....#.#.....#.#
.#.###.#.###.###.#.#####.###.#.#.#.#######.#.#.#.#.#.#.#####.###
.#...#.#...#.#...#...........#.#.#.........#.#...#.#.#.#...#...#
.###.#.###.###.###############.#.#######.#########.###.#.#.###.#
...#.#.#...#...#.............#.#.......#.#.......#.......#.#...#
####.#.#.#.#.###.###########.#.###.###.#.#.#####.#.#########.#.#
.....#...#.#...#...#.......#.#...#.#...#...#.....#.#.......#.#.#
.#.#######.###.###.#.#####.#.###.#.#.###########.###.#####.#.###
.#.#...#.#.#.#.....#...#...#.#...#.#.#...#.....#.....#.#...#...#
.###.#.#.#.#.#######.#.###.#.###.###.#.#.#.###.#######.#.#####.#
.#...#.#...#.....#...#...#.#...#...#...#...#...#S#.....#...#...#
.#.###.###.#####.#.#####.#####.###.#########.###.#.#######.#.#.#
.#...#...#.......#.....#.....#...#...........#...#.#.......#.#.#
.###.###.#######.#####.#####.###.#########.###.###.#.#######.###
.#...#...#...#.......#.#.#.....#.....#.....#...#...#.#...#.....#
.#.###.###.#.#.#######.#.#.#.#######.#######.###.#.#.#.#.#####.#
.#...#...#.#...#.......#.#.#.#.....#...#.....#.#.#...#.#.......#
.###.###.#.#####.#######.#.###.###.###.#.#####.#.#####.#########
.....#...#...#...........#.....#.....#.#...#...#.#.........#...#
.#####.#.#####.#########.#######.###.#.###.#.#.#.#.#######.#.#.#
.#...#.#.#.....#.......#.#.....#...#.#.....#.#...#...#...#...#.#
.#.#.#.###.#####.#####.#.#.###.###.#.#######.#######.###.#####.#
...#.#.....#...#.#.#...#...#.#.#.#.#...#.....#.....#.#.....#...#
####.#######.#.#.#.#.#######.#.#.#.#####.#########.#.#.#####.#.#
...#.#.....#.#.#.#.....#.........#.....#...#.....#.#.#.#...#.#.#
##.#.###.#.#.#.#.#####.#########.#####.###.#.###.#.#.#.#.#.#.###
...#.#...#.#.#.#...#.#...#.....#.....#...#.#.#...#.#.#...#.#...#
.#.#.#.###.#.#.###.#.###.#.###.#######.###.#.#.###.#.#####.###.#
.#.#...#...#.#...#.#...#.#.#.#...#...#...#.#.#.#.........#...#.#
.#######.###.#.###.#.###.#.#.###.#.#.#.#.#.#.#.#########.#.###.#
.......#.#...#.#...#.....#.#...#...#.#.#.#...#.....#.....#...#.#
.###.#.#.#.#####.###.#####.#.#######.###.#########.#.#######.#.#
G..#.#.#...#...#...#.#.....#.....#...#...........#.#.........#.#
##.#.###.###.#.#.#.#.###.###.#.#.#.###.#####.#####.###########.#
.#.#.#...#...#.#.#.#.....#...#.#.#...#.#...#.#...#.#.......#...#
.#.#.#.###.###.###.#######.###.#.###.#.#.#.###.#.#.#.#####.#.#.#
.#.#.#.#.#.#.......#.#...#.#...#...#...#.#.....#.#.#...#...#.#.#
.#.#.#.#.#.#########.#.#.#.#.#########.#.#######.#.#.#.###.#.#.#
...#.#...#...#.....#...#.#.#.#.......#.#...#...#.#.#.#...#...#.#
.###.###.###.#.###.###.#.#.#.#.#####.#.###.#.###.#.#####.#####.#
.#...#...#.#.....#...#.#.#.#...#...#.#.#...#.#...#.....#.#.....#
##.###.###.#########.#.#.#.#######.#.#.#.###.#.#######.#.#####.#
...#...........#...#.#.#...#.......#...#...#.#.........#.....#.#
.#.#.###########.#.#.#.#####.#####.#######.#.###########.###.#.#
.#.#.#.#.........#...#.......#.....#.....#...#.......#...#.#.#.#
.###.#.#.#############.#############.#.#####.#.#####.#.###.#.###
.....#.#.#...........#.#.............#.......#...#.#.#.....#...#
.#####.#.#.#######.###.#.#####################.#.#.#.#####.###.#
.#.....#.#.#.....#.....#.#.........#.....#.....#.#...#...#...#.#
.###.#.#.###.###.#######.#.#######.###.#.#######.#.###.#.#####.#
.....#.#.....#...#.......#.#.....#.....#.........#.#...#.....#.#
######.#######.#.#.#######.#.#####################.###.#####.#.#
...#...#...#.#.#.#.........#.#.......#...........#.....#...#...#
.#.#.###.#.#.#.#.###########.#.###.###.###.#.###########.#.###.#
.#.#...#.#...#.#.....#...#.....#.#...#...#.#.#.........#.#...#.#
.#####.#.###.#.#######.#.#.#####.###.###.#.###.#.#######.#.###.#
.........#...#.........#...........#.....#.....#.........#.....#
################################################################
