32
.#...........#.........#.......#
.#.###.###.###.#.#####.#.#####.#
.#.#.#...#.#...#.#...#.#.....#.#
.#.#.###.###.###.#.#.#.#.###.###
.......#...#.#.#.#.#.#.#...#...#
.#########.#.#.#.###.#.#######.#
.#.#....S#.#...#...#...........#
.#.#.#####.###.###.#.#########.#
...#.#.#.......#...#.#...#.....#
##.#.#.#.#######.#####.#.#####.#
.#.#.#.#...#...#.......#.....#.#
.#.#.#.###.#.#.#############.#.#
...#.#...#.#.#.#...........#.#.#
.###.#.###.#.#.#.#.#########.#.#
.#...#.....#.#.#.#.....#.....#.#
##.#####.###.#.#######.#.#####.#
...#...#.....#.........#.#...#.#
.###.#.#############.###.#.###.#
.#...#.#...#...#...#.#...#.....#
.###.#.#.#.#.#.#.#.#.#.###.#####
.....#...#.#.#...#...#...#.#..G#
##########.#########.###.###.#.#
.........#.#.......#...#.....#.#
##.#####.#.#.#####.#####.#####.#
...#...#.#...#...#.....#.#.....#
.###.#.#########.#####.###.###.#
.#...#.#...........#...#...#...#
.#.###.#.###.#####.#.###.###.###
.#.#...#...#...#...#.#.....#...#
.#.#.#####.###.#####.#####.###.#
...#.........#.............#...#
################################
