16
...#.........#G#
.###.###.###.#.#
.#...#...#...#.#
.#.###.#####.#.#
.....#.#...#.#.#
######.#.#.#.#.#
.....#...#.#...#
.###.#####.###.#
.#.#..S#...#...#
.#.#####.###.###
.#.........#...#
.#########.###.#
.#.....#...#.#.#
.#.###.#.###.#.#
...#.....#.....#
################
