32
.#.......#.....#...........#...#
.#.###.###.#.#.#########.###.#.#
.#.#.#...#.#.#.........#.#...#.#
.#.#.###.#.#.#########.#.#.###.#
.#.#...#...#.#.....#...#...#...#
.#.###.#####.#.#####.#######.#.#
.#...#.....#.#.#...........#.#.#
.###.###.#.#.#.#.#########.#.#.#
...#.....#.#.#.......#...#...#.#
.#########.#.#########.#.#####.#
...........#...#S..#...#.....#.#
.#############.###.#.#######.#.#
.....#.....#.....#...#...#...#.#
####.#.###.#.#.#######.###.#####
.....#.#...#.#.#.........#.....#
.#####.#.###.###.#######.#####.#
.#...#.#.#.....#...#...#.......#
.#.###.#.###.#.###.#.#.#########
...#...#...#.#...#...#...#...#.#
.###.#####.###.#.#######.#.#.#.#
.#...#.........#.......#.#.#...#
##.#.#######.###########.#.#####
...#.#.....#.#.........#.#.#...#
.###.#.###.###.#######.#.#.#.#.#
...#.#.#.#.....#.....#...#...#.#
.#.###.#.#########.#.#########.#
G#.....#...........#.#.........#
.#############.#####.###.#####.#
.#...#.........#.#...#...#...#.#
.#.#.#.#########.#.###.###.###.#
...#...#...............#.......#
################################
