64
.....#...............#.............#...........................#
.#####.#####.#######.#.#.###.#######.###########.#####.#######.#
.#...#...#...#.....#.#.#.#...#...........#.....#.....#.#.....#.#
.#.#.###.#.###.###.###.#.#####.###########.###.#####.#.#.#####.#
.#.#.#...#...#.#.#.....#.....#.#.........#...#.#.....#.#.....#.#
.#.#.#.#####.#.#.###########.#.#.#######.###.#.#######.#.###.#.#
...#.#...#.#...#...#.........#.#.....#.....#.#.........#.#.#.#.#
.###.###.#.#####.#.#.#######.#.#####.#####.#.###########.#.#.#.#
...#.........#...#.#.#.....#.#.#...#...#...#...#...#...#...#.#.#
##.#########.#.#.###.#.###.#.#.#.#.###.###.###.###.#.#.#.###.#.#
.#...#...#.#.#.#.#...#.#.#.#.#.#.#...#...#.....#...#.#.#.#...#.#
.###.#.#.#.#.###.#.###.#.#.#.#.#.#######.#######.###.#.#.#.###.#
.#...#.#.#.......#...#...#.#.#...#.......#.....#.#...#...#...#.#
.#.###.#.###########.###.#.#.###.#.#######.###.#.#.#########.#.#
.#.#...#.#.....#...#.....#.#.#...#...#.....#.#.#.#.........#...#
.#.#.###.#.###.#.#.###.###.###.#####.#.#####.#.#.#########.#####
.#.#.#...#...#...#...#.#.#.....#...#.#.#.....#.#.....#.#...#G..#
.#.#.#.###.#.#######.#.#.#######.#.#.#.###.###.#.###.#.#.#####.#
.#.#.#...#.#.#...#...#.#.....#...#.#.......#...#.#...#.#.#...#.#
.#.#.###.#.#.#.#.#.###.#####.#.###.#.#######.###.###.#.#.#.#.#.#
.#.#...#.#.#.#.#...#.......#.#...#.#.#.....#.#.#...#...#...#.#.#
.#.###.#.###.#.###########.#.###.#.###.###.#.#.#.#.###.#####.#.#
.#.#...#.....#.#.....#...#...#.#.#.#...#.#.#.#.#.#...#...#...#.#
.#.#.#########.###.#.#.#.###.#.#.#.#.###.#.#.#.#.###.#####.###.#
.#.#...#.#...#.#...#...#...#...#.#.#...#.#...#.#.#.#.......#...#
.#.###.#.#.#.#.#.#########.###.#.#.###.#.#####.#.#.###########.#
...#.#.#...#.#.#...#.....#.#...#.#.#...#...#.#...#...#.........#
.###.#.#####.#.###.#.#.###.#####.#.#.###.#.#.#.###.###.###.###.#
...#.#.....#.#.....#.#.#...#.....#.#.#...#...#.#.....#.#...#.#.#
##.#.#####.#.#########.#.###.#####.#.#.#.#.###.#####.#.#.###.#.#
...#.#...#.#.#.......#.#.#...#.#...#.#.#.#.#...#...#...#...#...#
.###.#.#.#.#.#.###.#.#.#.###.#.#.###.#.#.#.#.###.#.###.###.#####
.....#.#.#.#...#.#.#...#.#...#.#.#...#.#.#.#.#...#...#...#.....#
##.###.#.#.#.###.#.#####.#.###.#.#.#.###.#.#.#.#####.#########.#
...#...#...#.....#.#.....#.#...#.#.#...#.#.#...#...#...#.....#.#
.###.###########.#.#.#####.#.#.#.#.###.#.#######.#.###.#.###.#.#
.#...#...#.#.....#...#.....#.#.#.#.#.#.#.....#...#...#...#...#.#
.#.###.#.#.#.#######.#.#####.#.#.#.#.#.#####.#.###.#######.###.#
.#...#.#.#...#.....#.#.#.....#...#...#.....#.....#.......#.....#
.###.#.#.#####.###.#.#.#.###########.#####.#####.###.#########.#
...#.#.#.#.......#.#...#...#.....#...#...#...#.#...#...#.....#.#
##.#.#.#.#.#######.#######.#.#.#.#.#####.###.#.###.###.#.###.#.#
.#.#...#.......#...#...#...#.#.#.#.....#...#.#.......#.....#...#
.#.#######.#####.###.#.#.###.#.#.#####.###.#.###############.###
...#.....#.#.....#.#.#.#.#...#.#.....#.....#.....#.........#...#
.###.###.#.#.#####.#.#.#.#####.#####.#####.#####.#.#######.###.#
...#.#...#.#.#.#.....#...#.....#.......#.#.#.#...#.....#...#...#
.###.#.###.#.#.#.#########.###########.#.#.#.#.#######.#.#######
.#...#...#.#.#.....#...#.............#.#.....#.......#.#...#...#
.#.#####.###.#####.###.#.###########.#.#######.#.###.#.###.#.#.#
.#.#S#.....#.....#...#.............#.#...#...#.#...#.#...#...#.#
##.#.#####.#.###.###.#######.#######.###.#.#.#####.#####.#####.#
...#...#.#.#.#...#.....#...#.#.......#.#...#.#...#.......#...#.#
.#####.#.#.###.#######.#.###.#.#######.#####.#.#.###.#####.#.#.#
.....#.#...#...#...#...#.....#.....#...#.....#.#...#...#.#.#...#
##.###.#.###.###.#.#.###.#########.#.###.#####.###.###.#.#.###.#
.#.....#.#.......#.#.#...........#.#.....#.....#...#.....#.#...#
.#######.#.#######.#.###########.#.#.#####.#.#####.#######.#.###
.....#...#.....#...#.......#.....#.#...#...#.....#.....#...#.#.#
.###.#.#######.#.#########.#.#####.###.#.#######.#####.#.###.#.#
.#.#.#.#.......#.#...#.....#.....#.#...#.......#.#...#...#.#.#.#
.#.#.#.#########.#.###.###########.#.###########.#.#######.#.#.#
...#.............#.................#.............#.............#
################################################################
