64
...#.....#.........#...#.....#.........#.........#.......#.....#
.#.#.#.###.#.#####.#.#.#.###.###.#####.#.#######.#.#####.###.#.#
.#.#.#.....#...#.....#...#.#.....#...#.#.....#.#.#...#.....#.#.#
.#.###.#######.###########.#######.###.#.###.#.#.###.#####.#.#.#
.#...#.....#...#.....#.........#.....#.#.#...#.#...#...#...#.#.#
.###.#####.#.###.###.#.#######.#####.#.#.#.###.###.###.#.#####.#
...#.#...#.#.....#...#...#.....#.....#.#.#...#...#.....#.......#
.#.#.#.#.#.#######.#####.#.#####.###.#.#####.#.###############.#
.#.#...#.#.#...#...#...#.#.......#.#.#.......#.............#.#.#
##.#####.#.###.#.###.#.#.#########.#.#########.#####.#####.#.#.#
...#.....#.....#.#...#.#.....#.#.....#.#...#.....#...#....G..#.#
.###.#########.#.#.###.#.###.#.#.#####.#.#.#.#####.###.#######.#
.#.#.#.....#...#.#.#...#...#.#...#.....#.#.....#...#.#...#.....#
.#.#.#.###.#.###.#.#.#######.#.#####.#.#.#######.###.###.#.#####
.#.#...#...#.#...#.#.........#.......#.#.#...#...#.#...#.#.....#
.#.#####.#####.###.#####.###############.###.#.###.#.#.#.#####.#
.#.....#.#.....#.....#...#.......#.......#...#.#.....#...#.....#
.#.#####.#.#####.###.#####.#####.#.#######.###.###########.#####
.#.#.....#.#.....#...#.......#...#.#...#.....#.............#...#
.#.#.#####.#.#####.#.#.#######.#.#.#.#.#.###.#################.#
.#.#.#.....#...#.#.#.#.#.#.....#.#.#.#...#...#.........#.....#.#
.#.#.###.#####.#.#.###.#.#.#####.#.#.#####.#.#.#######.#.#.#.#.#
.#...#...#.#.....#.#...#.#.....#.#.#.#.#...#...#.#.....#.#.#...#
.###.#.###.#.#####.#.###.#####.###.#.#.#.#######.#.#####.#.###.#
...#.#...#...#...#.....#.....#...#.#...#.......#...#.....#.#...#
.#.#.###.#####.#.#####.###.#####.#.###.#######.#.#########.#####
.#.#...#.......#.....#...#...#...#.#...#.....#.#.#.......#.#...#
##.###.#######.#####.###.#.#.#.###.#.#####.###.#.###.###.#.#.#.#
S#...#.......#...#...#...#.#.#.....#.#.....#...#.....#.....#.#.#
.#.#.#######.#####.###.#####.#######.#.###.#.#####.#########.#.#
.#.#.......#.....#.#...#.....#.........#...#.#...#.#.........#.#
.#.#######.#####.#.#.###.###.###############.#.#.###.#########.#
.#.......#.#.#...#.#.....#...#.....#...#...#...#.#.......#...#.#
.#########.#.#.###.#######.###.###.#.#.#.#.#.###.#.#######.#.#.#
...........#.#.#...#.....#.#.#...#.#.#.#.#.#...#.#.#.......#...#
############.#.#.###.#.###.#.#.#.#.#.#.#.#.###.#.#.#.#########.#
.......#.....#...#.#.#.....#...#.#...#...#.#...#...#.........#.#
.###.###.###.#####.#.###########.#########.#.###############.#.#
...#.....#.......#...#...........#.........#.#.........#.....#.#
##.#######.#######.#######.#######.#########.#.#####.###.#######
.#...#.#...#.....#.....#...#.....#.....#...#.#.#.#...#...#.....#
.###.#.#.#.#.###.#####.#.###.#.#.#####.#.#.#.#.#.#.###.###.###.#
...#...#.#.#.#.#.......#.#...#.#.#.....#.#.#...#.#...#.#...#...#
##.###.#.###.#.#########.#####.#.#.#####.#######.#.###.#.###.###
...#...#...#.#.............#...#.#.....#.........#.#...#...#...#
.###.#####.#.#############.#.###.#####.###.#####.#.#.#####.###.#
...#.....#...#.............#.#...#...#...#.#...#.#.#.......#...#
##.#####.#####.#############.#.###.#####.#.#.#.#.#.#########.#.#
...#.....#.#...#.......#.....#...#...#...#...#.#.#...#.....#.#.#
.#.#.#####.#.#.#.#####.#.#######.###.#.#######.#.###.###.#.#.#.#
.#.#.#.......#.#.#...#.#...#.......#.#.#...#...#.#...#...#.#.#.#
.#.#.#########.#.#.#.#.###.#######.#.#.#.#.#####.#.###.###.#.#.#
.#.#.........#.....#.#...#.#.....#...#...#.....#...#...#...#.#.#
.#.#########.#######.###.#.#.###.###.#########.#.#####.#.###.#.#
.#.......#.#.#...#.#.#...#.....#.#.....#.......#.#.....#.#.#.#.#
.#.#####.#.#.#.#.#.#.#.#########.#######.#######.###.###.#.#.###
.#.#...#...#.#.#.#...#.........#...#...#...#.........#...#.#...#
.###.#.#####.#.#.#######.#####.#.#.#.#.###.#############.#.###.#
.....#.....#...#.......#...#...#.#...#...#.............#.....#.#
.#########.###########.#####.###.#####.###############.#####.#.#
.#.......#...#.....#...#.....#.#...#.#.....#.....#...#.....#.#.#
.#####.#.###.#.#.###.###.#####.###.#.#####.#.#.###.#.#####.###.#
.......#...#...#.........#...............#...#.....#...........#
################################################################
