32
..G........#.....#.......#.....#
.#.#######.###.#.###.###.###.###
.#.#.....#.....#.....#.....#...#
.###.###.#################.###.#
.#...#.#.......#.....#...#.....#
.#.###.#######.#.###.#.#.#####.#
...#.....#...#...#.#...#.#...#.#
.###.###.#.#######.#####.#.###.#
.#...#.#.#.......#.#...#.#.....#
.###.#.#.#####.#.#.#.#.#.###.###
...#.#.........#.#...#.#...#...#
##.#.#.#########.#.###.###.###.#
.#...#.#...#.....#...#...#...#.#
.#.#####.#.#.#########.#.###.#.#
.#.#.....#.#...........#...#.#.#
.#.#.#####.###############.#.###
.#.#.#...#...#....S#...#...#...#
.#.#.###.###.#.#######.#.#####.#
...#...#...#...#.......#...#...#
.#####.###.#######.#######.#.#.#
.#...#...........#.#.....#.#.#.#
.#.#.###########.#.#.###.#.#.#.#
.#.#.#...#.......#.#...#.#.#.#.#
.#.#.#.###.#######.###.#.#.#.#.#
.#.#.#...#.#.....#...#.#.#.#.#.#
.#.#.###.#.###.#.###.#.#.#.#.#.#
...#.....#.....#...#.#.#.#.#.#.#
########.#########.#.#.#.#.#.#.#
.#.....#...#.....#.#...#...#.#.#
.#.###.###.#.###.#.#########.#.#
.....#.......#...#...........#.#
################################
