64
...#.......#.....#.....#...#.......#.....#.....................#
.###.#####.#.#.###.#.#.#.#.#.#####.#.#.#.###.#########.#######.#
...#.....#...#...#.#.#...#...#.....#.#.#...#.#.......#.....#...#
.#.#####.#######.#.#.#########.#######.###.#.#.###.#####.#.#.###
.#...#...#...#.#...#.#.......#.#.......#.#.#.#.#...#...#.#.#...#
.###.#.###.#.#.#####.###.###.#.#####.###.#.#.###.###.#.###.###.#
.#.#...#...#...#...#...#...#.#.......#...#.#...#...#.#...#.#...#
.#.#####.#####.#.#####.#.###.#########.###.###.#.#.#.###.#.#.###
.#.......#.......#.....#.#...#.....#...#...#...#.#.#.#.#...#.#.#
.#.#######.#######.#####.#.#.###.#.###.#.###.#####.#.#.#####.#.#
.#.#.#...#.#.......#.#...#.#.....#.#...#...#.......#.#.....#...#
.#.#.#.#.#.#.#######.#.###.#######.#.#.###.#####.###.#.###.#.###
...#.#.#...#.#.....#...#.#.....#.#...#.#.#.#...#.#...#.#...#.#S#
####.#.#####.#.#.#.#.###.#####.#.#####.#.#.#.#.#.#.###.#####.#.#
...#...#...#.#.#.#.#.#.......#.#.....#...#.#.#...#...#.......#.#
.###.###.#.#.#.#.###.#.#####.#.###.#.###.#.#####.###.#.#######.#
.......#.#...#.#.....#.....#.#...#.#.....#.....#.#...#...#.#...#
.#######.#######.###########.###.#############.#.#.#####.#.#.###
.#...#...#.....#...#.......#...#.....#.......#.#.#...#.#...#.#.#
.#.#.#.###.###.###.###.###.#.#.#####.#.#.#.###.#.###.#.###.#.#.#
...#.#.....#.#.#.......#...#.#.....#.#.#.#.#...#...#.#...#.#...#
####.#######.#.#########.#######.#.#.#.#.###.#####.#.###.#.###.#
.....#.....#.#...#.....#.........#.#.#.#.....#.....#...#.....#.#
.#####.###.#.###.#.#.###.#########.#.#.#########.#####.#.#####.#
.#.......#.#...#.#.#.#...#.....#...#.#.#.......#.#...#.#.#.....#
.###.###.#.###.#.###.#.###.###.#.###.#.#####.#.#.#.#.#.###.#####
...#...#.#.....#...#.#...#...#.#.#...#.......#.#.#.#.#.#...#...#
##.#####.###.#####.#.#.###.###.#.#.#.#########.###.#.#.#.###.###
...#.....#.#.#.....#...#...#...#.#.#.#.......#.....#...#.#.....#
.###.#####.#.#.#####.###.###.#####.###.###.#.#####.#####.#####.#
.....#.#.....#.....#.#...#.#.....#.......#.#.#.....#.....#.....#
######.#.#########.###.###.#####.#######.#.###.#####.#####.###.#
.......#.....#...#...#...#...#...#...#.#.#.#...#.#...#.......#.#
##.#.#######.#.#.###.###.#.#.#.###.#.#.#.#.#.###.#.###.#####.###
...#.#.....#...#.#.#.....#.#.#.#...#.#.#.#.#.#...#...#.....#...#
.#####.#.#######.#.#######.#.#.###.#.#.#.#.#.#.#####.#####.###.#
.....#.#.........#.........#.#.#...#.#...#.#.#.....#.#...#...#.#
####.#.###################.###.#.###.#####.#.###.#.#.#.#####.#.#
.....#.....#...............#...#.#.........#...#.#.#.#.#.....#.#
.#########.#####.#########.#.###.#############.#.#.#.#.#.#####.#
.#.......#.....#.#...#...#.#.#.................#.#.#.#...#...#.#
.#.#####.#####.#.###.#.#.#.#.#############.#####.#.#.#####.#.#.#
.#.#...#...#...#...#...#.#.#.......#.....#.......#.#.......#...#
.#.#.#####.#.#####.#.###.#.#######.#.###.#####################.#
.#.#.#...#.#.....#.#...#...#.....#.....#.#...#.........#.......#
.#.#.#.#.#.#####.#.###.#########.#######.#.#.#.#####.###.#######
.#.#...#.#.......#.#.#.....#...#.....#...#.#.#.....#...#.....#.#
.#.#####.#########.#.#####.#.#.###.#.#.#.#.#.#####.###.#####.#.#
.#.....#.......#...#.....#.#.#...#.#.#.#.#.#.......#.#.....#...#
.#####.###.#.#.#.#.###.#.#.#.###.###.#.###.#########.###.#####.#
...#.#...#.#.#.#.#...#.#.#...#.#.#...#.....#...#.......#.#.....#
.#.#.###.#.#.#.#####.#.#######.#.#.#.#######.###.###.###.#.#####
.#.....#.#.#.#.......#.......#...#.#.#...#.......#...#...#.....#
.#####.#.###.#########.#.###.#.###.#.###.#.#######.#.#.#.#####.#
.#.....#.#...#.........#.#...#.....#...#.........#.#.#.#.#.....#
.#######.#.#####.#######.#############.#####.#####.###.###.#####
.........#.....#.......#......G..#...#.....#.#...#...#.#...#...#
.#########.###.#######.#########.#.#.#####.#.#.#.###.#.#.###.###
.....#.......#.....#.#.#.....#...#.#.......#.#.#...#.#.#...#...#
####.###########.#.#.#.###.###.#.#.###########.###.#.#.###.###.#
...#.......#...#.#.#.#...#.#...#.#.#.....#...#.#.#...#...#...#.#
.#.#######.#.#.###.#.###.#.#.#####.#.###.#.#.#.#.###.###.###.#.#
.#...........#.....#.......#.........#.....#...#.......#.......#
################################################################
