32
...........#.#G..........#.....#
.#########.#.#.###.#######.###.#
.#...#...#.#.#.#.#.......#.#.#.#
.#.#.#.###.#.#.#.#######.#.#.#.#
...#.#...#.#.#.#.......#.....#.#
.###.###.#.#.#.#.#############.#
...#...#...#.#.#.#...#...#.....#
##.###.#.###.#.#.#.#.#.#.#.###.#
.#.#.#.#.....#.#...#...#.#.#...#
.#.#.#.#######.#.#######.#.###.#
.....#...#.....#.#.....#.#...#.#
.#######.#.#####.#.###.#.###.#.#
.#.#.....#.#...#.#.#.#.#...#.#.#
.#.#.###.#.#.#.#.#.#.#.#.#.#.###
.#.#...#.#.#.#.#.#.#.....#.#...#
.#.###.#.#.#.#.###.###########.#
.....#.#.#...#.....#.....#.....#
##.###.#######.#####.###.#.#####
...#...#...#...#.....#...#.....#
.###.###.#.#.###.#######.#.###.#
.#.#...#.#.#...#.......#.#.#...#
.#.###.#.#.###.#######.#.###.#.#
.....#...#...#.#.#.....#.....#.#
####.#######.#.#.#.###########.#
...#...#.....#.#.#.....#.#.....#
.#.###.#.###.#.#.#####.#.#.#####
.#.....#...#.#.#.#.....#.#.#...#
.#########.#.#.#.#.#####.#.###.#
.#.......#.#.#...#.#S..#.#.....#
.#######.#.#####.#.###.#.#####.#
.........#.......#.....#.......#
################################
