16
.#G..#.........#
.#.#.#.#####.#.#
...#...#...#.#.#
.#######.#.#.###
...#.#...#.#...#
##.#.#.###.###.#
...#.#.#.....#.#
.###.#.#####.#.#
.#...#.....#.#.#
.#.#.#####.#.#.#
.#.#...#S..#.#.#
.#.###.#####.#.#
.#.#...#...#...#
.#.#.###.#.#####
...#.....#.....#
################
