32
.#.........#...#...#........G..#
.#.#####.###.#.#.#.#.#########.#
...#...#.....#.#.#.#.#...#.....#
.#####.#######.#.#.#.#.#.#.###.#
.....#.......#...#.#...#.#.#...#
####.#######.#####.#####.#.###.#
...#.#.........#.#.......#...#.#
.#.#.#.#######.#.###########.###
.#.#.#...#.....#.....#.....#...#
.###.#.#.#.#####.#####.###.###.#
.....#.#.#.......#...#.#.......#
.#######.#.#######.#.#.#.#####.#
.#.....#.#.#.....#.#.#.#.#...#.#
.#.###.#.###.###.#.#.#.###.#.#.#
...#.#.#...#.#.#.#.#.#.#...#.#.#
####.#.###.#.#.#.#.#.#.#.###.#.#
...#.......#.#.#...#...#.#.#.#.#
.#.#.#######.#.#.#######.#.#.#.#
.#...#.......#...#...#...#.#.#.#
.#####.###########.#.#.###.#.###
.#...#.#.......#...#...#...#...#
.###.#.#.#####.#.#########.###.#
.....#.#...#.#.#.#.....#...#...#
######.###.#.#.#.#.#.#.#.#.#.#.#
.........#...#.#.#.#.#...#.#.#.#
.#####.#####.#.#.###.#######.#.#
.#.....#.....#.......#.....#.#.#
.#.#####.###########.#.###.#.#.#
.#.#.....#.....#...#.#.#.#...#.#
.###.#####.###.#.#.###.#.#####.#
.........#S#.....#.....#.......#
################################
