32
.....#.#.........#.............#
.###.#.#.#####.#.#####.#.#######
.#...#.#.....#.#.....#.#.#.....#
.#.###.#.#####.#####.#.#.#.###.#
.#.#.....#.....#...#.#.#.#.#...#
.#.#.#####.#####.#.#.#.#.#.#.###
.#.#.#.....#.....#...#.#.#.#...#
.#.###.#############.###.#.###.#
.#...#...#.....#...#.....#...#G#
.###.#.#.#.###.#.#.#########.#.#
.#...#.#.....#.#.#...........#.#
.#.###.#######.#.#########.###.#
.#.#...#.....#.......#...#.#...#
.#.#####.###.#######.#.#.###.#.#
.#.......#.#.....#...#.#...#.#.#
.#########.#####.###.#.###.#.#.#
...#.......#...#...#.#...#...#.#
##.#.#######.#.###.#.###.#####.#
.....#.......#.#...#...#.#.....#
.#####.#######.#.#####.#.#####.#
.#.....#S..#.#...#.....#.....#.#
.#.#######.#.#####.#########.#.#
.#.........#.........#.......#.#
.#####################.#######.#
.............#.......#.#.......#
############.#.#####.#.#########
.#.....#...#.#.#.#...#.#.......#
.#.###.#.#.#.#.#.#.###.#.#####.#
...#...#.#...#.#...#.......#...#
.###.###.#####.#.###########.#.#
...#...........#.............#.#
################################
