32
.#.....#...#.....#.......#.....#
.#.#.#.#.#.#.###.#.#####.#.###.#
.#.#.#.#.#.....#.#.....#.#...#.#
.#.#.###.#######.#####.#.###.#.#
...#.....#.......#.....#.#...#.#
.#########.#.#####.#####.#.#####
...#.....#.#.#.....#...#.#.#...#
##.#.#.###.#.#.#####.#.#.#.#.#.#
.#...#.#...#.#.....#.#.#.#...#.#
.#####.#.###.#####.#.#.#.#####.#
...#...#.#...#...#.#S#.#.#.....#
.###.###.###.#.#.#.###.#.#.#####
...#...#...#.#.#.#.....#.#.....#
.#.###.###.#.#.#.#######.###.#.#
.#...#...#.#...#...#...#...#.#.#
.###.###.#.#######.#.#.###.###.#
.#.#.....#.....#...#.#...#...#.#
.#.###########.#.#####.#####.#.#
...#...#...#...#.......#.....#.#
##.#.#.#.#.#.###########.#####.#
...#.#...#.#...#.....#...#.....#
.#####.###.###.#.###.#.###.###.#
.....#...#.#...#...#...#.....#.#
####.#####.#.#.###.#########.#.#
...#...#...#.#...#.......#...#.#
.#####.#.###.#.#########.#.###.#
.#.....#.#...#.#...#.....#...#.#
.#.#####.#.#####.#.#.#########.#
.#G..#...#.....#.#...#.......#.#
.###.###.#####.#.#####.#####.#.#
.............#.........#.......#
################################
