32
.....#.....#...#.......#...#...#
.#####.###.#.#.#.#####.#.#.#.#.#
.#.......#.#.#.#...#.#...#.#.#.#
.#.#######.#.#.###.#.#####.#.#.#
.#.#...#...#.#...........#...#.#
.#.###.#.#####.#########.#####.#
.#...#.#.....#.#.....#.#.#...#.#
.###.#.#####.###.###.#.#.#.###.#
.#.........#.#.....#.#.#.#.#...#
.#.#######.#.#.#####.#.#.#.#.###
...#...#.#.#...#.....#.#.#.#...#
.###.#.#.#.#####.#####.#.#.###.#
.#...#S#...#.....#.....#...#...#
.#.#######.#.#########.#.###.#.#
.#...#...#.#.#.......#...#...#.#
.###.#.#.###.###.###.#####.###.#
.#.#...#.....#...#.#.....#.#.#.#
.#.###########.###.#####.#.#.#.#
.....#.........#.....#...#.#.#.#
####.#.###########.#.#.###.#.#.#
...#.#...#.......#.#.......#...#
##.#.###.#.#####.#######.#######
...#...#...#...#.#.....#.#.....#
.#####.#####.#.#.#.###.###.###.#
.....#...#...#...#...#.....#...#
.#.#####.#.#.#######.#######.#.#
.#.....#.#.#.#.........#...#.#.#
.###.###.#.###.#########.#.#.###
...#.....#.....#.........#.#..G#
##.#############.#########.###.#
.................#.............#
################################
