8
S..#...#
##.###.#
.#...#.#
.###.#.#
.....#.#
.#####.#
......G#
########
