16
...#...........#
.#.#.#.#########
.#.#.#.#.......#
.###.#.#.#####.#
.#...#.......#.#
.#.#####.#####.#
.#...#S#.#...#.#
.###.#.###.#.#.#
...#.#.#...#...#
.#.#.#.#.#####.#
.#...#.#...#.#.#
.#####.###.#.#.#
.#...#...#.#.#.#
.###.###.#.#.#.#
.......#...#..G#
################
