16
.#.......#.....#
.#.###.#.#.###.#
.#.#...#.#.#...#
.#.#.#####.#.###
.#.#.....#.#.#.#
.#.#####.#.#.#.#
...#...#...#.#.#
.###.#.#####.#.#
.#...#.#...#.#.#
.###.#.#.#.#.#.#
...#.#...#.#S#.#
##.#######.###.#
...#...#...#...#
.###.#.#.#.#.#.#
G....#...#...#.#
################
