16
.#.........#...#
.#.#######.#.#.#
...#...#...#.#S#
.###.#.#.#.#.###
.#.#.#...#.#.#.#
.#.#.#####.#.#.#
.#.#.#...#.#...#
.#.#.#.#.#####.#
.#.#...#.....#.#
.#.#######.###.#
.#.....#...#...#
.#.###.#.#.#.###
.#.#...#.#.#...#
.#.#.###.#####.#
G..#...#.......#
################
