16
.#.....#.......#
.#.###.#.###.#.#
.#.#.#S#.#...#.#
.#.#.#####.###.#
.#.....#...#.#.#
.#####.#.###.#.#
.....#...#.....#
.#########.#####
.........#...#.#
.#######.###.#.#
.....#.#.....#G#
####.#.#######.#
...#.#.........#
.###.#########.#
...............#
################
