32
.....#.....#G..............#...#
.###.#.###.#.#########.###.#.#.#
.#.....#.#.#.#.......#...#...#.#
.#######.#.#.###.###.###.#####.#
.....#...#.#.....#.....#...#.#.#
.###.#.#.#.###############.#.#.#
.#...#.#.........#.......#.#.#.#
.#.#############.#.#####.#.#.#.#
.#.........#.......#...#...#...#
.#########.#.#######.#.#.#####.#
.#.........#...#.#...#.#.#...#.#
##.###.#######.#.#.###.###.#.###
...#...#...#.#...#.#.#.....#...#
.###.###.#.#.###.#.#.#########.#
.#.....#.#.#.....#...#...#.....#
.#######.#.#.#######.#.#.#.#####
.........#.#...#.......#.#.....#
.#########.#####.#############.#
.#.......#.....#.....#...#.....#
.#.#####.#####.#.#####.#.#.###.#
.#.....#.#...#.#.#...#.#.#.#...#
.#.###.#.#.#.#.#.#.#.#.#.#.#.###
.#.#...#.#.#.#...#.#.#.#.#.#...#
.#.#.###.#.#.#####.#.#.#.#.###.#
.#.#.#.....#...#...#...#.#...#.#
.#.#.#########.#.#######.#.#.###
.#.#.......#...#.#S......#.#...#
.#.#######.###.#.#############.#
.#.......#...#.#.#.....#...#...#
.###########.#.#.###.#.#.#.#.#.#
.............#.#.....#...#...#.#
################################
