32
.#S..#.................#.#.....#
.###.#.#.#############.#.#.###.#
.#...#.#.#.........#...#...#...#
.#.#####.#.#####.###.###.###.#.#
.#.......#.#.....#...#...#...#.#
.#########.#.###.#.###.###.###.#
.#.....#...#.#...#...#...#.#...#
.#.#.#.#####.#######.#####.#.###
.#.#.#.......#.....#.......#...#
.#.#.#####.###.###.###########.#
...#...#.#.#...#.#.........#...#
######.#.#.#.###.#####.#####.###
.......#...#.....#...#.#.....#.#
.###############.#.#.#.#.#####.#
...#...........#...#.#...#.....#
.#.#.#########.#####.#######.#.#
.#.#...#.#.......#...#.......#.#
.#.###.#.#.#####.#.#####.#####.#
.#...#...#.#.....#.......#...#.#
.#.#####.#.#.###############.#.#
.#...#...#.#.#...#...........#.#
.###.#.###.#.#.#.#.#####.#####.#
...#...#...#.#.#...#...#.#.....#
##.#####.#####.#####.#.#.#.#####
...#...#.......#.....#...#.#..G#
.###.#.#########.#######.#.###.#
...#.#.....#.....#.....#.#...#.#
##.#.###.#.#.#####.###.#####.#.#
.#.#.#...#.#.#...#.#...#.....#.#
.#.###.###.#.#.#.#.#.###.#####.#
.......#...#...#...#...........#
################################
