8
S..#...#
##.###.#
.#.#...#
.#.#.#.#
.#..G#.#
.#####.#
.......#
########
