64
.....#.....#.......#...#.............#........G#...#...........#
.###.#.###.#.#.###.#.#.###.###.#####.#.#####.#.#.#.#.#####.#####
.#.#.....#...#...#...#...#.#.#.#...#.#.#.....#...#.#.....#.....#
.#.#############.#######.#.#.#.###.#.###.#########.#.#########.#
.#.....#...#...#.....#...#...#...#...#...#.....#.#.#.#.........#
.#.#####.#.#.#.#####.#.#########.#.###.###.###.#.#.###.#######.#
...#...#.#...#.......#.........#.#...#.....#.#.#.......#.....#.#
.###.#.#.###.#################.#.###.#.#####.#.#########.#####.#
.#...#.#...#.#.........#.....#...#.#.#.#.....#.........#.....#.#
##.###.###.###.#######.#####.#####.#.#.###.#.#########.#.###.#.#
...#...#...#...#.....#.#...#.....#...#.....#.....#.....#.#.#...#
.###.###.#.#.###.#####.#.#.###.#.#.#########.#####.#####.#.#####
...#.....#.#.#...#.....#.#...#.#.#.#.....#...#.....#.....#.....#
.#.#########.#.#.#.#.###.###.#.#.#.#.###.#####.#######.###.#####
.#...#.......#.#.#.#.#...#...#.#.#...#.#.....#.#.....#.....#...#
.###.#.#########.#.###.###.#####.#####.#####.#.#.###.#######.#.#
.#...#...#.....#.#.....#.#.#...#...........#...#.#.#.........#.#
.#.#.###.###.#.#.#######.#.#.#.#######.#####.###.#.###########.#
.#.#...#.....#.#.........#...#...#.....#.....#...#.#.........#.#
##.###.#######.#.###############.#.#####.#####.###.#.#####.#.#.#
...#...#.....#.#...#...#.....#...#.........#...#.#...#...#.#.#.#
.#.#####.#.###.#.#.#.#.#.###.#.#######.#####.###.#.###.###.#.#.#
.#.#...#.#...#.#.#...#...#.#.#...#...#...#...#.........#...#.#.#
.###.#.#.###.#.#######.###.#.###.#.#.#####.#########.###.###.#.#
...#.#.....#.#.#.....#.....#...#...#.............#...#...#.#.#.#
##.#.#######.#.#.###.#####.###.#################.#####.###.#.#.#
...#.#...#...#.#.#.......#...#.....#...#.......#.#...#.#.....#.#
.###.#.#.#.#.#.#.#######.#####.###.###.#.#####.#.#.#.#.#.#####.#
...#.#.#.#.#.#...#...#.........#.......#...#.#.#...#.#.#...#...#
.#.#.#.#.#.###.###.#.#########.###########.#.#.#####.#.#####.#.#
.#.#...#.#...#.#...#.........#.#.........#.#.....#.....#.....#.#
##.#####.###.#.#.###.#######.###.#######.#.#####.#######.#######
...#.#...#.#.#.#...#.#.....#.....#.......#.....#.........#.....#
.#.#.#.###.#.#.###.#.#.###.#######.#######.###.#######.###.###.#
.#...#.#...#...#.#.#.#...#.#.....#...#.#...#.#.......#.#...#...#
.#####.#.#######.#.#####.#.###.#.###.#.#.###.#######.###.###.###
.#.....#.....#...#.....#.#...#.#.....#...#.........#...#...#...#
.#.#######.#.#.#######.#.###.#.#########.#.#####.#####.#.#####.#
...#.....#.#.#.......#.....#.#.#.......#.#.#...#.#...#...#.....#
.###.#.#.#.#.#####.#.#######.#.#.#####.#.###.#.#.#.#.###.#.###.#
.#...#.#...#.......#...#.....#.#...#.#.#.....#...#.#...#.#...#.#
.#.###.#.#########.#####.#####.#.#.#.#.#########.#.###.#.###.#.#
.#...#.#.#...#.....#.....#.....#.#.#.....#.....#.#.#.#.#...#.#.#
.#.###.#.#.#.#.#####.#######.#####.#####.#.###.#.#.#.#.###.#.#.#
.#.#...#.#.#.#.#...#...#...#.....#.....#.#...#.#.#.#.#.#...#.#.#
.###.#####.#.#.#.#.###.#.#.#####.#####.#.#.#.#.#.#.#.#.#####.#.#
.....#...#.#.#.#.#.....#.#.....#.......#.#.#.#.#.#.#.......#.#.#
######.#.#.#.###.#####.#.#####.###.#####.#.#.###.#.#######.#.###
.....#.#...#.....#...#.#.#...#...#.#...#.#.#.....#.......#.#...#
.###.#.###########.###.#.#.#.###.###.#.#.#######.#######.#.###.#
...#.#.......#.....#...#.#.#...#.#...#.#.......#.......#.#.....#
.#.#.#####.#.#.#.###.###.#.###.#.#.###.#######.#.#####.#.#####.#
.#.#.....#.#.#.#.......#...#...#.....#.......#.#.#...#.#...#...#
##.#####.###.#############.#########.#######.#.###.#.#.###.#.###
...#...#...#...............#.....#...#.....#.#.#...#.#...#.#.#.#
.###.#####.###.#############.###.#.###.#.###.#.#.###.###.#.#.#.#
.#.......#...#.........#.....#...#.....#.#...#.#...#...#.#.#...#
.#######.###.#######.###.#####.#######.###.###.#.#.###.###.#####
.......#.....#.#...#.#...#...#.......#.#...#...#.#...#...#.....#
######.#.###.#.#.#.#.#.###.#.#######.#.#.###.###.###.###.#.###.#
.......#.#S#.#...#...#.#...#.......#.#.#.#...#...#...#...#...#.#
.#########.#.#########.#.#########.#.###.#.#######.###.#######.#
...........#...........#.........#.......#.........#...........#
################################################################
