32
...#.......#.........#.........#
.###.###.#.#.###.#.###.###.###.#
.....#...#.#...#.#.#...#.#.#...#
.#####.#######.#.###.###.#.#.###
.....#.#.......#.#...#...#.#...#
######.#.#######.#.###.#.#.#####
...#...#.#...#...#.#...#.#.#...#
.#.#.#.#.###.#.#.#.#.###.#.#.#.#
.#...#.#.....#.#.#.#...#.#...#.#
.#.#######.###.#.#.#####.#####.#
.#.#.......#...#.#...#...#.....#
.###.#######.#######.#.#.#.###.#
.#.........#...#...#...#.#.#...#
.#.###########.#.#.#####.#.#.###
.....#.......#...#.......#.#...#
.#####.#####.#####.#######.###.#
.#.....#S..#.#...#...#.....#.#.#
.#.###.###.#.#.#.#####.#####.#.#
.#.#...#...#.#.#...#...#.......#
##.#.###.###.#.###.#.###.#######
...#...#.#.#...#.#.#.#.#.....#.#
.#######.#.#####.#.#.#.#####.#.#
...#.....#.........#.#...#...#.#
##.#.#######.#######.#.###.###.#
...#...#...#.#.....#.#.....#...#
.#####.#.#.#.#.###.#.###.###.#.#
.....#...#.#...#...#...#.#...#.#
##.#.#####.#####.#####.#.#.###.#
...#.#.....#.#...#.....#.#.#.#G#
.#####.#####.#.###.#####.#.#.#.#
.......#...........#.......#...#
################################
