64
...#.....#.........#...........#.....#.....#...#...............#
.#.###.#.###.###.#.#.#######.#.###.###.###.###.#.#############.#
.#.....#...#...#.#.#...#.....#...#...#...#...#...#.....#...#...#
.#########.###.#.#####.#.#######.#.#.###.###.#####.###.#.#.#.#.#
.....#.....#...#.......#.#.....#.#.#...#...#.....#...#...#.#.#.#
####.#.#####.###########.#.###.#.#####.###.#####.###.#####.#.#.#
.....#.....#.#.....#.....#.#...#.#.......#.....#.#...#...#...#.#
.#########.#.###.#.#.#####.#.###.#.#.#########.#.#.#####.#####.#
.#.......#.#.....#.#.#...#.#.......#.#.....#...#.#.#.........#.#
.#####.#.#.###.#####.#.#.#########.###.###.#.###.#.#.#########.#
.....#.#.#...#.#...#...#.........#.#.....#.....#.#.#...........#
####.#.#.###.#.#.#.#######.#####.###.###########.#.#.###########
.....#.#.....#.#.#.......#.....#.#...#...........#.#...#.......#
.#####.#######.#.#######.#######.#.###.###########.###.###.###.#
.....#...#.....#.#...#...........#.#.#.#.#.........#.#...#.#...#
.###.###.###.###.#.#.#########.###.#.#.#.#.#######.#.###.#.#.###
.#...#.....#.#...#.#...#.#.....#.....#.#.#.#.....#.#...#...#.#.#
.#.#######.###.###.###.#.#.#####.#####.#.#.#.###.#.###.#####.#.#
.#.#...#.......#.....#.#...#.....#.#S#.#...#.#.#...#...#...#.#.#
##.#.#.#########.#####.#.###.#####.#.#.#####.#.#####.#.#.#.#.#.#
...#.#...#...#...#.#...#...#.#.....#.#.#.....#.......#.#.#.#...#
.###.###.#.#.#.###.#.#######.###.###.#.#.#####.###.###.###.###.#
.#...#.#.#.#...#...#.#.......#...#...#.#.#.#...#.#.#.......#...#
.#.###.#.#.#####.#.#.#.#######.#.#.###.#.#.#.###.#.#######.#.###
.#.....#.#.#.....#.#...#.#.....#.#...#.#.#.#...#.#...#...#.#.#.#
.###.###.#.#####.#.#####.#.#.###.###.#.#.#.###.#.###.#.###.#.#.#
...#.#...#.......#.#...#...#.#.#...#...#.#.....#...#.#.....#...#
.###.#.#.#########.#.#.#.###.#.###.#####.#####.#.###.#####.###.#
.#...#.#.#.....#...#.#.#.#...#.....#.....#...#...#...#...#...#.#
.#.###.#.#.###.#.#####.#.#.###.#####.#.###.#.###.#.###.#.#####.#
...#...#.#.#...#.....#.#.#.#.#...#...#.#...#.#...#.#...#.#.....#
.###.###.#.#########.#.#.#.#.###.#.###.#.###.###.#.#.###.#.#####
.#...#...#.#.........#...#.#.....#.#.#.....#...#.#...#.#.#.....#
##.###.###.#.#############.#.#####.#.#######.#.#.#####.#.#####.#
...#.#.#...#.......#...#...#.#...#.....#...#.#.#.......#...#...#
.###.#.#.#.#######.#.#.#.###.#.#.#.#####.#.###.#######.#.###.###
.#.......#.#.....#.#.#...#...#.#...#.....#.....#...#...#.#...#.#
.###########.###.#.#.#####.#########.###########.###.###.#.###.#
.#...#.....#.#.#.#...#...#...#.....#...#.......#.....#.#.#...#.#
.#.#.#.###.#.#.#.#####.#.###.#.###.###.#.#####.#.#####.#.###.#.#
...#...#...#...#.......#...#...#.#.....#.....#.#...#...#.....#.#
######.#.###.#######.###########.#######.###.#.###.#.#########.#
.....#.#.....#.......#.........#.........#...#...#.#...#.......#
.###.#########.#####.#.#######.#.#########.#####.#.#.#.#.#####.#
.#.#.#...#...#.....#.#.#.....#.....#.......#.....#.#.#...#.....#
.#.#.#.#.#.#.#####.###.#.#.#####.###.#######.#####.#.#####.###.#
.#...#.#...#.....#.#.....#.#...#.#...#.....#.....#.#.#.....#.#.#
.#.###.#########.#.#.#######.#.###.###.#########.#.###.#####.#.#
.#.....#.....#.....#.#.......#.....#.......#.....#...#.#...#...#
.#####.#.###.#.#####.#.###############.###.#.#######.#.###.#.###
...#...#...#.#.#.....#.#.......#.....#...#.....#...#.#...#...#.#
##.#.#####.#.###.#####.#.#####.#.###.###########.#.#.#.#.###.#.#
...#.....#.#...#.#.#...#.#...#.#.#...#.......#...#.#.#.#...#...#
.###.#####.###.#.#.#.###.###.#.#.#.###.#####.#.###.#.#####.#####
.#...#.......#.....#...#.....#...#...#.....#...#...#.....#.....#
.#####.###############.#####.#######.#####.#####.#######.#####.#
....G..#.......#...........#.....#.#.....#.....#.......#.....#.#
.#######.#####.#.###############.#.#####.#####.#######.#####.#.#
.#.....#.#.....#.#.......#.....#.......#...#...#.#.....#...#.#.#
.#####.#.#.#####.#.#####.#.###.#######.#.#.#.###.#.#####.#.#.#.#
.......#.#.......#...#.#.#.#.#.#...#...#.#.#.....#.....#.#...#.#
######.#.###########.#.#.#.#.#.#.#.#.###.#######.#####.#.#####.#
.......#...............#.....#...#.....#.............#.........#
################################################################
