8
....G..#
.###.#.#
.#...#.#
.#.###.#
.#.#...#
##.#.###
S..#...#
########
