32
.......#.......................#
.#####.#.###.#####.#########.#.#
.#...#.#.#S#.#...#.#.....#...#.#
.#.#.#.#.#.#.#.#.#.#.###.#.###.#
...#.#...#.#.#.#.#.#...#.#...#.#
.#########.#.#.#.#####.#.###.###
.#...#.....#.#.#.......#...#...#
##.#.#.#####.#.###########.#.#.#
...#.#.#.#...#...#.#.....#.#.#.#
.###.#.#.#.#####.#.#.#.#.#.###.#
.#.#.#.#...#.....#...#.#.#.#...#
.#.#.#.#####.#####.###.#.#.#.#.#
.#.#.#...#...#...#.#.#.#.#...#.#
.#.#.###.#.###.#.#.#.#.#.#####.#
...#...#.#.#...#.....#.#.....#.#
##.###.#.#.#.#########.#######.#
...#...#.#.#...#.....#.....#...#
.###.###.#.#####.###.#.###.#.###
...#.....#...#...#...#.#...#.#.#
##.#########.#.###.###.#.#.#.#.#
...#.........#.#.#.#...#.#.#.#.#
.#########.###.#.#.#####.###.#.#
...#.....#.......#.....#...#...#
##.#.###.#############.#.#.###.#
.#...#.#...#.....#....G#.#...#.#
.#####.###.#.###.#.#####.#.###.#
.........#...#.#...#...#.#.....#
.#############.#####.#.#.#######
.....#.........#.....#.#.#.....#
.###.#.#.#######.###.###.###.#.#
...#...#...........#.........#.#
################################
