8
.#....G#
.#.###.#
.....#.#
.#####.#
.#S....#
.#######
.......#
########
