64
...#...#.....#.......#.............#.#...#.........#.....#.....#
.#.#.#.###.#.#.#####.#.#########.#.#.#.#.#.#.#####.###.#.#####.#
.#...#.#...#.#.#...#.....#...#...#.#...#...#.#...#.....#.#.....#
.#####.#.###.###.#.#####.#.###.###.#.#######.#.#########.#.###.#
.....#...#.#...#.#...#.....#...#.#.#.......#.#.........#.#.#...#
.###.#####.###.#.###.#######.###.#.#######.#.###.#####.#.#.#####
...#...#...#...#.#...#.......#...#.#.......#...#.#...#.#.#.#...#
######.#.###.###.###.#.#######.###.#.#########.#.#.#.#.#.#.#.#.#
.......#.....#.....#.#.....#...#...#.......#...#.#.#...#.#...#.#
.#######.#########.#.#####.#.#.#.###.#######.###.#.###.#.###.#.#
.....#.#...#.......#.#.....#.#...#...#.....#.#...#.#...#...#.#.#
.###.#.###.###.#####.#.#####.#######.#.###.#.#####.#.#####.###.#
...#.#...#.....#...#...#...#...#...#.#.#.#.#...#...#.....#....G#
##.#.###.#######.#######.#.###.#.#.###.#.#.###.#.#######.#####.#
...#.#...#.....#.........#...#.#.#.....#.....#.#.....#...#...#.#
####.#.###.#.###.#######.#####.#.###.#######.#.#.###.#.###.###.#
.....#.....#...#.#.#...#...#...#...#.#...#.#...#.#...#.....#...#
.#.#######.###.#.#.#.#.###.#.#####.###.#.#.#######.###.#####.###
.#.#.....#...#.....#.#.#...#.....#.....#.#...#.....#.#.#.....#.#
.###.###.###.#######.#.#.#.#####.#.#####.#.###.#.###.#.#.#####.#
.#...#...#...#...#...#.#.#...#...#.#.....#.....#.#.....#...#...#
.#.###.#######.#.#.###.#.###.#.#####.#####.#####.#.#######.#.#.#
.#.#...#.......#...#...#.#...#...#...#...#.....#.#.#.....#.#.#.#
.#.#.###.###########.###.#.#####.#.###.#######.#.#.#.###.#.###.#
.#.#.#.......#.......#...#.#...#...#.........#.#.#.#.#.#.#...#.#
.#.#.###.###.#.#####.###.#.#.#######.#######.#.#.###.#.#.###.#.#
...#...#...#.#.#...#.....#.#.......#.#.....#...#...#.#.#...#.#.#
######.#.###.#.#.#.#######.#.#.#####.#.###.#######.#.#.###.#.#.#
.......#.#...#.#.#.....#...#.#.......#...#...#.....#...#...#...#
.#######.#.#.###.#####.#.###.###########.###.#.###.###.#.#####.#
...#...#.#.#.#...#.#...#.#.............#.#.#...#...#...#.......#
##.#.###.#.###.###.#.###.###############.#.###.#####.###########
...#.....#.........#.#.........#.........#.....#...#.#.#.......#
.#####.###########.#.#########.#.#########.#####.#.#.#.#.#.###.#
.....#.......#...#.#.#.....#...#.#...#...#.#.....#.#.#...#.#...#
####.#########.#.###.#.###.#.###.#.#.#.###.#.#####.#.#####.#.###
...#...........#...#.#.#...#...#.#.#.#.....#.#.#...#.#.....#.#.#
.#.#########.#####.#.#.#.#####.#.#.#.###.###.#.#.###.#.#####.#.#
.#.....#...#.#.....#...#.#.......#.#...#...#...#...#...#.#...#.#
.###.###.#.###.#######.#.#########.###.#######.###.#####.#.###.#
.#...#...#...#.#.....#.#.............#.#.....#...#.#.......#...#
.#.###.#####.#.#.###.#.###############.#.###.###.#.#.#######.#.#
.#.#.#....S#.#...#.#.#.......#.#.......#.#.#...#.#...#.......#.#
.#.#.#######.###.#.#.#######.#.#.#####.#.#.#.#.#.###########.###
.#.....#...#...#.#.#.#.#.......#...#...#...#.#.#...........#...#
.#######.#.###.#.#.#.#.#.#########.#.#####.#.#############.###.#
.........#...#.#...#.#.#.#.#.....#.#.#...#.#.............#...#.#
.#########.#.#.###.#.#.#.#.#.###.#.#.#.###.###.#############.#.#
.....#...#.#.#.#...#.#.....#...#...#.#...#.#.#...#...#.....#.#.#
##.###.#.#.#.#.#####.#######.#.#####.###.#.#.###.#.#.#.#.###.#.#
.#.#...#.#.#.#.....#.......#.#...#.#.#...#.#.#...#.#...#...#.#.#
.#.#.###.#.#.#####.#######.#.###.#.#.#.#.#.#.#.###.#######.#.#.#
...#.#.#...#.....#...#.....#...#.#.#...#.#...#.....#.....#.#.#.#
.###.#.###.#########.#.#########.#.#.#######.#######.#####.#.#.#
...#.#.....#.......#.#.#.........#...#.....#.....#.....#...#...#
##.#.#######.#####.#.#.###.#.#########.#.#######.#.###.#.#.###.#
.#.#...#.....#...#.#...#...#.#...#.....#.......#.#.#.#.#.#.#...#
.#.###.#.#######.#.#####.###.#.#.#.###########.#.#.#.#.#.###.###
...#...#.#.......#.......#...#.#...#.........#...#...#.#.....#.#
.###.###.#.#.#########.#######.#####.#.###############.#######.#
.#.#.....#.#.........#.#.......#...#.#.........#.....#.....#...#
.#.#############.###.#.#.#######.#.#########.#.#.###.###.#.###.#
.................#...#...........#...........#...#.......#.....#
################################################################
