8
......G#
##.###.#
...#...#
.###.###
.#.....#
.#####.#
....S#.#
########
