16
.#...........#.#
.#.#####.###.#.#
G....#...#.....#
.#####.###.#####
.#.#...#...#...#
.#.#.#######.#.#
.#.#.........#.#
.#.###########.#
...#...........#
##.#.#########.#
...#.#...#S..#.#
.###.#.#.###.#.#
...#...#...#.#.#
##.#######.#.#.#
.........#...#.#
################
