32
.....#.......#.........#.......#
.###.#.#####.#.###.###.#####.###
.#...#.#...#...#.#.#.......#...#
.#####.#.#.#####.#.#######.###.#
.#.....#.#.....#.#...#...#.....#
.#.#####.#####.#.###.###.#####.#
.#...#.....#...#...#...#...#...#
.###.#####.###.#.#.###.#.###.###
...#.....#...#...#.#...#.#...#.#
.#######.###.#######.###.#.###.#
...........#.#.......#...#.#...#
.#########.#.#.#######.###.#.#.#
...#.....#...#...#.#.......#.#.#
####.###.#####.#.#.#.#########.#
.....#...#...#.#.#.............#
.#####.###.#.###.#####.#######.#
...#.......#...#.#...#.#...#...#
.#.###########.#.#.#.###.#.###.#
.#.....#.#...#.#.#.#.....#...#.#
.#####.#.#.#.#.#.#.#########.#.#
.#..G#.#...#.....#.....#...#.#.#
##.#.#.#.#############.###.#.###
...#.#.#...#.#.........#...#...#
.###.#.###.#.#.#########.#.###.#
...#...#.....#.#.........#...#.#
.#.###.#######.#########.#####.#
.#.#...#.......#.......#...#...#
.#.#####.#######.#####.###.#.###
.#.....#.......#.#...#.#...#...#
.#####.#######.#.#.###.#.#.###.#
.....#...........#.......#.#S..#
################################
