8
.......#
.#.###.#
.#G..#.#
####.#.#
.....#.#
.#######
......S#
########
