16
.....#.........#
.###.#.#####.#.#
...#.#...#...#.#
##.#.#.###.###.#
...#...#S#...#.#
.#######.#.#.#.#
.#.......#.#.#.#
##.#######.#.#.#
...#...#...#.#.#
.###.#.#.###.#.#
.#...#.....#.#.#
.###########.#.#
.#.......#...#.#
.#.#####.#.###.#
G..#.......#...#
################
