16
.#.............#
.#.#####.#######
...#...#.#....S#
.###.#.#.#.#####
.#...#...#.....#
##.###########.#
...#...#.....#.#
.###.#.#.#.###.#
...#.#...#.....#
.#.#.###########
.#.#.......#...#
.#.#######.###.#
.#.......#.#...#
.#######.#.#.#.#
..G....#.....#.#
################
