16
...#.....#...#.#
.#.#.#.#.#.#.#.#
.#.#.#.#.#.#S#.#
.#.#.#.#.#.###.#
.#.#.#.#.#.#...#
##.#.#.###.###.#
...#.#...#...#.#
.###.###.###.#.#
...#...#.....#.#
.#.###.#######.#
.#.....#.......#
.#######.#######
....G#.........#
####.#########.#
...............#
################
