64
...........#.......#...#.......#.........#...#.....#...#.#.....#
.#######.#.#######.#.#.###.###.#######.#.#.#.###.#.#.#.#.#.###.#
...#...#.#.....#...#.#...#.#.#.......#.#...#...#.#...#.#...#.#.#
##.###.#.#####.#.###.###.#.#.#######.#.#######.#.#####.#.###.#.#
.#...#.#.#...#.#.#...#...#.#.....#...#.#.....#...#.....#.....#.#
.###.#.#.###.#.#.#.###.###.#.###.#.###.###.#######.#######.###.#
...#...#.#...#...#.#...#...#...#.#.....#...#...#...#...#...#...#
.#.#.###.#.#####.#.#.###.#####.#.#######.###.#.#.#####.#.###.#.#
.#...#...#.......#.#.#.....#...#.....#.......#...#.....#...#.#.#
.#####.###########.#.###.#.#.#####.###.###########.#.#####.#.#.#
...#.#.#...#...#...#...#.#.#...#...#...#...........#.#...#.#.#.#
##.#.#.#.#.#.#.#.#####.###.###.#.###.#########.###.###.#.#.#.#.#
...#.#...#.#.#...#.........#.#.#.....#.......#...#.....#...#.#.#
.###.#####.#.#####.#########.#.#########.###.#.#######.#####.#.#
.........#.#.#...#.#.....#.#...#...#.....#...#.#.....#.....#.#.#
.#########.#.###.#.#.###.#.#.###.#.#.#####.###.#.###.#######.#.#
.#...#.....#...#...#...#.#...#...#.#.#...#...#.#...#.........#.#
##.#.#.###.###.#.###.###.#.###.###.#.#.#.###.#.###.###########.#
...#.#...#.#...#.#.#.#S#.#.#...#.#...#.#.#...#...#.....#...#...#
.###.#.#.###.###.#.#.#.#.#.#.#.#.#####.###.#####.#####.#.###.###
.#...#.#.#...#.....#.#.#.#.#.#.#.........#.#...#.#...#.#...#...#
.#.#####.#.#######.#.#.#.#.#.#.#.#######.#.#.###.###.#.#.#.###.#
.#.#...#.#.#.....#.#.#...#.#.#.#...#...#...#...#...#.#.#.#...#.#
.#.#.#.#.#.#.###.###.#####.###.###.#.#.#####.#.###.#.#.#####.#.#
.#.#.#...#...#.#.#...#...#.....#...#.#.....#.#.......#.....#...#
.#.#.###.#####.#.#.###.#########.#######.###.#######.#####.#.###
.#...#.#...#...#.#.#.#.......#.#.......#.....#.....#...#...#.#.#
.#####.###.#.#.#.#.#.#.###.#.#.#######.#.#####.###.#####.###.#.#
.#...#.....#.#.#.#.#...#.#.#.#.#.......#.#.....#.#.......#.#.#.#
.#.#.#######.#.#.#.#.###.#.#.#.#.#########.#####.#########.#.#.#
.#.#.........#.#...#.....#.#...#...#.......#...............#...#
.#.###########.#########.#.#######.#.#######.#################.#
...#...#.........#.......#.......#.#.#.#.....#...#.....#.......#
.#####.#.#######.#.#############.#.#.#.#.#.###.#.#.###.#.#######
.#.....#.....#...#.#...........#...#.#.#.#.....#...#.#...#.....#
.###.#####.#.#.###.#.#########.#####.#.#.###########.#####.#.###
.....#...#.#.#...#.#...#.#.....#.....#...#.....#.....#.....#...#
####.#.#.###.###.#.###.#.#.#####.#####.###.#.###.#.#.#########.#
.#...#.#...#.#...#...#.#...#.....#.#...#...#.....#.#...#...#...#
.#.###.###.#.###.###.#.#.###.###.#.#.###.#########.###.#.#.#.###
...#...#.#.#...#...#...#...#.#.#.#.....#.....#...#.#.....#.#...#
####.###.#.###.###########.#.#.#.#####.#####.#.#.#.#######.###.#
...#.#...#...#.........#...#...#...#.#.#...#...#.#.....#.......#
.#.#.#.#.###.#.#####.#.#.#####.###.#.#.#.#######.#####.#########
.#.#.#.#.....#.#...#.#.#...#.#.#.#.#...#.#.......#...#.#.......#
.#.#.#.#########.#.###.###.#.#.#.#.#.###.#.#######.###.#.#####.#
.#.#.#...........#.......#.#.....#.#.#.....#...#.....#...#.#...#
.#.#.###################.#.#.#####.#.###.#####.#.###.#####.#.#.#
.#...#.....#...........#.#.#...#...#...#.....#...#.......#.#.#.#
.###.#.###.#.#########.###.#####.#####.#####.###.#.#####.#.#.###
.#...#...#...#.......#...#...#...#.........#...#.#.#.....#.#...#
.#.#####.#####.#.###.###.###.#.###########.###.###.#####.#.###.#
.#.....#.....#.#...#...#.....#.......#.....#.......#...#.....#.#
.#.#########.#####.###.#######.#####.#.#############.#.#####.#.#
.#.#.......#.....#...#.#...#...#.....#.........#...#.#.#...#.#.#
.###.###.#.#####.###.#.###.#.###.#############.#.#.#.#.#.#.###.#
.....#...#.....#.#...#...#.#...#...#...#.....#...#G..#...#...#.#
.#####.#########.#.#####.#.#.#####.#.#.#.###.###############.#.#
.....#.........#.#.#...#.#...#...#.#.#...#.#.....#.........#...#
####.#########.#.#.#.###.#####.#.#.#.#####.#####.#.#.#########.#
...#.#...#...#...#.#...#.#...#.#...#.#.......#.#.#.#...........#
.#.#.#.#.#.#.#####.#.#.#.#.#.#.#####.###.###.#.#.#.#############
.#.....#...#.......#.#.....#...#.........#.....#...............#
################################################################
