64
...#.....#.........#S....#...#.................#.#.....#.......#
.#.#.###.#.#######.#####.#.###.#############.#.#.#.#.###.###.###
.#...#.#.......#.......#.#.....#.......#.....#...#.#.....#.#...#
.#####.#########.#####.#.#######.#####.#.#######.#.#######.###.#
.#.....#...#.....#...#.#.#.....#.#...#.#...#.....#...#.......#.#
.#.###.#.#.#.#.###.#.#.#.#.###.#.#.###.#.#.#########.#.#####.#.#
.#.#...#.#...#.#...#.#.#...#...#.#...#.#.#...........#...#...#.#
.###.#.#.###.###.###.#######.###.#.#.#.#######.#######.###.###.#
.....#.#...#.#...#.#.......#.....#.#...#.....#.......#.#...#...#
######.###.#.#.###.###.###########.#####.###.#######.#.#.#.#.#.#
.....#.#.#.#.#.......#.......#...#.#.....#.#...#...#.#.#.#.#.#.#
.###.#.#.#.#.#######.#####.#.###.#.#.#####.###.#.#.#.###.###.###
...#.#.#.#.#.....#...#...#.#.....#...#.........#.#.#...#...#...#
##.###.#.#.#######.#####.#.###########.#########.#.###.###.###.#
...#...#.#...#.....#.....#...#...#...#.#.......#.#.#.........#.#
.#.#.###.###.#.#####.###.###.#.#.#.#.#.#.#####.#.#.#########.#.#
.#.#.#.....#.#.......#.#.#.#...#.#.#...#.#...#...#...#.......#.#
.###.###.#.#.#########.#.#.#####.#.#####.#.#.#######.#.#######.#
...#...#.#.#...#.......#.#.....#...#.....#.#.......#.#.#.....#.#
.#.###.#.#.#.###.#.#####.#.###.#####.#####.#.###.###.###.###.#.#
.#...#.#.#.#.....#.....#...#.#.#.....#...#.#...#.#...#...#.....#
.###.#.###.###########.#####.#.#.#####.###.###.###.###.#######.#
.#...#.....#.......#.#.......#.#.#.....#...#.#.....#.........#.#
##.#######.#####.#.#.###.#####.#.#####.#.###.#######.#######.#.#
...#.....#.#.....#.....#.......#.....#.#.#.........#.#.......#.#
.###.###.#.#.#########.#############.#.#.#####.###.#.#.#########
.....#...#...#.....#...#...........#.#.#.....#...#.#.#.........#
.#####.#######.#.###.###.#########.#.#.#####.#####.#.#####.###.#
.....#.......#.#...#.#...#.#.....#...#.....#.....#.#.#...#.#...#
####.#####.###.###.#.###.#.#.#.#.#####.###.#####.#.#.#.#.###.###
...#.#...#...#.#.#...#...#.#.#.#.....#...#.#.#...#...#.#...#...#
.###.###.###.#.#.#####.###.#.#.###.###.#.#.#.#.#######.###.###.#
.....#...#...#.#...#.....#...#...#.#...#.#...#.#...#...#.#.....#
####.#.###.#.#.###.#.###.#######.###.###.###.#.#.#.#.###.#####.#
...#...#...#.#.#...#.#.#.......#...#...#...#.#...#...#.#.......#
.#.#####.###.#.#.###.#.#######.###.###.###.###########.#.#######
.#...#...#...#.#.......#.....#...#.....#.#.#...#.......#.....#.#
.###.#.###.###.#########.###.###.#.#####.#.#.#.#.#.#########.#.#
.#...#.#.....#.......#...#.#...#.#...#...#...#...#.........#...#
.#.###.#####.#######.#.###.###.#.###.#.#.###############.#####.#
.#.....#...#.....#...#...#...#...#...#.#.#.......#.....#.....#.#
.#####.#.#.#######.#####.#.#######.###.#.#.#####.#.#######.#.#.#
...#...#.#.......#.#...#.#.#.......#...#.#.#...#...#.......#.#.#
##.#####.#######.#.#.#.#.#.#.#######.###.#.#.#####.#.#######.#.#
...#.....#.....#...#.#...#...#.......#.....#.......#...#.....#.#
.###.#####.#########.#####.#########.#######.#########.#######.#
.....#.#.........#...#...#.#.......#...#.....#.......#.#.......#
.#####.#.#####.#.#.#####.#.#.#####.###.#.###########.#.#.#######
.#.....#.#.#...#.#.#...#...#.#...#...#.#.............#...#.....#
.###.###.#.#.###.#.#.#.#.###.#.#####.#.#############.#########.#
...#...#...#.#.#.#...#.#.#...#.....#.#...#...#.....#.#.....#...#
##.#.#.#.###.#.#.#####.#.#.###.#.#.#.###.#.###.#.#.#.#.###.#.#.#
.#.#.#...#...#...#.....#...#.#.#.#.#.....#.....#.#.#.#.#...#.#.#
.#.#######.###.###.#########.#.#.#########.#####.#.#.#.#.###.###
.#.....#...#.....#.#.....#.....#.....#.........#.#.#...#...#...#
.#####.#.#######.#.#.#####.#######.#.###########.#.#######.###.#
...#...#.......#...#.#...........#.#.........#...#...#...#.....#
.###.###.#####.#####.#.###########.#########.#.#.#####.#.#####.#
.#...#.#...#...#.....#.#...#.......#...........#.#.....#...#...#
.#.###.###.#.###.#####.###.#.###################.#.#######.#.###
.#...#.....#...#.....#.....#.#.....#.......#.....#.....#.#.#.#.#
.###.#########.#.###.#####.#.#.###.#.#####.###########.#.#.#.#.#
........G......#...#.......#.....#.......#...............#.....#
################################################################
