32
.........#...........#.........#
.###.###.#####.#######.#####.#.#
...#...#.....#.......#.#.....#.#
.#####.#####.###.###.#.#.#######
.#...#.#...#...#.#.#.#.#...#...#
.#.#.#.#.#.###.#.#.#.#.###.#.#.#
.#.#...#.#.#.#.#...#.....#...#.#
.#.#####.#.#.#.#########.#####.#
.#.#.....#.#.......#...#.....#.#
.#.#.#####.#######.#.#.#####.#.#
.#.#.#S..#...#.....#.#.....#.#.#
##.#.###.###.#.#####.#####.###.#
...#...#...#.#.#.......#.....#.#
.#####.###.#.#.###.###.#####.#.#
...#...#.#...#...#...#.#...#...#
##.#.###.#######.###.#.#.#.###.#
.#...#.......#...#.#.#...#...#.#
.#########.###.###.#.#######.#.#
.........#.#...#.#...#.#...#.#.#
.#####.#.#.#.###.#.###.#.#.#.#.#
.#.#...#...#...#.#.....#.#...#.#
.#.#.#####.###.#.#####.#.#######
...#.#.......#.#.......#.......#
##.#.#.#######.#.#########.###.#
.#.#.#...#...#.#.#.#.....#.#...#
.#.#.#####.#.#.#.#.#.###.###.#.#
.#.#.#.....#...#...#.#.#...#G#.#
.#.#.#.#############.#.###.#.###
.#.#...#...#.........#...#.#...#
.#.#####.#.#.#########.#.#.###.#
.........#...#.........#.......#
################################
