64
...#.............#.................#.....#...........#.#.......#
.###.#.#########.#.#.#############.#.#.###.#.#######.#.#.#####.#
.#...#.........#.#.#.#.......#.....#.#.#...#.#.....#.#.#.#.#...#
.#.###########.#.###.#.###.###.#######.#.###.#.#####.#.#.#.#.#.#
.....#.........#.#...#...#.#...#.....#.#...#.#.#.....#.....#.#.#
######.#########.#.#######.#.#####.#.#.#.###.#.#.###########.#.#
.......#.#.........#.......#.......#.#...#...#.#.....#.......#.#
.#######.#.#########.#######.#######.#####.###.#####.#.#.#######
...#...#.#...#.#...#.........#...#........G#...........#.#.....#
.#.#.#.#.###.#.#.#.#######.###.#.###.#################.###.###.#
.#...#.#.#...#.#.#.#.....#...#.#...#.#...#...........#.#...#.#.#
.#####.#.#.###.#.#.#.###.#####.###.#.#.#.#.#########.###.###.#.#
.#.....#.......#.#.#...#.......#...#.#.#...#.#.....#...#...#.#.#
##.#.#########.#.#.###.#########.###.#.#####.#.###.###.###.#.#.#
...#.#...#.....#.#...#.....#...#...#.#...#.....#.#...#...#.#.#.#
.###.#.#.###.###.###.###.###.#.###.#####.#.#####.###.###.#.#.#.#
.#...#.#...#.#.#.#...#...#...#.....#...#.#.....#...#...#.....#.#
.###.#.###.#.#.#.#.###.###.#########.#.#.#####.###.###.#######.#
...#.#.#.#.#...#.#.....#.#...#.....#.#.#...#...#.....#...#...#.#
.#.###.#.#.#####.#######.###.#.###.#.#.###.#.###.#.#####.#.#.#.#
.#.......#.....#.#.#...#...#...#...#.#...#.#.....#.#.....#.#...#
##############.#.#.#.#.#.#.#####.###.###.#.#####.###.#.###.###.#
...............#.#...#...#.#.....#...#.#.#...#.#.#...#.#...#.#.#
.#############.#.#########.#.#####.###.#.###.#.#.#.###.#.###.#.#
.....#.....#...#.....#...#.#...#.......#...#.#...#.#...#.#.....#
.###.#.#.#.#.#######.#.#.#.###.#.#########.#.#####.#.###.#####.#
.#.#.#.#.#.#.#.....#.#.#...#.#.....#.......#.#...#.#...#.....#.#
.#.#.###.#.#.#.#.###.#.###.#.#######.#####.#.#.#.#.###.#####.#.#
.#.#...#.#.#.#.#.#...#...#...#.......#...#.#...#...#...#.#...#.#
.#.###.#.###.###.#.#####.#.###.#####.#.#.###########.###.#.#####
.....#.#.......#.#.#.....#.#...#...#.#.#...#.....#...#...#.....#
####.#.#######.#.#.#.#####.#.###.#.###.###.#.#.###.###.#######.#
.....#.....#...#.#.#.....#.#.....#.......#.#.#...#.#...#.....#.#
.#########.#.###.#.#.###.#################.#.###.#.###.#.###.#.#
.#.......#.#.#...#.#...#.......#...........#...#.#...#...#...#.#
.#.#####.#.#.###.#.###########.#.#########.###.#.###.#####.###.#
.#...#.....#.#...#.........#...#.......#.....#.#.....#.....#...#
####.#.#####.#.#.#########.#.#.#######.#######.#######.###.#.#.#
.....#.#...#...#...#.....#.#.#.....#.#.#.......#.......#...#.#.#
.#######.#.#########.###.#.#.#####.#.#.#.#######.#.#.#######.#.#
.....#...#.#...#.....#.#...#...#.....#...#.......#.#.#.....#.#.#
.###.#.###.#.#.#.#####.#####.#.#.###########.#####.#.#.###.#.#.#
...#...#S#.#.#.#.#.......#...#.#...#.......#.#.....#.#.#.#.#.#.#
.#######.#.#.#.#.#.###.#.#####.#####.#.###.###.#####.#.#.#.#.#.#
.#.....#.#.#.#...#.#...#.....#.......#.#...#...#...#.#.#.....#.#
##.###.#.#.#.#######.#######.###.#####.#.###.###.#.###.#######.#
...#.#.#.#.#.#.......#.....#...#.#.#...#.#.......#.#...#.....#.#
.###.#.#.#.#.#.#######.#######.#.#.#.###.#########.#.###.###.#.#
.....#.#.#.....#.......#.....#.#...#.#.............#.....#...#.#
####.#.#.#########.#.###.#.#.#.#####.#.#########.#####.###.###.#
.#...#.#.........#.#.....#.#.#.....#.#...#...#...#...#.#...#...#
.#.###.#########.#####.###.#.#####.#.###.#.#.#####.#.#.#.#######
.#.#.#...........#...#...#.#...#...#.#...#.#...#...#.#.#.......#
.#.#.#############.#.#####.#####.###.#.###.###.#.###.#.#######.#
...#.............#.#...#...#...#.#...#...#...#...#.#.#.#.......#
.###.###.#######.#.###.#.###.#.#.#.#.#######.#####.#.###.#####.#
.#.....#...#...#...#...#.....#.....#.#.....#.#.#.....#...#...#.#
.#####.###.#.#.#####.###############.#.###.#.#.#.#####.###.#.#.#
.....#...#...#.#.....#...#...#.....#.#.#.#...#.#.......#.#.#.#.#
####.#######.#.#####.#.#.#.#.#.###.###.#.#####.#########.#.#.#.#
.....#.....#.#.....#...#.#.#.#...#.....#.....#.........#...#.#.#
.#####.###.#######.#####.#.#.###.#######.###.#.#######.#.###.#.#
.......#...........#.......#.....#.........#.........#.....#...#
################################################################
