16
...........#G..#
.#.#######.###.#
.#.#...........#
.#.###.#########
.#...#.#...#...#
.###.###.#.#.#.#
.#.#.#...#...#.#
.#.#.#.#####.#.#
.#.#...#...#.#.#
.#.#####.#.###.#
...#...#.#.....#
##.#.#.#.#####.#
...#.#.#...#...#
.###.#.###.#.###
.....#.#S..#...#
################
