8
...#S..#
.#.###.#
.#.....#
.#######
.#...#.#
.#.#.#.#
...#..G#
########
