64
.......#...........#.......#.#.....#...........#.....#.........#
.#####.#.#####.###.#.#.###.#.#.###.#.#.#########.#.###.#.#######
.....#.......#...#.#.#.#.....#.#.#...#.#...#.....#.....#.#.....#
##.#####.#####.#.###.#.#######.#.#####.#.#.#.###########.#.###.#
...#...#.#...#.#.#...#.......#...#...#...#...#.#.......#.#.#...#
.###.#.###.#.###.#.#########.###.#.#.#########.#.###.#.#.#.#.###
...#.#.#...#.....#.#...#.......#...#.#...........#...#.#...#...#
####.#.#.#######.#.###.#.#####.#####.#############.###.#####.#.#
.....#...#.....#.#.#...#.#...#.#...#...............#.#.#...#.#.#
.#########.#.###.#.#.#.#.#.#.#.#.#.#################.#.#.#.###.#
...#.#.....#.....#...#.#.#.#...#.#.....#...#.......#...#.#...#.#
.#.#.#.#######.#####.###.#.#####.#####.#.#.#.#.#####.###.###.#.#
.#.#...#.#...#...#...#...#...#...#.#...#.#.#.#.....#.#...#.#...#
.#.###.#.#.#.#####.###.#####.#.###.#.###.#.#.#####.#.#.###.###.#
.#...#...#.#.......#.#..G#.#...#.....#...#.....#...#.#...#.#...#
####.#####.#########.###.#.#####.###############.#.#.###.#.#.###
.....#...#...........#.#.#.....#.#.....#...#.....#.#.#...#...#.#
.#####.#.###########.#.#.#.#.###.#.###.#.#.#.#######.#.###.###.#
.......#.........#...#.#.#.#.....#.#.#...#...#.......#.#.#.#...#
##########.#######.###.#.#.#######.#.###.#####.#######.#.#.#.#.#
.........#.#.....#...#.#.#.....#...#.....#.....#.....#.#...#.#.#
.#######.#.#.###.###.#.#.#####.#.#########.#####.#####.###.#.#.#
.#.......#...#.....#...#.....#.#.#.........#.....#...#...#...#.#
.#####.#######.#######.#####.#.#.#.#############.#.#.###.#####.#
.....#.........#...#...#...#.#...#.#.....#.......#.#.#...#.....#
.###.###########.#.#.###.#.#.#####.#####.#.#.#####.#.#.###.#####
...#.........#...#...#...#.#.....#.....#...#.#.....#...#.......#
##.#########.#.#######.###.#####.#####.#####.#.#################
...#.....#...#.#.....#...#.....#.....#.......#.................#
.###.###.#.#.#.#.###.#.#####.#######.#######.#######.#########.#
.#...#.....#.#.#.#...#.#.....#.....#.#.....#.#.#...#.......#...#
##.###########.#.#.###.#.#####.#.###.#.#.###.#.#.#.###.#####.###
...#.....#.....#.#...#.#.......#...#...#.......#.#...#.#...#...#
.#.#.###.#.#####.###.#.#########.#.#############.###.#.#.#.###.#
.#.#...#...#...#...#.#.....#...#.#.#...#.........#...#.#.#.....#
.#.###.#####.#.###.#.#####.#.#.#.#.#.#.#.#########.#####.#######
.#.#...#...#.#.#...#.......#.#.#.#...#.#.#.........#.....#.....#
.###.###.#.###.#.#####.#####.#.#######.#.#.###########.#.#.###.#
.#...#...#...#...#...#.....#.#.........#.#...#.........#.#...#.#
.#.###.#.###.#####.#.#######.#######.###.###.#.#########.###.#.#
.#...#.#.#.....#...#.........#.....#.#...#...#.#...#.......#.#.#
.###.#.#.#####.#.#############.#####.#.###.###.#.#.###.#####.#.#
.#...#.#...#...#.#.......#.....#.....#.#.......#.#...#.#.#...#.#
.#.#######.#.###.#######.#.###.#.#####.#########.###.#.#.#.###.#
.#.#.......#...#.#.......#.#.#...#.#...#.........#...#...#...#.#
.#.###.#######.#.#.#####.#.#.#####.#.###.#########.#########.#.#
.#.#...#.......#.#.....#.#.#.......#.#...#...#...#.#.......#.#.#
.#.#.###.#######.#.###.###.###.###.#.#.###.#.###.#.#.###.###.#.#
.#...#.#...#.....#.#.#.#.......#...#...#...#.....#.#.#...#S..#.#
.#####.###.#.#####.#.#.#.#######.#######.#######.#.#.#.#.#####.#
.....#.....#.....#...#...#.....#.....#...#...#...#...#.#.#...#.#
.#####.#########.#########.###.#####.#.###.#.#########.###.#.#.#
.#.....#...#.....#.........#.#...#.#...#...#.#...#.....#...#...#
.#.#####.#.#.#####.#######.#.###.#.###.#.###.#.#.#.#####.#######
...#.....#.#.........#...#.....#.#.....#.#.....#...#...#.......#
.###.###.#.###.#######.#.#####.#.#.#####.#.#########.#.#######.#
.#.....#.#...#.#.#.....#.....#.#.#.....#.#.#.........#.......#.#
.#######.###.#.#.#.#########.###.###.###.#.#.###############.#.#
.........#...#...#.#.#.....#.#...#.#.#...#.#.#...........#.#...#
##########.#######.#.#.###.#.#.###.#.#.###.#.#####.#####.#.#####
.......#...#...#...#.#...#.#...#.....#.#...#.#...#.#.#...#.....#
.#####.#.###.#.#.###.###.#.#####.#####.#####.#.#.#.#.#.###.###.#
.....#.......#...#.......#...........#.........#...#.......#...#
################################################################
