8
G......#
.#######
......S#
.#######
.#...#.#
.#.#.#.#
...#...#
########
