8
.....#G#
.#.#.#.#
.#.#...#
##.#####
S#.....#
.#####.#
.......#
########
