16
.........#.....#
##.#####.#.#.#.#
S#...#...#.#.#.#
.###.#.#####.#.#
...#.#...#...#.#
##.#.###.#.###.#
.#...#...#.#...#
.#####.###.#.###
.....#.....#.#.#
.#.#########.#.#
.#.....#.#...#.#
.###.#.#.#.###.#
...#.#...#.....#
##.#.#########.#
...#......G....#
################
