8
..G#...#
.###.#.#
.#...#.#
.#.###.#
...#...#
.###.###
...#..S#
########
