16
...............#
.###.#########.#
.#...#...#.....#
.#####.#.#.#####
.#.....#.#.....#
.#.#####.#####.#
.#.....#.....#.#
.#####.#####.#.#
...#S..#...#.#.#
.#######.###.#.#
.....#...#...#.#
.#.###.#.#.###.#
.#.#...#.#.#.#.#
.#.#.###.#.#.#.#
.#.....#...#..G#
################
