32
...#.......#...............#...#
.#.#####.###.#########.###.#.#.#
.#.......#...#...#...#.#G..#.#.#
.#######.#.###.#.#.#.#.#.#####.#
.....#...#.#.#.#...#...#.......#
.###.#.###.#.#.###############.#
.#...#...#...#...#.......#.....#
##.#.#######.###.#######.#.#####
...#.#.....#.#.#...#.....#.#...#
.#.###.#.###.#.###.#.#####.#.#.#
.#.#...#.....#.#...#.....#.#.#.#
.###.#########.#.###.###.#.#.###
.#...#.......#.#.#...#.#...#...#
.#.###.#####.#.#.#.###.#######.#
.#.....#...#...#.#.#.........#.#
.#####.#.#.#####.#.#######.#.#.#
.....#.#.#.....#.#...#.....#...#
####.#.#.#####.#.###.#.###.#####
.....#.#.#...#.#...#...#.#.#...#
.###.#.#.#.###.#.#.#####.#.#.#.#
...#.#.#.#.#...#.#.#.......#.#.#
.#.#.#.#.#.#.#####.#.#######.#.#
.#.#.#.#.#...#.....#.#.......#.#
.#.###.#.###.#.###.###.#######.#
.#...#.#...#...#...#...#...#...#
.###.#.###.###.#####.###.#.#.###
.#...#...#...#.#S....#.#.#...#.#
.#.#####.###.#########.#.#####.#
.#.....#...#.....#...#...#...#.#
.#####.###.#####.#.#.#.###.#.#.#
.....#.........#...#.......#...#
################################
