8
..G..#.#
.###.#.#
...#...#
##.#.###
...#.#S#
.#####.#
.......#
########
