8
......G#
.#####.#
...#...#
##.#.###
.#S#.#.#
.###.#.#
.......#
########
