32
.....#...............#.........#
.###.#.#######.#.#####.#####.#.#
.#...#.#.....#.#.#...#.....#.#.#
.###.#.#.###.#.###.#.#####.#.###
...#.#...#...#.#...#...#...#...#
.#.#.#######.#.#.#####.#.#####.#
.#.#.......#.#.....#...#.#.#...#
##.#######.#######.#.###.#.#.#.#
S..#.....#.....#...#...#...#.#.#
####.###.#####.#####.#.#.###.#.#
...#...#.#...#.....#.#...#...#.#
.#.###.#.###.#####.#.#####.###.#
.#.....#.....#.#...#.....#.#.#.#
.###########.#.#.#####.###.#.#.#
...#.......#.#.#.#...#.#...#.#.#
.#.#.###.###.#.#.#.#.###.###.#.#
.#.#.#.#...#...#...#...#.#...#.#
.#.#.#.###.###.#######.#.#.#.#.#
.#.#...#.....#.#.....#...#.#...#
.#.#####.#.###.###.#.#####.#####
.#.#...#.#.#...#...#.#.#..G#...#
.#.#.#.#.###.###.###.#.#.###.#.#
.#.#.#.#...#.#.....#.#.#.....#.#
##.#.#.###.#.###.#.#.#.#######.#
...#.#...#.....#.#.#.....#.....#
.###.###.#####.###.#####.#.#####
.....#...#...#.....#...#.#...#.#
.#####.###.#.#######.#.#####.#.#
...#...#...#.#.......#.....#.#.#
##.#.###.###.#.###########.#.#.#
...#.......#.............#.....#
################################
