16
.#......G..#...#
.#.###.###.###.#
.....#...#.....#
.#######.#####.#
...#...#.....#.#
##.#.#.#.###.#.#
...#.#.#...#.#.#
.###.#.#####.#.#
.#...#.....#.#.#
.#.#######.#.#.#
.#.#.......#.#.#
.#.###.#####.#.#
.#...#.......#.#
####.#########.#
S....#.........#
################
