64
.........#.....#...#...................#.................#.....#
##.#####.###.#.#.###.#####.#.#########.#.###.###########.#.###.#
...#...#.....#.#.#...#...#.#...#...#...#.#...#.....#...#.#.#.#.#
.#.#.#.#######.#.#.###.#.###.#.#.#.#.#####.###.###.#.#.#.#.#.#.#
.#.#.#.#.......#...#...#...#.#.#.#...#.....#...#...#.#.#...#.#.#
.###.#.###.#########.#####.###.#.#####.#########.#.#.#.#####.#.#
.....#...#.#.........#.....#...#.#...#...#.......#.#.#.#.......#
.#######.#.###.#######.#####.###.#.#.###.#.#########.#.#.#######
.#...#...#.....#...#...#.#...#.#...#.....#...........#...#.....#
##.#.#.#########.#.#.###.#.#.#.###########.###############.###.#
...#...#.......#.#.#...#...#.#...#.......#...#.....#...#...#...#
.#######.###.#.#.#.###.#.###.#.#.#.#####.###.#.###.#.#.#.###.###
.#.......#...#.#.#.....#...#.#.#.......#...#...#.#...#...#...#.#
.###.#####.###.#.#########.#.#.#########.#.#####.#########.###.#
...#.#.....#...#...#.....#.#.#.#...#...#.#.............#...#...#
.#.#.#.###########.#.###.###.###.#.#.#.#######.#####.###.###.#.#
.#.#.#.#.....#.....#.#.#...#.#...#...#.......#.....#...#.#...#.#
.#.###.#.###.#.#####.#.###.#.#.#############.#######.#.#.#.###.#
.#.#...#...#...#.....#.......#.#.......#.....#.....#.#.#...#.#.#
.#.#.#####.#####.#############.#.#.#####.###.#.###.#.#.#####.#.#
.#.#.............#.......#.....#.#.#...#.#...#.#...#.#.......#.#
##.###############.#####.#.#####.#.#.#.#.#.###.#.#.#####.#####.#
...#.......#.......#...#.#...#...#.#.#.#.#.#...#.#.#...#...#...#
.#.#.#####.#.#######.#.#.###.#.#.#.#.#.#.###.###.###.#.###.#.###
.#.#...#.#.#...#...#.#.#.#...#.#.#.#.#.#.....#.#...#.#.#S#.#.#.#
.#####.#.#.###.#.#.#.###.#.###.#.#.#.#.#######.###.#.#.#.#.#.#.#
...#...#.#.....#.#...#...#...#.#.#.#.#...........#...#.#.#.#...#
##.#.###.#######.###.#.#.###.###.###.#.#.#############.#.#.###.#
...#.#...........#...#.#.#.#...#.....#.#.#...#.......#...#.#...#
.###.###.#########.###.#.#.###.#####.#.###.#.#.#####.#####.#.###
...#...#.......#.#...#.#.#...#.....#.#...#.#...#...#.......#.#.#
.#.###.###.###.#.#.###.#.###.#####.#.###.#.#######.#######.#.#.#
.#...#...#...#.#.#.#...#.......#...#.#.#.#...#.....#.....#...#.#
.###.###.#.###.#.#.#.#########.#.###.#.#.###.#.#.#.###.#.#####.#
.#.#.....#.#...#...#...#...#.#.#...#...#...#.#.#.#.#...#.#.....#
.#.#########.###.#####.#.#.#.#.###.#######.#.###.#.#.#.###.###.#
.#...........#.#...#.#.#.#...#.#.#.......#.#.....#.#.#.#...#.#.#
.#######.#.###.###.#.#.#.#.###.#.#######.#.#######.#.###.###.#.#
.......#.#...#.......#.#.#.#...#.......#.#.......#.#.........#.#
######.#####.#.#######.#.###.###.###.###.#.#.#####.###########.#
...#...#...#.#.....#...#.#...#.....#...#.#.#.....#.#...........#
##.#.###.#.#.###.###.###.#.#######.###.#.#####.#.#.#.###.#######
...#.#...#.#...#.#...#.......#...#...#.#.....#.#.....#...#.....#
.#.#.###.#.###.#.#.#########.#.#.#####.#####.#############.###.#
.#.#.....#.....#.#.........#...#.........#.#.......#.......#.#.#
.###############.#########.#############.#.#######.#.#######.#.#
.........#.....#.....#.....#.....#.....#.#...#.....#.#.......#.#
.#######.#.###.#####.#.#####.###.#.###.#.#.#.#.#####.#.###.###.#
.....#...#.#.#...#...#.........#.#...#...#.#.#.......#...#.....#
######.###.#.###.#.#############.#####.#####.###########.#######
.......#...#...#...#.....#.......#...#...............#.#.....#.#
.#######.#####.#####.###.#.#.#####.#.#######.#######.#.#####.#.#
....G..#.#...#.....#.#.#.#.#.#.....#.#.......#...#.........#...#
######.#.#.#.#####.#.#.#.#.#.#.#####.#########.#.#####.#######.#
.......#.#.#.#.....#.#...#.#.#.#...#...........#...#...#...#...#
.#######.#.#.#.###.#.#.###.#.#.#.#.###############.#.###.#.#.###
.........#.#...#...#.#.#...#.#.#.#.............#.#.#.#...#...#.#
.#########.#####.###.#.#.###.#.#.###########.#.#.#.###.#######.#
.#.........#...#...#.#...#...#.#.....#.......#...#...#.........#
.#.#######.#.#.###.#.#########.#######.#########.###.#########.#
.#...#...#...#...#.#.....#.....#.....#.#...#...#.#.#.#...#.....#
.#####.#.#######.#.#####.#.#####.###.#.#.###.#.#.#.#.#.#.#.#####
.......#.........#.....#.........#.....#.....#.....#...#.......#
################################################################
