8
...#..S#
.###.###
...#...#
.#.###.#
.#...#.#
.###.#.#
...#G..#
########
