16
.....#.....#...#
.#.###.#.#.###.#
.#.#...#.#.....#
.#.#.###.#####.#
.#.....#.#...#.#
.#######.#.#.#.#
...#.#S#...#.#.#
##.#.#.#####.#.#
.....#.#.....#.#
######.#.#####.#
.......#...#...#
.#######.#.#####
.....#...#.....#
####.#########.#
..............G#
################
