32
...........#.....#.............#
##.#######.###.#.#####.#######.#
...#.#...#.....#.....#.....#.#.#
.###.#.#.###########.#####.#.#.#
...#...#...#.....#.#...#.....#.#
.#.###.###.#.#.#.#.###.#######.#
.#...#...#.#.#.#.....#.#.......#
.###.#.###.#.#.#####.#.#.#####.#
...#.#.#...#.#.....#.#.#.#.....#
####.#.#.###.#####.###.#.###.###
...#.#.#...#.#.#...#...#...#...#
.#.#.#####.#.#.#.###.###.#.###.#
.#.#.....#...#.#...#.#.#.#...#G#
.#.#####.#.###.###.#.#.#.###.#.#
.#.......#...#...#...#.....#.#.#
.###########.###.###########.#.#
.#...#...........#.........#.#.#
.#.#.###########.#.#######.#.#.#
...#...#...#.....#...#.......#.#
######.#.#.###.#####.#########.#
.....#...#...#.#.....#.....#...#
.###.#######.#.#.#.###.###.#.###
.#.....#S..#.#.#.#.......#.#.#.#
.#.#######.#.#.###.#######.#.#.#
.#.......#...#...#...#.....#.#.#
.#####.#########.#.###.#####.#.#
.#...#.........#.#.#...#...#.#.#
.#.#.#####.#####.###.#####.#.#.#
...#.#.#...#.....#...#.....#.#.#
####.#.#.###.#####.###.#.###.#.#
.......#...........#...#.......#
################################
