32
.....#.......#.............#...#
.#####.#.###.#.#######.###.#.#.#
.#...#.#.#...#.#...#...#...#.#.#
.#.#.#.#.#####.###.#.###.###.###
.#.#...#...#...#...#.#...#.....#
.#.#######.#.###.###.#.#######.#
.#.#.....#...#...#...#.....#...#
.#.#####.#######.#.#######.#.#.#
.#.#.............#.#.....#.#.#.#
.#.#.#.#########.#.#.###.#.#.#.#
...#.#.#.......#.#...#...#.#.#.#
.###.###.#####.#.#####.###.#.#.#
...#.......#...#.....#.#.#...#.#
##.#######.#.#######.#.#.#####.#
...#.....#.#.....#...#.#...#G..#
.###.###.#######.#.###.#.###.###
.#...#.#.........#...#.#...#.#.#
.#.###.#####.#########.#.#.#.#.#
...#...#...#.#.........#.#.#.#.#
######.#.#.#.#.###########.#.#.#
...#...#.#...#.#.#.........#...#
.#.#.###.#####.#.#.###.#######.#
S#.#...#.#.....#.#.#.#.......#.#
##.#.#.#.#.#####.#.#.#####.###.#
...#.#...#.#...#...#.....#.....#
.###.#####.#.#.#.#####.#.#######
.#...#...#.#.#.#.....#.#.#.....#
.###.#.###.#.#######.#.#.#####.#
...#...#...#.......#.#.#.#...#.#
##.#####.###.#####.#.#.#.#.#.#.#
.........#.......#.....#...#...#
################################
