64
.#.......#.............#.....#...........#...........#.........#
.#.#####.#.###########.#.#.###.#.#######.#.#########.#.#####.#.#
.#.#...#.#.....#.#...#...#.....#.....#...#...#.....#.#.#...#.#.#
.#.#.#.#.#####.#.#.#.#########.#####.#.#####.#.###.#.#.#.#.#.#.#
.#.#.#.#.....#.#...#.....#...#.#...#.#...#.#.#.#.....#.#.#.#.#.#
.#.###.#####.#.#######.#.#.#.#.#.#.#.###.#.#.#.#######.###.#.#.#
.#...#.....#.#.#.....#.#.#.#.#...#.#...#.#...#.............#.#.#
.###.#.#####.#.#.###.###.#.#.#########.#.###########.#####.#.#.#
...#...#.....#...#...#...#.#.......#...#...#.......#.#...#.#.#.#
.#.###.#.###.#####.###.###.#######.#.#####.#.#####.###.#.#.#.###
.#...#.#.#...#...#.#.....#...#...#...#.#...#...#.......#.#.#...#
.#####.#.#.###.#.#.#####.###.#.#.#####.#.###.#.#########.#.###.#
.#.....#.#.#...#...#...#...#.#.#.......#.#.#.#.........#.#...#.#
.#.#####.###.#######.#.###.#.###.#######.#.#.#########.#.#.###.#
...#...#...#...#.....#.....#...#.........#...........#.#.#.#...#
.#####.###.###.###.#######.###.#.###############.#####.#.#.#.###
.#.....#.#...#...#.#...#.....#.#.#.......#...#...#...#.#.#.#...#
.#.###.#.#.#####.#.#.#.#######.#.#####.#.#.#.#####.#.#.#.#####.#
...#.....#.........#.#.....#...#.......#...#...#...#.#.#.......#
####.###############.#####.#.###########.#####.#.###.#.#######.#
.....#...#...#.......#.#...#.#.....#.....#S..#...#.#...#...#...#
######.#.#.#.#.#######.#.###.#.###.#.#######.#####.#####.###.###
.....#.#...#...#...#.#...#...#...#.#.#.....#...#.......#.....#.#
.###.#.#######.#.#.#.#.#####.###.#.#.#.#.#####.#####.###.#####.#
...#...#.......#.#.#.#.#.....#...#.#.#.#.#...#.....#.....#...#.#
.#.#####.#######.#.#.#.###.###.###.#.#.###.#.#####.#.#####.#.#.#
.#.#.....#.#.....#.#.......#.#.#...#...#...#.#.....#.......#.#.#
##.#.#####.#.#####.#########.#.#.###.###.###.#.#############.#.#
...#.......#.....#.#...#.......#.....#...#.#.#...#.........#.#.#
.#.#############.#.#.#.###############.###.#.###.#####.###.#.#.#
.#.#...........#.#.#.#.....#...#.....#.....#...#.....#...#...#.#
.###.#########.#.#.#.#####.#.#.#.###.#.#####.#.#####.###.#####.#
.#.....#...#...#.#.#.....#...#...#...#.#.....#.....#.#.#.....#.#
.#.#####.#.#.###.#.#####.#########.###.#.###########.#.#####.#.#
...#.#...#...#...#.#...#.....#.....#...#.#...........#.....#...#
.###.#.#######.###.#.#.#####.#.#####.###.#.###########.#.#####.#
.....#.#...#...#.#...#.....#.#.#.....#.#...#...#.......#.#.....#
####.#.#.#.#.###.#####.###.#.#.#.#####.#######.#.#####.###.#####
.#...#...#...#.......#...#.#.#.#.....#...#...#.#.....#...#...#.#
.#.#############.###.###.###.#.#####.#.#.#.#.#.#.#######.###.#.#
.#.#...........#...#...#.....#.....#...#...#.#.#.#.....#.......#
.#.###.#.#####.#.#.###.###########.#########.#.#.#.###.#######.#
.#...#.#.#.....#.#...#.#.........#.......#...#...#.#.#.#.....#.#
.###.###.#.#########.#.#######.###.#####.#.#######.#.#.#.###.#.#
...#.....#.#.........#.#.......#...#...#.#...#.....#.#...#.#.#.#
.#.#######.#.#########.#.#####.#.###.#.#####.#.#####.#####.#.###
.#.......#.#.........#...#...#.#.....#.#...#.#.#...#.......#...#
.#######.#.#########.#####.###.#######.#.#.#.#.#.#.#.#####.###.#
...#.#...#...#.....#.#...#.....#.......#.#...#.#.#.#.#...#.....#
##.#.#.#####.#.###.#.#.###.#####.#######.#####.#.###.#.#.#######
...#.......#...#...#.#.......#...#.....#.#.....#...#.#.#.......#
.###############.###.#########.#.#.###.#.#.#######.#.#########.#
.......#...#.....#.#.........#.#.#.#.#...#.#.......#.......#...#
.#####.#.#.#.#####.#.#######.#.#.#.#.#####.#.###.#.#######.#.#.#
.#...#...#...#.......#.......#.#.#.#...#...#.#...#...#...#...#.#
.###.###########.#####.#######.###.#.#.###.###.#####.#.#.#####.#
...#...........#.#.....#.....#...#...#.....#...#.....#.#.....#.#
##.#.#########.###.###.#.###.###.###########.###.#####.#####.#.#
...#.#.......#...#.#.#.#.#...#...#.............#.#.#...#.....#.#
.###.###.###.###.#.#.#.#.###.#.#.#.###########.#.#.#.###.#####.#
...#...#...#...#...#...#...#...#.#.#.........#.#...#...#...#...#
##.###.#.#.#########.#####.#######.#.#######.#.#######.###.#.###
G......#.#...............#...........#.......#...........#.....#
################################################################
