32
.......#.......#.......#.......#
.#####.#.#.###.#####.#.#.#####.#
.#.....#.#...#.......#.#.#.#...#
.#.#####.###.#######.###.#.#.###
.#...#.....#...#.....#.....#...#
.###.#.#####.#.#######.#######.#
...#.#...#S#.#.........#.....#.#
##.#.#####.#.###########.###.#.#
.#.#.......#.#...........#.#.#.#
.#.###########.###########.#.#.#
.#.#...........#...........#.#.#
.#.#######.###########.###.#.#.#
.#.....#...#.....#.....#...#...#
.#####.#.#####.#.#.#####.#####.#
.....#.#.#.....#...#.#...#.....#
.#####.#.#.#########.#.###.#####
.....#...#...#.#.......#...#...#
.###.#####.#.#.#.#######.###.#.#
...#.....#.#.#.....#.....#...#.#
##.#.###.#.#.#######.#####.#.#.#
.#.#.#.#.#.#.#.....#...#...#.#.#
.#.#.#.#.#.#.#.###.###.###.#.#.#
...#.#...#.#.#...#...#...#.#G#.#
.###.#.###.#.#.#####.###.###.#.#
.#...#.#...#...#.......#.....#.#
##.###.#.#######.#####.#######.#
...#...#.#.....#.....#.#...#...#
.#######.#####.#####.#.#.#.#.###
.#.....#.....#.....#.#.#.#.#...#
.#.###.#####.###.#.#.###.#.###.#
.....#...........#.#.....#.....#
################################
