16
..G........#...#
.#####.#####.#.#
.#...#.#.....#.#
.#.###.#.#####.#
.#.#...#.#...#.#
.#.#.###.#.###.#
...#...#.#.....#
##.###.#.#.#####
.#.#...#.#.#...#
.#.#.###.#.###.#
...#...#.#.....#
.#####.#.#####.#
.....#.#S#.....#
####.#.###.#####
.....#.........#
################
