16
.#...........#.#
.#.#####.###.#.#
...#.#...#.#...#
.###.#.###.#.###
.....#.#.#...#S#
####.#.#.#.###.#
...#.#.#.....#.#
.###.#.#.#####.#
.....#.#.#.....#
.#####.###.#####
...#.#...#...#.#
##.#.###.###.#.#
.#.#...#...#.#.#
.#.#.#.#.###.#.#
.....#.#G......#
################
