8
...#S#.#
.###.#.#
...#...#
.#.###.#
.#...#.#
.#.###.#
.#....G#
########
