8
...#...#
##.#.#.#
...#.#S#
.###.###
.....#.#
.#####.#
G......#
########
