8
......G#
##.#.#.#
S#.#.#.#
.#.#.###
.#.#...#
.#####.#
.......#
########
