32
...#.....#.....#...............#
.#.#.#.###.#.#.#.#############.#
.#...#.....#.#.#.......#S......#
.###########.#.#######.#########
.#...#.#...#.#.....#...#.....#.#
.#.#.#.#.#.#.#####.#.#####.#.#.#
...#...#.#...#...#.#.......#.#.#
######.#.#######.#.#########.#.#
.....#.#.......#...#.......#...#
.#.###.#######.#.###.###.#####.#
.#.....#.#.....#...#...#.....#.#
.#######.#.#.#########.#####.#.#
...#.....#.#.#.........#...#...#
##.#####.#.###.###########.#####
...#.....#.....#.........#.....#
.###.###.###########.###.#####.#
.....#.#.........#...#.#.#...#.#
######.#########.#.###.#.#.#.#.#
.........#.....#.#...#.#.#.#...#
##.#####.#####.#.###.#.#.#.###.#
..G#...#.......#...#.#.#.#.#.#.#
.#####.###.#######.#.#.#.#.#.#.#
.....#...#.#.....#.#.#.#.#.#.#.#
.###.#.#.#.#.#.#.#.#.#.#.#.#.#.#
.#.#.#.#...#.#.#.#.#.#.#...#.#.#
.#.#.#.#####.#.#.#.#.#.#####.#.#
...#.#.#.....#.#.#...#.........#
.###.#.#.#####.#.#####.#########
.#...#.#...#.#.#.....#...#.....#
.#.#######.#.#.#########.#####.#
.#...........#.................#
################################
