32
.......#...........#.#.....#G..#
##.#####.#.#######.#.#.#.#.###.#
...#.....#...#.......#.#.#.....#
.###.#######.#######.#.#.#####.#
.#...#.....#.......#.#.#.#.....#
.#.###.#.#.#######.###.#.#.#####
.#.#...#.#.......#.....#.#...#.#
.#.#####.#.#############.###.#.#
.........#.#...#...#.....#...#.#
##########.#.#.#.#.#.#####.###.#
.....#S..#.#.#...#.#.#.....#...#
.###.###.#.#.#####.#.#####.#.#.#
...#.#...#.#.....#.#.....#...#.#
##.#.#.###.#####.#.#####.#####.#
...#...#...#.....#.......#.....#
.###########.#############.#####
...#.......#.....#.......#.#...#
##.#.#####.###.#.#######.#.###.#
...#.....#...#.#...#...#.#...#.#
.###.###.###.#####.#.#.#.###.#.#
...#...#.#.#.#.....#.#...#...#.#
##.#####.#.#.#.#####.###.#.###.#
...#.....#...#.#.....#...#.#...#
.###.#####.###.#.###.#####.#.#.#
.#...#.....#...#...#.....#.#.#.#
.###.###.###.#####.#####.#.#.###
...#...#.....#...#.....#...#...#
##.###.#########.#####.#######.#
.#...#.#.#...........#.#.....#.#
.###.#.#.#.###.#######.#.###.#.#
.......#.....#...........#.....#
################################
