32
.....#.......#...#.............#
.#####.#.###.#.#.#.#.#########.#
.......#...#.#.#...#.........#.#
.#########.#.#.#########.###.#.#
...#.......#.#.#.......#.#...#.#
####.#######.###.#####.#.#.###.#
.....#.....#.#...#...#.#.#.#.#.#
.#####.#####.#.#.#.#.#.###.#.#.#
.#.....#...#.#.#.#.#.#.....#.#.#
.#####.#.#.#.#.###.#.#######.#.#
.#..S#...#...#.....#.#.........#
.#.###.#############.###.#######
.#.#...#...........#...#.....#.#
.#.#.#####.#######.###.#####.#.#
.#.#.......#.....#...#.#...#...#
.#.#########.###.###.#.#.#.###.#
.#.......#...#...#...#.#.#.#...#
.#######.#####.#.#.###.#.###.###
.......#...#...#.#.....#.#..G#.#
####.#.###.#.###.#######.#.###.#
...#.#...#.#.#...#.........#...#
.#.###.#.#.#.#####.###########.#
.#...#.#.#.#.....#.....#.....#.#
.###.#.#.#.#.###.#####.#.###.#.#
.#.#.#.#.#.#...#...#...#.#.....#
.#.#.###.#.###.###.#.###.#####.#
.#.......#.#.#.#.#...#.......#.#
.#########.#.#.#.###########.###
.#.......#.#.#.....#.......#...#
.#.#####.#.#.#####.###.###.###.#
.......#...#...........#.......#
################################
