16
.....#S#.......#
##.#.#.###.#####
...#.#...#.....#
.#######.###.#.#
.#.....#...#.#.#
.#.###.###.###.#
.#...#...#.#...#
.###.#.###.#.###
...#.#.....#...#
.###.#########.#
...#........G#.#
.#.#########.#.#
.#.#...#...#...#
.#.#.#.#.#.###.#
.#...#...#.....#
################
