8
.#....G#
.#.#.###
...#...#
######.#
..S#...#
.###.#.#
.....#.#
########
