8
..S#...#
.###.###
...#...#
##.#.#.#
.#.#.#.#
.#.###.#
....G..#
########
