16
...#.......#S..#
.###.###.#####.#
...#.#.#.#...#.#
##.#.#.#.#.#.#.#
...#...#.#.#.#.#
.#.###.#.#.#.#.#
.#.#.#.#.#.#...#
.#.#.#.#.#.#####
.#...#.#.#.....#
.###.#.#.#####.#
.#...#.#...#...#
.#.###.###.#.###
.#.#...#G#...#.#
.###.###.#####.#
...............#
################
