8
..G....#
.#.###.#
.#.#.#.#
##.#.#.#
...#...#
.###.###
S#.....#
########
