16
.......#....G..#
.#####.#.#####.#
.....#.#.#.#...#
.###.###.#.#.###
.#.#.......#...#
.#.#####.#####.#
.#.#...#.#...#.#
.#.#.#.###.#.#.#
.#.#.#.....#.#.#
.#.#.#######.#.#
.#.#.....#.#.#.#
.#.#####.#.#.#.#
.....#S#.#.#.#.#
####.#.#.#.#.#.#
.....#...#.....#
################
