32
...#...#.....#.............#...#
.#.#.#.#.###.#.###########.#.#.#
G#.#.#.#.#...#.#...#.....#...#.#
##.#.#.#.#.###.#.#.#.###.#####.#
...#.#...#...#.#.#.#.#.....#...#
.###.#######.#.#.#.###.###.#.###
.....#.......#.#.#.#...#...#...#
.#####.#######.#.#.#.###.#####.#
.....#.......#...#...#.#.#...#.#
####.#######.#########.#.#.#.#.#
...#.#.....#.........#...#.#.#.#
.###.###.#.#########.#.#####.#.#
.....#...#...#.......#.#.....#.#
.#####.#####.#.#######.#.#####.#
...#.#...#...#...#.....#.#.....#
##.#.#.#.###.###.#.#####.#.###.#
.#.#...#...#...#.........#...#.#
.#.###.###.###.#########.###.#.#
.#...#.#...#.#.#S....#...#...#.#
.###.###.###.#.#####.#.###.###.#
...#.#...#.#...#.#...#...#.#.#.#
.#.#.#.###.#.###.#.#######.#.#.#
.#...#...#.......#.#.......#...#
.#####.#.#.#######.#.#######.###
.#.....#.#.#...#...#.......#.#.#
.#######.###.#.#.#######.#.#.#.#
.......#.#...#...#.....#.#.#.#.#
######.#.#.#######.###.###.#.#.#
.....#.#.#...#.....#.#...#.#.#.#
.#####.#.###.#####.#.###.#.#.#.#
...........#.......#.......#...#
################################
