32
.#...........#.....#.#.........#
.#.#.#####.###.#.#.#.#.#######.#
G..#.....#.#...#.#...#.....#...#
.#######.###.###.#####.#####.#.#
.#.....#.....#...#.....#...#.#.#
.#.###########.###.#####.#.#.#.#
.#.........#.#...#.#...#.#...#.#
.#.#####.#.#.###.#.#.#.#.#####.#
.#.#...#.#...#.#.#.#.#.#.#.#...#
.###.#.#.###.#.#.#.###.#.#.#.###
.....#...#.#...#.#...#.#.#.....#
##########.###.#.###.#.#.#######
.....#.....#...#.......#.#.....#
.###.#.#.###.###########.#.###.#
...#.#.#...#...#.#.....#.....#.#
.#.###.###.###.#.#.###.#######.#
.#.....#.#.....#.#S#.#.#...#...#
.#######.#######.###.#.#.#.#.###
.#...............#...#...#.#.#.#
.#########.###.#.#.#.#####.#.#.#
.....#...#...#.#...#.#...#.#.#.#
####.#.#.#.###.#####.#.#.#.#.#.#
...#...#.#.#...#.....#.#.#...#.#
.#######.###.###.#####.#######.#
.#.....#.....#.#...#.#.........#
.#.###.#######.###.#.#.#####.###
...#.#.....#.....#.#.......#...#
.###.#####.#.###.#.#####.#####.#
.....#...#.#.#...#.....#.#.....#
####.#.#.#.#.#.#######.###.###.#
.......#.#...#.............#...#
################################
