8
S#...#.#
.#.#.#.#
.#.#..G#
.#.###.#
...#.#.#
####.#.#
.......#
########
