32
.......#.......#.........#.....#
.#.###.###.#####.#.#######.#.#.#
.#.#S#...#.......#.....#...#.#.#
.###.###.#.###########.#.###.#.#
.....#.#.#.......#.#...#.#.#.#.#
######.#.#######.#.#.###.#.#.#.#
.......#.#...#.....#...#.#.#.#.#
.###.###.#.#.#####.###.#.#.#.###
...#.#...#.#.....#.#.#...#.#...#
.#.#.#.###.#####.#.#.#####.###.#
.#.#.#.....#.#...#...........#.#
.#.#########.#.#######.#######.#
.#.........#...#.....#.#.....#.#
.#########.#.#####.###.#.###.#.#
.#.#.....#...#...#.....#..G#.#.#
.#.#.#.#######.#.#####.###.#.#.#
.#...#.........#.....#.#...#...#
.###.#####.#########.#.#.#####.#
...#.....#...#...#...#.#.#...#.#
##.#####.###.#.#.#.#####.#.###.#
.#.#.....#...#.#...#.....#.....#
.#.#######.###.#####.#########.#
.#.........#.#.....#...#.....#.#
.###########.#####.#.#.#.###.###
...#.......#.....#.#.#.....#...#
.###.#.###.#.###.#.#######.###.#
.#...#.#...#.#.#...#...#.#.#...#
.#.###.#####.#.#####.#.#.#.#.#.#
...#...#...#.......#.#.#...#.#.#
.###.###.#.#######.#.#.#####.#.#
...#.....#...........#.......#.#
################################
