8
G......#
.#####.#
.#.....#
##.###.#
...#S#.#
.###.#.#
.....#.#
########
