32
...#..G..#.....#.#.....#.......#
.#.###.#.#.#.#.#.#.#.#.###.###.#
.#.....#.#.#.#...#.#.#...#...#.#
.#######.###.#####.#.###.#####.#
.#.....#...#.......#.#.#...#...#
.#.#######.#.#######.#.###.#.#.#
.#.......#.#...#.....#...#...#.#
.###.#.###.###.#.#####.#.#####.#
...#.#.....#...#.#.....#.#.....#
.#.#.###########.#####.#.#.#####
.#.#.#...........#...#.#.#.....#
.#.#.#######.###.#.#.###.#####.#
.#.#...#.....#...#.#...#.....#.#
##.###.#.#########.###.#.###.#.#
...#...#.#...#.....#...#.#.#.#.#
.#####.#.#.#.#.#####.###.#.#.#.#
.....#...#.#...#.....#.#...#.#.#
.###.###.#.#####.#####.###.#.#.#
.#.#...#.#.....#...#.....#.#.#.#
.#.###.#######.###.#####.#.#.#.#
.#...#.......#.#.#.....#.#.#.#.#
.#.#.#####.###.#.#####.#.#.#.#.#
...#.#...#.........#...#...#...#
####.#.###########.#.#####.#####
...#.#.........#S#.#.....#.....#
.#.#.###.#.#.###.#.#####.#######
.#.#...#.#.#.#...#.....#...#...#
.#.###.###.###.#####.#####.#.#.#
.#...#...#...#.....#.#...#...#.#
.#######.###.#####.###.#.#####.#
.................#.....#.......#
################################
