8
.......#
.###.#.#
.#.#.#.#
.#.#.###
...#.#S#
##.#.#.#
G..#...#
########
