64
...#.......#.......#...........#.....#.......#.......#.....#...#
.#.#.###.###.#.###.#.###.#####.#####.#.#.###.#####.#.#.###.#.###
.#...#...#...#.#.#.#...#.....#.......#.#.#.........#...#.#.#...#
.#####.###.###.#.#.###.#####.###.#####.#.###############.#.#.#.#
.#...#.....#...#.#...#.....#...#.#.....#.........#...#...#.#.#.#
.#.#.#######.###.#.#######.###.###.#############.#.#.###.#.###.#
.#.#.....#...#...#.#.....#...#.#...#...........#...#...#.......#
.#####.###.###.###.#.#.###.###.#.###.#########.#######.#########
...#...#...#...#...#.#.....#...#.#...#.......#.......#.........#
##.#.###.#####.#.###.#######.#.#.#.#####.###########.#########.#
.....#...#...#...#...#.#.....#.#.#.....#.#.....#.....#.....#...#
######.#.#.#.#####.###.#.#####.#.#####.#.#.###.#.#####.###.#.#.#
...#...#.#.#...#.......#.#.....#...#...#.#.#.#.#.....#.#...#.#.#
.#.#.#####.###.#.#######.#.#######.#.###.#.#.#.#####.#.#####.#.#
.#.#.....#.#.#...#.......#...#.#...#.#...#...#.#.....#...#...#.#
.#.#.###.#.#.#####.#########.#.#.###.#.###.###.#.#####.#.#.#####
.#.#.#...#...#...#.........#...#.....#.....#...#.#.....#.#.....#
.#.###.#.###.###.#########.###.#######.#####.###.#######.#####.#
.#.....#...#.....#...#.....#.....#...#.#...#.#...#...#.....#.#.#
.#########.#####.#.###.###########.#.#.#.#.#.#.###.#.#.###.#.#.#
.#.......#.#...#.#...#.#...#.......#...#.#.#...#...#...#.#.#.#S#
.#####.###.#.#.#.#.#.#.#.#.#.###########.#.#####.#.#####.#.#.###
.#...#...#...#.#.#.#.#...#...#.....#.#...#...#...#.....#...#...#
.#.#.###.#####.#.###.#########.###.#.#.###.#.#.#######.#.###.#.#
...#.#...#...#.#...#.......#.....#.#...#.#.#.#.....#...#.#...#.#
.###.#.#.#.#.#.###.#.#####.#####.#.#.###.#.###.#####.###.###.#.#
.#.#.#.#...#.#.#.#...#...#...#...#.#.....#.....#...#.#...#...#.#
.#.#.#.#######.#.#####.#.###.#.###.#####.#######.#.#.#.###.###.#
.#.#.#...#...#.......#.#...#...#.#.....#.....#...#...#.#...#...#
.#.#.#.#.#.#.#######.#.###.#####.#####.#######.#######.###.#.###
...#.#.#...#.........#...#...#.......#.#.......#.....#...#.#.#.#
####.#.###############.###.#.###.###.#.#.#########.#####.#.#.#.#
.....#...#.......#.....#...#.....#...#...#.......#...#...#.#...#
.#######.#####.#.#####.#.#########.#######.###.#.###.#.###.###.#
.#.#...#.#G....#.....#.#.......#.#.....#.#...#.#.....#...#...#.#
.#.#.#.#.#.#########.#########.#.#####.#.###.#.#####.###.#.#.#.#
.#...#.#.#.#.......#...#.......#...#...#.#...#...#...#.#.#.#.#.#
.###.#.#.#.#.#####.###.#.#######.###.###.#.#####.#.###.#.###.###
...#.#...#.#.....#.#...#.#.....#...#.#.......#...#...#.#...#...#
.#.###.###.###.#.###.###.#.###.###.#.#######.#.#####.#.###.###.#
.#...#...#...#.#.........#.#.#...#.........#.#.#...#.#...#...#.#
.###.###.###.#########.###.#.###.#.#######.###.#.###.#.#.###.#.#
...#.#.......#.......#.#...#...#.#.#.....#.#...#...#...#...#...#
##.#.#######.#.#####.###.###.#.#.###.###.#.#.#####.#.#########.#
...#.#.....#.#...#...#...#...#.#.......#.#...#.....#.#.....#...#
.###.#.###.#####.#.#.#.#######.#########.#####.#.###.#.###.#.###
.#.#...#...#.....#.#.#.#.....#.#.....#...#.....#.....#...#.#.#.#
.#.#####.###.#####.#.#.#.###.#.#.###.#.#################.#.#.#.#
.....#...#.....#...#.#.#.#.#.#.....#.#.....#...........#.#...#.#
####.#.###.#####.###.#.#.#.#.#######.#####.#.#######.#.#.#####.#
.....#.....#...#.#...#.#.#.#...........#...#...#.....#.#.#.....#
##########.#.#.#.###.#.#.#.###########.#.###.###.#######.#.###.#
.....#...#.#.#.#...#.#.#.#.#...#.....#.#...#.#...#.......#...#.#
.###.#.#.###.#.###.#.#.#.#.#.#.#.#.###.###.#.#.###.#######.#.#.#
...#...#.....#.....#.#...#...#...#.....#.#.#.#.....#...#...#.#.#
.#.###########.###########.#######.#####.#.#.#######.#.#.###.#.#
.#.#.........#.#.......#...#.#...#...#...#.#.....#...#.#.#.#.#.#
##.#####.###.#.#.#####.#.###.#.#.###.#.###.#####.###.#.#.#.#.#.#
...#...#...#...#.#...#.#.....#.#...#...#.......#...#.#.....#.#.#
.###.#.#.#####.#.#.###.#####.#.###.#####.#####.###.#########.#.#
.....#.#.#...#.#...#.......#.#...#.......#...#.#...#.....#...#.#
.#####.###.#.#####.#.#######.###.#########.#.###.###.###.#.###.#
.....#.....#.......#...........#...........#.........#.....#...#
################################################################
