8
.#S....#
.#####.#
.....#.#
.###.#.#
...#.#.#
.#.###.#
.#..G..#
########
