64
.....#...#.......#...#.......#.....#.#.........................#
.###.#.#.#.#####.#.#.###.###.#.###.#.#.###########.###########.#
.#.....#...#.......#.#...#.#...#.#.#.#.#...#...#...#.........#.#
.###################.#.###.#####.#.#.#.#.#.#.#.#.###.#########.#
...................#.#...#...#.....#...#.#...#...#.....#.......#
.#################.#.###.#.#.#.#####.###.#####.#######.#.#######
...#...............#.....#.#...#...#...#.....#.#...#...#.......#
##.#.#####################.#####.#.###.#####.###.#.#.#########.#
...#.#...#.....#...........#.....#...#.#.....#...#.#.........#G#
.###.#.###.###.#.###########.#####.###.#.#.###.###.###.#####.#.#
...#.#...#...#...#.#.........#.#...#...#.#.#...#...#...#.#...#.#
##.#.#.#.###.#####.#.#########.#.###.###.###.###.###.###.#.###.#
.#.#.#.#.#...#...#.#.....#.....#.#...#.#.....#...#...#...#.#...#
.#.#.###.#.###.#.#.#####.#.###.#.#.###.#######.###.###.###.#.###
...#...#...#...#.#.......#.#...#.#...#.....#...#...#.......#...#
######.#.#####.#.#.#######.###.#.###.#.#.###.#####.###########.#
.......#.......#.#.....#.....#.#...#.#.#.#...#.....#...#.....#.#
.###############.#####.###.#.#.###.#.#.###.###.###.#.#.#.###.#.#
.......#.....#...#...#...#.#.#...#.....#...#.#...#.#.#...#.#...#
######.#.###.#.#####.###.###.###########.###.#.#.###.#####.#####
.......#.#...#.....#.........#...#.......#...#.#.....#...#.....#
.#######.#########.#.#########.#.#.#########.#.#######.#.#####.#
...#.....#.........#...#.#...#.#...#.......#.#.........#.......#
.#.#.#####.#######.###.#.#.#.#.#####.#####.#.#################.#
.#.#...#...#.....#...#...#.#.#...#.#...#.........#.......#...#.#
.#.###.#.###.###.###.#####.#.###.#.#.#.#########.#.#.#####.#.#.#
.#...#...#.#...#.#.#.......#.....#...#.......#...#.#...#...#...#
####.#.###.###.#.#.#########.###############.#####.###.#.#######
.....#.....#...#.#.......#...#.............#.......#.#...#.....#
.#########.#.###.#######.#.###.###########.#.#######.#####.###.#
.....#...#.#.#.#.......#...#.#.#...#...#...#...#...........#.#.#
####.#.#.###.#.#######.###.#.#.#.#.###.#.#####.#####.#######.#.#
.....#.#.....#.......#...#...#...#...#.#.#...#.....#.#.......#.#
.###.#.#######.#.#####.#.###########.#.#.#.#.#####.#.#.#####.#.#
...#.#.....#...#.#S..#.#.#.........#.#.#.#.#.....#...#.#...#...#
##.#######.#.#.#####.###.#.###.#####.#.#.#.#####.#####.#.#######
...#.....#.#.#...#...#...#...#.......#.#.#.#...#...#...#.......#
.#.#.#.###.#####.#.###.#####.#########.#.###.#.#.###.###.#####.#
.#.#.#...#.......#.#...................#.....#.#.....#...#...#.#
.###.###.#######.#.###################.#######.###.#######.#.#.#
.....#.#...#.....#.....#...#.........#.#.....#...#.#.....#.#...#
.#####.###.#.#########.#.#.#########.#.###.#.###.#.###.#.#.#####
.#.......#.#.......#.#...#.....#...#.#.#...#.#...#.....#.#.#...#
.#.#.#####.#######.#.#########.#.#.#.#.#.#####.#########.#.#.#.#
...#.#.........#.#...#.....#.#...#.#...#.#.....#.....#...#...#.#
####.#.#######.#.###.#.###.#.#####.#.###.#.#####.#####.###.###.#
.#...#...#...#.#...#...#...#.#.....#...#.#.#.....#...#.#.....#.#
.#.#####.#.#.#.#.#######.###.#.#######.#.#.#.#####.#.#.#######.#
.....#...#.#.#...#...#...#...#.......#...#.#...#...#.#...#.....#
####.#.###.#.#.###.#.#.#####.#######.#.###.#.#.#.###.###.#.#####
...#.#.#...#.#.#...#...........#.....#.#...#.#...#...#...#.....#
.#.###.#####.#.#.###############.#####.#.###.#####.#.#.#######.#
.#...#.#...#...#.....#...........#.....#.#.....#...#.#.#.....#.#
.###.#.#.#.#.#####.###.###########.#####.#####.#.#.###.#.###.#.#
.#.#.#...#.#.#...#.#...#.........#.....#...#.#.#.#.#...#.#.#.#.#
.#.#.#.###.#.###.#.#.###.#####.#######.###.#.#.#.###.###.#.#.#.#
.#...#...#.#.....#.#...#.#...#.........#...#...#...#.....#.#...#
.#.#######.#.#####.###.###.#.###.#######.#########.#######.###.#
.#.....#...#.#.....#.#...#.#...#.#...#...#...........#.......#.#
.#####.#.#####.#####.###.#.###.###.#.#.###.###########.#.#####.#
.....#...#...#...#.....#.#...#.#...#.#.#...#.........#.#.#.....#
.###.#####.#.###.#.###.#.###.#.#.###.#.#.#.#.#######.#.#.#.#####
...#.......#.......#...#.....#...#.....#.#.........#...#.......#
################################################################
