16
.#.............#
.#.#####.#####.#
...#...#.#...#.#
.###.#.#.#.#.###
.#...#.#...#.#S#
.#####.#####.#.#
...#.......#...#
##.#.#####.#####
G#.#...#.....#.#
.#.###.#####.#.#
.#...#...#.#...#
.###.###.#.###.#
...#...#.#...#.#
.#####.#.#.###.#
.........#.....#
################
