64
.#.........#.................#...#.....#...#.....#...#...#.....#
.#.###.#####.###########.#####.#.#.#.#.#.#.#.#.###.#.#.#.###.###
.#...#.....#.#...#.....#...#...#...#.#...#.#.#.#...#...#...#...#
.###.#####.#.#.###.###.#.#.#.#######.#####.#.#.#.#########.###.#
.....#.#...#...#...#.#.#.#...#.......#...#...#.#...#.....#.#...#
.#####.#.#####.#.###.#.###.###.#######.###.#######.#.#####.#.#.#
.#.....#...#...#.#...#...#...#.#...#.......#...#...#.......#.#.#
.#.###.###.#.###.#.#####.#####.#.###.#######.#.#.###.#######.###
.#.#.....#...#...#...#...#.....#...........#.#...#.#.....#.....#
.#.#.###.#####.#####.#.###.###############.#.#####.#####.#.###.#
.#.#.#.#.#.....#.....#...#...#.......#...#.#.#.........#.#...#.#
.###.#.#.#.#####.###.###.###.#.#####.#.#.###.###.#####.#.#####.#
...#.#...#.....#.#.#.#.#.....#.#...#...#...#...#.....#...#...#.#
##.#.#########.#.#.#.#.#####.#.###.#######.###.#####.#####.#.#.#
.#...#...#.....#.#.....#.....#.#.........#...#.#...#...#...#.#.#
.###.#.#.#.#####.#######.#####.#.#########.#.#.#.#.###.#.###.#.#
...#.#.#...#...........#.#.....#.#.......#.#.#...#.#.#...#...#.#
.###.#.###########.###.#.#.#####.#.#####.###.#####.#.#####.###.#
.....#.#.....#...#...#...#.#.....#.....#...#...#.#.#.....#.#...#
####.#.#.###.#.#.###.#####.#.#.#######.###.#.#.#.#.###.#.#.#.#.#
...#.#.#...#.#.#.#...#...#.#.#...#.....#.#...#.#.#.#...#.#.#.#.#
.#.###.###.#.#.#.#####.#.#.#.###.#.#####.#####.#.#.#.#####.###.#
.#...#...#.#.#.#.#.....#.#.#.#...#...#...#.......#.#.#...#...#.#
.###.###.#.#.#.#.#.#####.#.###.#.###.###.#.#######.#.#.#.###.#.#
...#.....#.#...#.#.#.....#.....#...#...#...#S......#.#.#...#...#
.#.###.###.#####.#.#.#####.#######.###.#############.#.###.###.#
.#...#.#.....#...#.#.......#.....#...#.#...........#...#.#.#...#
.###.###.#####.#.#.#########.###.#.###.#.#########.#.###.#.#.###
.#.#.#...#.....#.#...#.....#.#...#.#...#.........#.......#.#...#
.#.#.#.###.#########.#.###.#.#.#####.#.#########.#########.###.#
.#.#.#.#.#.........#.#.#.#.#.#.......#.#.#.....#.#.#.......#...#
.#.#.#.#.#########.#.#.#.#.#.#########.#.#.###.#.#.#.#####.#.###
...#...#.....#...#...#.#.....#.......#...#...#.....#.....#.#.#.#
##.#######.###.#.#####.#######.#########.###.###########.###.#.#
.#.#.....#.#...#.....#...#...#.#.......#.#.#.#.#.........#...#.#
.#.###.#.#.#.#######.###.#.#.#.#.###.###.#.#.#.#.#########.###.#
...#...#...#.#.....#...#...#.#.#.#.#...#...#.#.#.....#.....#...#
.###.#.#####.###.#.###.#.###.#.#.#.###.###.#.#.#####.#.#######.#
.#...#.#.....#...#...#.#...#.#.#.....#.....#.#.....#...#.......#
.###.#.#.#####.#######.#####.#.#####.#######.#####.#####.#####.#
...#.#.#.#.#...........#...#.#.#.....#.......#.....#.....#...#.#
##.#.#.#.#.#.###########.#.#.#.#.#####.#######.###.###.###.#.#.#
.#...#.#.#...#...#.......#...#...#.#...#.....#.#.#...#.....#.#.#
.#####.#.###.#.#.#####.#######.###.#.###.###.#.#.###.#######.#.#
...#...#...#...#.....#...#.....#...#...#.#.#...#...#.#...#...#.#
.###.#####.#########.#.#.###.#####.###.#.#.#######.#.#.#.#.###.#
...#.#...#.#...#.....#.#...#.........#.#.#.....#...#...#...#...#
##.#.#.###.#.###.#####.###.#########.#.#.###.#.#.#.#########.###
...#.#.#...#.#...#...#.#...#.....#...#...#...#...#.#.#.....#.#.#
.###.#.#.###.#.###.#.###.###.#.###.#######.#######.#.#.###.#.#.#
.......#.#...#.....#.....#...#.....#.........#.#.....#...#.#...#
.#####.#.###.#############.#################.#.#.#######.#.###.#
.#...#.#...#.....#.....#...#.....#...........#...#.....#.#...#.#
##.#.#####.#.###.#.###.#.#######.#.#.#.#######.###.###.#.###.#.#
...#.......#...#.#.#.#.#.......#...#.#.#...#.#.#.#.#.#.....#.#.#
.###.#########.#.#.#.#.#######.#####.###.#.#.#.#.#.#.#######.#.#
.#...#.....#...#...#.#...............#...#.#...#.#.#...#...#.#.#
.#.###.###.#.#######.#################.###.#.###.#.###.#.#.#.#.#
.#...#.#..G#...........#...........#...#...#...#.#.#...#.#...#.#
.#####.#.#####.#########.#########.#.###.#####.#.#.#.###.#####.#
.......#.....#.#...#...#.#...#...#.#.#.#.#.......#.#...#.......#
.###########.###.#.#.#.#.#.#.#.#.#.#.#.#.#########.###.#########
...........#.....#...#.....#...#.#.....#.......................#
################################################################
