32
.#.......#.......#.#.......#...#
.#.#.###.###.#.#.#.#.###.###.#.#
...#...#...#.#.#...#...#...#.#.#
.#####.###.#.#.#.###.#####.#.#.#
.....#.#...#.#.#.#...#...#.#.#.#
######.#.#####.###.###.#.#.#.#.#
.......#.....#.....#...#.#...#.#
.###########.#######.###.#####.#
...#...#.............#.#.#.....#
.#.#.#.#.#############.#.#.#####
.#...#.#.#.....#.....#.#.#.....#
.#####.###.###.#.###.#.#.#####.#
...#S#...#...#.#...#.#.....#...#
####.#.#.###.#.###.#.#####.#.#.#
.....#.#...#.#...#.#.....#...#.#
.#####.#.#.#.#.###.#####.#####.#
...#...#.#.#.#.....#...#.#.....#
##.###.#.#.#.#######.#.#.#.#####
.#...#.#.#.#.......#.#.#.#.....#
.###.#.#.#########.###.#.#####.#
...#.#.#.#.......#.....#.#.#...#
.#.#.###.#.#####.###.###.#.#.###
.#.#...#.....#.#...#.#...#.....#
.#####.#####.#.#.###.#.###.#####
.....#...#.....#.....#...#.#G..#
.#.#.###.#####.#######.#.###.#.#
.#.#...#...#.....#...#.#.....#.#
.#.###.###.#####.#.#.#.#######.#
.#...#...#.#...#.#.#.#.....#...#
.###.#####.#.#.###.#.#######.#.#
...#.........#.....#.........#.#
################################
